Date,Transaction Type,Name,Memo/Description,Split,Amount,Balance
05/07/2021,Deposit,EntityC,Received from John Doe towards Founders Preferred Stock 900000,Cash,9,9
05/07/2021,Deposit,EntityC,Received from John Doe towards Common Stock 8100000,Cash,81,90
05/07/2021,Deposit,EntityC,,-Split-,90,180
05/07/2021,Deposit,EntityC,Received from John Doe towards Common Stock 8100000,Cash,81,261
05/07/2021,Deposit,EntityC,,-Split-,90,351
05/07/2021,Deposit,EntityC,Received from John Doe towards Founders Preferred Stock 900000,Cash,9,360
05/07/2021,Deposit,EntityC,Received from John Doe towards Common Stock 8100000,Cash,81,441
05/07/2021,Deposit,EntityC,Received from John Doe towards Common Stock 8100000,Cash,81,522
05/07/2021,Deposit,EntityC,,-Split-,90,612
05/07/2021,Deposit,EntityC,Received from John Doe towards Founders Preferred Stock 900000,Cash,9,621
05/07/2021,Deposit,EntityC,,-Split-,90,711
05/07/2021,Deposit,EntityC,Received from John Doe towards Founders Preferred Stock 900000,Cash,9,720
08/10/2021,Transfer,,PaymentServiceB Checking **7257,Savings (6977),402460,403180
08/10/2021,Transfer,,SVB FOR BENEFIT OF ANGELLIST,Account1,-402460,720
08/10/2021,Transfer,,SVB FOR BENEFIT OF ANGELLIST,Account1,-402460,-401740
08/10/2021,Transfer,,PaymentServiceB Checking **7257,Savings (6977),-402460,-804200
08/10/2021,Transfer,,SVB FOR BENEFIT OF ANGELLIST,Account1,-402460,-1206660
08/10/2021,Transfer,,PaymentServiceB Checking **7257,Account1,402460,-804200
08/10/2021,Transfer,,PaymentServiceB Savings **6977,Account1,402460,-401740
08/10/2021,Transfer,,PaymentServiceB Savings **6977,Account1,402460,720
08/10/2021,Transfer,,PaymentServiceB Checking **7257,Account1,-402460,-401740
08/10/2021,Transfer,,PaymentServiceB Savings **6977,Savings (6977),-402460,-804200
08/10/2021,Transfer,,PaymentServiceB Checking **7257,Savings (6977),-402460,-1206660
08/10/2021,Transfer,,PaymentServiceB Savings **6977,Savings (6977),-402460,-1609120
08/10/2021,Transfer,,PaymentServiceB Checking **7257,Account1,402460,-1206660
08/10/2021,Transfer,,SVB FOR BENEFIT OF ANGELLIST,Account1,-402460,-1609120
08/10/2021,Transfer,,PaymentServiceB Savings **6977,Account1,402460,-1206660
08/10/2021,Transfer,,PaymentServiceB Checking **7257,Account1,402460,-804200
08/10/2021,Transfer,,SVB FOR BENEFIT OF ANGELLIST,Savings (6977),402460,-401740
08/10/2021,Deposit,,SVB FOR BENEFIT OF ANGELLIST,Series Seed Preferred Share:Angel -Investment,402460,720
08/10/2021,Transfer,,PaymentServiceB Savings **6977,Account1,402460,403180
08/10/2021,Transfer,,PaymentServiceB Checking **7257,Savings (6977),402460,805640
08/10/2021,Transfer,,PaymentServiceB Savings **6977,Savings (6977),-402460,403180
08/10/2021,Transfer,,SVB FOR BENEFIT OF ANGELLIST,Savings (6977),402460,805640
08/10/2021,Transfer,,PaymentServiceB Savings **6977,Account1,402460,1208100
08/10/2021,Deposit,,SVB FOR BENEFIT OF ANGELLIST,Account1,402460,1610560
08/10/2021,Transfer,,PaymentServiceB Checking **7257,Account1,-402460,1208100
08/10/2021,Transfer,,PaymentServiceB Savings **6977,Account1,402460,1610560
08/10/2021,Deposit,,SVB FOR BENEFIT OF ANGELLIST,Account1,402460,2013020
08/10/2021,Deposit,,SVB FOR BENEFIT OF ANGELLIST,Series Seed Preferred Share:Angel -Investment,402460,2415480
08/10/2021,Transfer,,PaymentServiceB Checking **7257,Savings (6977),-402460,2013020
08/10/2021,Transfer,,PaymentServiceB Savings **6977,Savings (6977),-402460,1610560
08/10/2021,Transfer,,PaymentServiceB Savings **6977,Account1,402460,2013020
08/10/2021,Transfer,,PaymentServiceB Checking **7257,Account1,-402460,1610560
08/10/2021,Transfer,,PaymentServiceB Savings **6977,Account1,402460,2013020
08/10/2021,Transfer,,PaymentServiceB Checking **7257,Savings (6977),402460,2415480
08/10/2021,Transfer,,PaymentServiceB Savings **6977,Savings (6977),-402460,2013020
08/10/2021,Deposit,,SVB FOR BENEFIT OF ANGELLIST,Account1,402460,2415480
08/10/2021,Transfer,,SVB FOR BENEFIT OF ANGELLIST,Savings (6977),402460,2817940
08/10/2021,Deposit,,SVB FOR BENEFIT OF ANGELLIST,Series Seed Preferred Share:Angel -Investment,402460,3220400
08/10/2021,Transfer,,PaymentServiceB Checking **7257,Account1,-402460,2817940
08/10/2021,Transfer,,PaymentServiceB Checking **7257,Account1,402460,3220400
08/10/2021,Transfer,,PaymentServiceB Checking **7257,Savings (6977),402460,3622860
08/10/2021,Transfer,,PaymentServiceB Savings **6977,Savings (6977),-402460,3220400
08/10/2021,Deposit,,SVB FOR BENEFIT OF ANGELLIST,Account1,402460,3622860
08/10/2021,Transfer,,PaymentServiceB Savings **6977,Savings (6977),-402460,3220400
08/10/2021,Transfer,,PaymentServiceB Savings **6977,Savings (6977),-402460,2817940
08/10/2021,Deposit,,SVB FOR BENEFIT OF ANGELLIST,Series Seed Preferred Share:Angel -Investment,402460,3220400
08/10/2021,Transfer,,SVB FOR BENEFIT OF ANGELLIST,Savings (6977),402460,3622860
08/10/2021,Transfer,,PaymentServiceB Checking **7257,Savings (6977),-402460,3220400
08/13/2021,Deposit,,RAMP BUSINESS CO,General business expenses:Bank fees & service charges,0.48,3220400.48
08/13/2021,Deposit,,RAMP BUSINESS CO,General business expenses:Bank fees & service charges,0.67,3220401.15
08/13/2021,Deposit,,RAMP BUSINESS CO,General business expenses:Bank fees & service charges,0.19,3220401.34
08/13/2021,Deposit,,RAMP BUSINESS CO,General business expenses:Bank fees & service charges,0.67,3220402.01
08/13/2021,Expense,,RAMP BUSINESS CO,General business expenses:Bank fees & service charges,-0.67,3220401.34
08/13/2021,Deposit,,RAMP BUSINESS CO,Savings (6977),-0.19,3220401.15
08/13/2021,Deposit,,RAMP BUSINESS CO,Savings (6977),-0.48,3220400.67
08/13/2021,Expense,,RAMP BUSINESS CO,Savings (6977),0.67,3220401.34
08/13/2021,Deposit,,RAMP BUSINESS CO,General business expenses:Bank fees & service charges,0.67,3220402.01
08/13/2021,Expense,,RAMP BUSINESS CO,General business expenses:Bank fees & service charges,-0.48,3220401.53
08/13/2021,Deposit,,RAMP BUSINESS CO,General business expenses:Bank fees & service charges,0.19,3220401.72
08/13/2021,Expense,,RAMP BUSINESS CO,Savings (6977),0.67,3220402.39
08/13/2021,Deposit,,RAMP BUSINESS CO,General business expenses:Bank fees & service charges,0.48,3220402.87
08/13/2021,Expense,,RAMP BUSINESS CO,General business expenses:Bank fees & service charges,-0.19,3220402.68
08/13/2021,Deposit,,RAMP BUSINESS CO,Savings (6977),-0.67,3220402.01
08/13/2021,Expense,,RAMP BUSINESS CO,General business expenses:Bank fees & service charges,-0.67,3220401.34
08/13/2021,Expense,,RAMP BUSINESS CO,Savings (6977),0.48,3220401.82
08/13/2021,Deposit,,RAMP BUSINESS CO,General business expenses:Bank fees & service charges,0.19,3220402.01
08/13/2021,Expense,,RAMP BUSINESS CO,General business expenses:Bank fees & service charges,-0.48,3220401.53
08/13/2021,Deposit,,RAMP BUSINESS CO,Savings (6977),-0.19,3220401.34
08/13/2021,Deposit,,RAMP BUSINESS CO,Savings (6977),-0.48,3220400.86
08/13/2021,Deposit,,RAMP BUSINESS CO,Savings (6977),-0.19,3220400.67
08/13/2021,Expense,,RAMP BUSINESS CO,Savings (6977),0.19,3220400.86
08/13/2021,Expense,,RAMP BUSINESS CO,General business expenses:Bank fees & service charges,-0.19,3220400.67
08/13/2021,Expense,,RAMP BUSINESS CO,Savings (6977),0.67,3220401.34
08/13/2021,Expense,,RAMP BUSINESS CO,Savings (6977),0.19,3220401.53
08/13/2021,Deposit,,RAMP BUSINESS CO,Savings (6977),-0.67,3220400.86
08/13/2021,Expense,,RAMP BUSINESS CO,General business expenses:Bank fees & service charges,-0.67,3220400.19
08/13/2021,Deposit,,RAMP BUSINESS CO,Savings (6977),-0.48,3220399.71
08/13/2021,Expense,,RAMP BUSINESS CO,General business expenses:Bank fees & service charges,-0.19,3220399.52
08/13/2021,Deposit,,RAMP BUSINESS CO,Savings (6977),-0.67,3220398.85
08/13/2021,Deposit,,RAMP BUSINESS CO,General business expenses:Bank fees & service charges,0.48,3220399.33
08/13/2021,Deposit,,RAMP BUSINESS CO,General business expenses:Bank fees & service charges,0.67,3220400
08/13/2021,Expense,,RAMP BUSINESS CO,General business expenses:Bank fees & service charges,-0.48,3220399.52
08/13/2021,Expense,,RAMP BUSINESS CO,General business expenses:Bank fees & service charges,-0.19,3220399.33
08/13/2021,Deposit,,RAMP BUSINESS CO,Savings (6977),-0.19,3220399.14
08/13/2021,Expense,,RAMP BUSINESS CO,Savings (6977),0.48,3220399.62
08/13/2021,Expense,,RAMP BUSINESS CO,General business expenses:Bank fees & service charges,-0.67,3220398.95
08/13/2021,Expense,,RAMP BUSINESS CO,General business expenses:Bank fees & service charges,-0.48,3220398.47
08/13/2021,Expense,,RAMP BUSINESS CO,Savings (6977),0.19,3220398.66
08/13/2021,Deposit,,RAMP BUSINESS CO,General business expenses:Bank fees & service charges,0.48,3220399.14
08/13/2021,Expense,,RAMP BUSINESS CO,Savings (6977),0.48,3220399.62
08/13/2021,Expense,,RAMP BUSINESS CO,Savings (6977),0.48,3220400.1
08/13/2021,Expense,,RAMP BUSINESS CO,Savings (6977),0.19,3220400.29
08/13/2021,Deposit,,RAMP BUSINESS CO,Savings (6977),-0.48,3220399.81
08/13/2021,Deposit,,RAMP BUSINESS CO,Savings (6977),-0.67,3220399.14
08/13/2021,Expense,,RAMP BUSINESS CO,Savings (6977),0.67,3220399.81
08/13/2021,Deposit,,RAMP BUSINESS CO,General business expenses:Bank fees & service charges,0.19,3220400
08/16/2021,Expense,Income Capitals ,Income Capitals ,Professional Service Charges,-5265.32,3215134.68
08/16/2021,Expense,,CompanyB,Account1,120000,3335134.68
08/16/2021,Transfer,,PaymentServiceB Checking **7257,Account1,-150000,3185134.68
08/16/2021,Expense,Income Capitals ,Income Capitals ,Professional Service Charges,-5265.32,3179869.36
08/16/2021,Expense,,CompanyB,Investment in Australia Subsidiary,-120000,3059869.36
08/16/2021,Expense,Income Capitals ,Income Capitals ,Professional Service Charges,-5265.32,3054604.04
08/16/2021,Expense,,CompanyB,Investment in Australia Subsidiary,-120000,2934604.04
08/16/2021,Transfer,,PaymentServiceB Checking **7257,Savings (6977),150000,3084604.04
08/16/2021,Expense,Income Capitals ,"Income Capitals , Gabriel (design contractor)",Account1,5265.32,3089869.36
08/16/2021,Transfer,,PaymentServiceB Checking **7257,Savings (6977),150000,3239869.36
08/16/2021,Expense,,CompanyB,Investment in Australia Subsidiary,-120000,3119869.36
08/16/2021,Expense,,CompanyB,Account1,120000,3239869.36
08/16/2021,Expense,Income Capitals ,"Income Capitals , Gabriel (design contractor)",Account1,5265.32,3245134.68
08/16/2021,Expense,Income Capitals ,"Income Capitals , Gabriel (design contractor)",Account1,5265.32,3250400
08/16/2021,Expense,,CompanyB,Account1,120000,3370400
08/16/2021,Transfer,,PaymentServiceB Checking **7257,Savings (6977),150000,3520400
08/16/2021,Expense,Income Capitals ,Income Capitals ,Professional Service Charges,-5265.32,3515134.68
08/16/2021,Expense,,CompanyB,Investment in Australia Subsidiary,-120000,3395134.68
08/16/2021,Transfer,,PaymentServiceB Checking **7257,Account1,-150000,3245134.68
08/16/2021,Transfer,,PaymentServiceB Checking **7257,Account1,-150000,3095134.68
08/16/2021,Transfer,,PaymentServiceB Checking **7257,Savings (6977),150000,3245134.68
08/16/2021,Transfer,,PaymentServiceB Checking **7257,Account1,-150000,3095134.68
08/16/2021,Expense,,CompanyB,Account1,120000,3215134.68
08/16/2021,Expense,Income Capitals ,"Income Capitals , Gabriel (design contractor)",Account1,5265.32,3220400
08/18/2021,Deposit,BIG VC Investors,BIG VC Investors,Series Seed Preferred Share:Accel -Investment,2097539.6,5317939.6
08/18/2021,Deposit,BIG VC Investors,BIG VC Investors,Series Seed Preferred Share:Accel -Investment,2097539.6,7415479.2
08/18/2021,Deposit,BIG VC Investors,"BIG VC Investors Issue of 3,226,984 Series seed shares",Account1,2097539.6,9513018.8
08/18/2021,Deposit,BIG VC Investors,"BIG VC Investors Issue of 3,226,984 Series seed shares",Account1,2097539.6,11610558.4
08/18/2021,Deposit,BIG VC Investors,BIG VC Investors,Series Seed Preferred Share:Accel -Investment,2097539.6,13708098
08/18/2021,Deposit,BIG VC Investors,BIG VC Investors,Series Seed Preferred Share:Accel -Investment,2097539.6,15805637.6
08/18/2021,Deposit,BIG VC Investors,"BIG VC Investors Issue of 3,226,984 Series seed shares",Account1,2097539.6,17903177.2
08/18/2021,Deposit,BIG VC Investors,"BIG VC Investors Issue of 3,226,984 Series seed shares",Account1,2097539.6,20000716.8
08/19/2021,Expense,Lion Words,Harvey Spector,Professional Service Charges,1654.56,20002371.36
08/19/2021,Expense,Lion Words,Harvey Spector,Professional Service Charges,1654.56,20004025.92
08/19/2021,Expense,Lion Words,Harvey Spector,Credit Card - Ramp,1654.56,20005680.48
08/19/2021,Expense,Lion Words,Harvey Spector,Credit Card - Ramp,1654.56,20007335.04
08/19/2021,Expense,Lion Words,Harvey Spector,Professional Service Charges,1654.56,20008989.6
08/19/2021,Expense,Lion Words,Harvey Spector,Professional Service Charges,1654.56,20010644.16
08/19/2021,Expense,Lion Words,Harvey Spector,Credit Card - Ramp,1654.56,20012298.72
08/19/2021,Expense,Lion Words,Harvey Spector,Credit Card - Ramp,1654.56,20013953.28
08/21/2021,Transfer,,PaymentServiceB Savings **6977,Savings (6977),-2070000,17943953.28
08/21/2021,Transfer,,PaymentServiceB Savings **6977,Savings (6977),-2070000,15873953.28
08/21/2021,Transfer,,PaymentServiceB Savings **6977,Savings (6977),-2070000,13803953.28
08/21/2021,Transfer,,PaymentServiceB Savings **6977,Account1,2070000,15873953.28
08/21/2021,Transfer,,PaymentServiceB Savings **6977,Account1,2070000,17943953.28
08/21/2021,Transfer,,PaymentServiceB Savings **6977,Savings (6977),-2070000,15873953.28
08/21/2021,Transfer,,PaymentServiceB Savings **6977,Account1,2070000,17943953.28
08/21/2021,Transfer,,PaymentServiceB Savings **6977,Account1,2070000,20013953.28
08/30/2021,Expense,,RAMP BUSINESS CO,General business expenses:Bank fees & service charges,-0.56,20013952.72
08/30/2021,Deposit,,RAMP BUSINESS CO,General business expenses:Bank fees & service charges,0.17,20013952.89
08/30/2021,Deposit,,RAMP BUSINESS CO,Account1,-0.17,20013952.72
08/30/2021,Expense,Pony Express,,Tools & Subscription - G&A,19,20013971.72
08/30/2021,Deposit,,RAMP BUSINESS CO,General business expenses:Bank fees & service charges,0.39,20013972.11
08/30/2021,Expense,,RAMP BUSINESS CO,General business expenses:Bank fees & service charges,-0.56,20013971.55
08/30/2021,Deposit,,RAMP BUSINESS CO,Account1,-0.39,20013971.16
08/30/2021,Expense,Pony Express,,Tools & Subscription - G&A,19,20013990.16
08/30/2021,Expense,,RAMP BUSINESS CO,Account1,0.56,20013990.72
08/30/2021,Deposit,,RAMP BUSINESS CO,Account1,-0.39,20013990.33
08/30/2021,Expense,,RAMP BUSINESS CO,Account1,0.56,20013990.89
08/30/2021,Deposit,,RAMP BUSINESS CO,Account1,-0.17,20013990.72
08/30/2021,Deposit,,RAMP BUSINESS CO,Account1,-0.39,20013990.33
08/30/2021,Expense,,RAMP BUSINESS CO,Account1,0.56,20013990.89
08/30/2021,Expense,Pony Express,Harvey Spector,Credit Card - Ramp,19,20014009.89
08/30/2021,Expense,Pony Express,,Tools & Subscription - G&A,19,20014028.89
08/30/2021,Deposit,,RAMP BUSINESS CO,General business expenses:Bank fees & service charges,0.17,20014029.06
08/30/2021,Deposit,,RAMP BUSINESS CO,General business expenses:Bank fees & service charges,0.39,20014029.45
08/30/2021,Deposit,,RAMP BUSINESS CO,Account1,-0.17,20014029.28
08/30/2021,Deposit,,RAMP BUSINESS CO,Account1,-0.39,20014028.89
08/30/2021,Expense,,RAMP BUSINESS CO,Account1,0.56,20014029.45
08/30/2021,Deposit,,RAMP BUSINESS CO,Account1,-0.17,20014029.28
08/30/2021,Expense,Pony Express,Harvey Spector,Credit Card - Ramp,19,20014048.28
08/30/2021,Deposit,,RAMP BUSINESS CO,General business expenses:Bank fees & service charges,0.39,20014048.67
08/30/2021,Expense,Pony Express,Harvey Spector,Credit Card - Ramp,19,20014067.67
08/30/2021,Deposit,,RAMP BUSINESS CO,General business expenses:Bank fees & service charges,0.39,20014068.06
08/30/2021,Deposit,,RAMP BUSINESS CO,General business expenses:Bank fees & service charges,0.17,20014068.23
08/30/2021,Expense,,RAMP BUSINESS CO,General business expenses:Bank fees & service charges,-0.56,20014067.67
08/30/2021,Expense,,RAMP BUSINESS CO,General business expenses:Bank fees & service charges,-0.56,20014067.11
08/30/2021,Deposit,,RAMP BUSINESS CO,General business expenses:Bank fees & service charges,0.17,20014067.28
08/30/2021,Expense,Pony Express,,Tools & Subscription - G&A,19,20014086.28
08/31/2021,Expense,Income Capitals ,Income Capitals ,Professional Service Charges,-20270,19993816.28
08/31/2021,Expense,Income Capitals ,Income Capitals ,Professional Service Charges,-20270,19973546.28
08/31/2021,Expense,Income Capitals ,Deel is for contractual (salary) payments,Account1,20270,19993816.28
08/31/2021,Expense,Income Capitals ,Income Capitals ,Professional Service Charges,-20270,19973546.28
08/31/2021,Expense,Income Capitals ,Deel is for contractual (salary) payments,Account1,20270,19993816.28
08/31/2021,Expense,Income Capitals ,Deel is for contractual (salary) payments,Account1,20270,20014086.28
08/31/2021,Expense,Income Capitals ,Income Capitals ,Professional Service Charges,-20270,19993816.28
08/31/2021,Expense,Income Capitals ,Deel is for contractual (salary) payments,Account1,20270,20014086.28
09/01/2021,Expense,Typeform,Harvey Spector,Credit Card - Ramp,413,20014499.28
09/01/2021,Expense,Typeform,,Tools & Subscription - G&A,413,20014912.28
09/01/2021,Expense,Typeform,Harvey Spector,Credit Card - Ramp,413,20015325.28
09/01/2021,Expense,Typeform,Harvey Spector,Credit Card - Ramp,413,20015738.28
09/01/2021,Expense,Typeform,,Tools & Subscription - G&A,413,20016151.28
09/01/2021,Expense,Typeform,,Tools & Subscription - G&A,413,20016564.28
09/01/2021,Expense,Typeform,,Tools & Subscription - G&A,413,20016977.28
09/02/2021,Expense,Income Capitals ,Income Capitals ,Professional Service Charges,-4069.03,20012908.25
09/02/2021,Expense,Income Capitals ,Income Capitals ,Professional Service Charges,-4069.03,20008839.22
09/02/2021,Expense,Income Capitals ,"Income Capitals  , Gabriel Sal till 20th Aug",Account1,4069.03,20012908.25
09/02/2021,Expense,Income Capitals ,"Income Capitals  , Gabriel Sal till 20th Aug",Account1,4069.03,20016977.28
09/02/2021,Expense,Income Capitals ,"Income Capitals  , Gabriel Sal till 20th Aug",Account1,4069.03,20021046.31
09/02/2021,Expense,Income Capitals ,"Income Capitals  , Gabriel Sal till 20th Aug",Account1,4069.03,20025115.34
09/02/2021,Expense,Income Capitals ,Income Capitals ,Professional Service Charges,-4069.03,20021046.31
09/02/2021,Expense,Income Capitals ,Income Capitals ,Professional Service Charges,-4069.03,20016977.28
09/03/2021,Expense,Mazurek Co,,Tools & Subscription - G&A,29.95,20017007.23
09/03/2021,Expense,Income Capitals ,Income Capitals ,Professional Service Charges,-4760.63,20012246.6
09/03/2021,Expense,Income Capitals ,Income Capitals ,Professional Service Charges,-6375.67,20005870.93
09/03/2021,Expense,Income Capitals ,"Income Capitals , Pradeep Sal 1.5 months",Account1,6375.67,20012246.6
09/03/2021,Expense,Income Capitals ,Income Capitals ,Professional Service Charges,-6375.67,20005870.93
09/03/2021,Expense,Income Capitals ,Income Capitals ,Professional Service Charges,-4760.63,20001110.3
09/03/2021,Expense,Income Capitals ,"Income Capitals , Pradeep Sal 1.5 months",Account1,6375.67,20007485.97
09/03/2021,Expense,Income Capitals ,"Income Capitals , Pavan Sal -",Account1,4760.63,20012246.6
09/03/2021,Expense,Mazurek Co,Harvey Spector,Credit Card - Ramp,29.95,20012276.55
09/03/2021,Expense,Mazurek Co,,Tools & Subscription - G&A,29.95,20012306.5
09/03/2021,Expense,Mazurek Co,,Tools & Subscription - G&A,29.95,20012336.45
09/03/2021,Expense,Mazurek Co,Harvey Spector,Credit Card - Ramp,29.95,20012366.4
09/03/2021,Expense,Income Capitals ,"Income Capitals , Pavan Sal -",Account1,4760.63,20017127.03
09/03/2021,Expense,Mazurek Co,,Tools & Subscription - G&A,29.95,20017156.98
09/03/2021,Expense,Income Capitals ,"Income Capitals , Pavan Sal -",Account1,4760.63,20021917.61
09/03/2021,Expense,Income Capitals ,"Income Capitals , Pradeep Sal 1.5 months",Account1,6375.67,20028293.28
09/03/2021,Expense,Income Capitals ,Income Capitals ,Professional Service Charges,-6375.67,20021917.61
09/03/2021,Expense,Income Capitals ,Income Capitals ,Professional Service Charges,-6375.67,20015541.94
09/03/2021,Expense,Income Capitals ,Income Capitals ,Professional Service Charges,-4760.63,20010781.31
09/03/2021,Expense,Income Capitals ,"Income Capitals , Pradeep Sal 1.5 months",Account1,6375.67,20017156.98
09/03/2021,Expense,Income Capitals ,"Income Capitals , Pavan Sal -",Account1,4760.63,20021917.61
09/03/2021,Expense,Income Capitals ,Income Capitals ,Professional Service Charges,-4760.63,20017156.98
09/03/2021,Expense,Mazurek Co,Harvey Spector,Credit Card - Ramp,29.95,20017186.93
09/06/2021,Expense,Conversion.Ai,Harvey Spector,Tools & Subscription - S&M,119,20017305.93
09/06/2021,Expense,Conversion.Ai,Harvey Spector,Tools & Subscription - S&M,119,20017424.93
09/06/2021,Expense,Conversion.Ai,Harvey Spector,Credit Card - Ramp,119,20017543.93
09/06/2021,Expense,Conversion.Ai,Harvey Spector,Tools & Subscription - S&M,119,20017662.93
09/06/2021,Expense,Conversion.Ai,Harvey Spector,Credit Card - Ramp,119,20017781.93
09/06/2021,Expense,Conversion.Ai,Harvey Spector,Tools & Subscription - S&M,119,20017900.93
09/06/2021,Expense,Conversion.Ai,Harvey Spector,Credit Card - Ramp,119,20018019.93
09/08/2021,Expense,Income Capitals ,"Income Capitals , Pavan Sal -",Account1,4088.45,20022108.38
09/08/2021,Expense,Income Capitals ,Income Capitals ,Professional Service Charges,-4205.03,20017903.35
09/08/2021,Expense,Income Capitals ,"Income Capitals , Pradeep Sal -",Account1,4205.03,20022108.38
09/08/2021,Expense,Income Capitals ,"Income Capitals , Pavan Sal -",Account1,4088.45,20026196.83
09/08/2021,Expense,Income Capitals ,"Income Capitals , Pradeep Sal -",Account1,4205.03,20030401.86
09/08/2021,Expense,Income Capitals ,Income Capitals ,Professional Service Charges,-4088.45,20026313.41
09/08/2021,Expense,Income Capitals ,"Income Capitals , Pradeep Sal -",Account1,4205.03,20030518.44
09/08/2021,Expense,Income Capitals ,Income Capitals ,Professional Service Charges,-4205.03,20026313.41
09/08/2021,Expense,Income Capitals ,"Income Capitals , Pavan Sal -",Account1,4088.45,20030401.86
09/08/2021,Expense,Income Capitals ,"Income Capitals , Pavan Sal -",Account1,4088.45,20034490.31
09/08/2021,Expense,Income Capitals ,Income Capitals ,Professional Service Charges,-4205.03,20030285.28
09/08/2021,Expense,Income Capitals ,Income Capitals ,Professional Service Charges,-4088.45,20026196.83
09/08/2021,Expense,Income Capitals ,Income Capitals ,Professional Service Charges,-4205.03,20021991.8
09/08/2021,Expense,Income Capitals ,"Income Capitals , Pradeep Sal -",Account1,4205.03,20026196.83
09/08/2021,Expense,Income Capitals ,Income Capitals ,Professional Service Charges,-4088.45,20022108.38
09/08/2021,Expense,Income Capitals ,Income Capitals ,Professional Service Charges,-4088.45,20018019.93
09/13/2021,Expense,Figma,,Tools & Subscription - G&A,90,20018109.93
09/13/2021,Expense,Heroku,Balapavan Tirumani,Tools & Subscription - S&M,7,20018116.93
09/13/2021,Expense,Figma,,Tools & Subscription - G&A,90,20018206.93
09/13/2021,Expense,Heroku,Balapavan Tirumani,Tools & Subscription - S&M,7,20018213.93
09/13/2021,Expense,Heroku,Balapavan Tirumani,Credit Card - Ramp,7,20018220.93
09/13/2021,Expense,Heroku,Balapavan Tirumani,Credit Card - Ramp,7,20018227.93
09/13/2021,Expense,Heroku,Balapavan Tirumani,Tools & Subscription - S&M,7,20018234.93
09/13/2021,Expense,Figma,,Tools & Subscription - G&A,90,20018324.93
09/13/2021,Expense,Figma,Mike ross,Credit Card - Ramp,90,20018414.93
09/13/2021,Expense,Figma,Mike ross,Credit Card - Ramp,90,20018504.93
09/13/2021,Expense,Heroku,Balapavan Tirumani,Credit Card - Ramp,7,20018511.93
09/13/2021,Expense,Figma,,Tools & Subscription - G&A,90,20018601.93
09/13/2021,Expense,Heroku,Balapavan Tirumani,Tools & Subscription - S&M,7,20018608.93
09/13/2021,Expense,Figma,Mike ross,Credit Card - Ramp,90,20018698.93
09/14/2021,Expense,Slack,Mike ross,Credit Card - Ramp,640,20019338.93
09/14/2021,Expense,Slack,Mike ross,Credit Card - Ramp,640,20019978.93
09/14/2021,Expense,Slack,,Tools & Subscription - G&A,640,20020618.93
09/14/2021,Expense,Slack,,Tools & Subscription - G&A,640,20021258.93
09/14/2021,Expense,Slack,Mike ross,Credit Card - Ramp,640,20021898.93
09/14/2021,Expense,Slack,,Tools & Subscription - G&A,640,20022538.93
09/14/2021,Expense,Slack,,Tools & Subscription - G&A,640,20023178.93
09/16/2021,Expense,carta,Mike ross,Credit Card - Ramp,2240,20025418.93
09/16/2021,Expense,,Harvey Spector,Investment in India Subsidiary,-180,20025238.93
09/16/2021,Expense,carta,,Tools & Subscription - G&A,2240,20027478.93
09/16/2021,Expense,,Towards Purchase of Equity Shares[code:P0006,Account1,180,20027658.93
09/16/2021,Expense,,Towards Purchase of Equity Shares[code:P0006,Account1,180,20027838.93
09/16/2021,Expense,carta,,Tools & Subscription - G&A,2240,20030078.93
09/16/2021,Expense,carta,,Tools & Subscription - G&A,2240,20032318.93
09/16/2021,Expense,,Harvey Spector,Investment in India Subsidiary,-180,20032138.93
09/16/2021,Expense,,Towards Purchase of Equity Shares[code:P0006,Account1,180,20032318.93
09/16/2021,Expense,,Harvey Spector,Investment in India Subsidiary,-180,20032138.93
09/16/2021,Expense,carta,Mike ross,Credit Card - Ramp,2240,20034378.93
09/16/2021,Expense,,Towards Purchase of Equity Shares[code:P0006,Account1,180,20034558.93
09/16/2021,Expense,,Harvey Spector,Investment in India Subsidiary,-180,20034378.93
09/16/2021,Expense,carta,,Tools & Subscription - G&A,2240,20036618.93
09/16/2021,Expense,carta,Mike ross,Credit Card - Ramp,2240,20038858.93
09/20/2021,Expense,Zoom,,Tools & Subscription - G&A,153.75,20039012.68
09/20/2021,Expense,Zoom,,Tools & Subscription - G&A,153.75,20039166.43
09/20/2021,Credit Card Payment,,RAMP BUSINESS CO,Credit Card - Ramp,-5212.51,20033953.92
09/20/2021,Credit Card Payment,,RAMP BUSINESS CO,Account1,-5212.51,20028741.41
09/20/2021,Expense,Zoom,Mike ross,Credit Card - Ramp,153.75,20028895.16
09/20/2021,Expense,Zoom,,Tools & Subscription - G&A,153.75,20029048.91
09/20/2021,Credit Card Payment,,RAMP BUSINESS CO,Credit Card - Ramp,-5212.51,20023836.4
09/20/2021,Credit Card Payment,,RAMP BUSINESS CO,Credit Card - Ramp,-5212.51,20018623.89
09/20/2021,Credit Card Payment,,RAMP BUSINESS CO,Account1,-5212.51,20013411.38
09/20/2021,Expense,Zoom,,Tools & Subscription - G&A,153.75,20013565.13
09/20/2021,Expense,Zoom,Mike ross,Credit Card - Ramp,153.75,20013718.88
09/20/2021,Credit Card Payment,,RAMP BUSINESS CO,Account1,-5212.51,20008506.37
09/20/2021,Expense,Zoom,Mike ross,Credit Card - Ramp,153.75,20008660.12
09/20/2021,Credit Card Payment,,RAMP BUSINESS CO,Credit Card - Ramp,-5212.51,20003447.61
09/20/2021,Credit Card Payment,,RAMP BUSINESS CO,Account1,-5212.51,19998235.1
09/21/2021,Expense,Browse AI,,Tools & Subscription - G&A,99,19998334.1
09/21/2021,Expense,Browse AI,Harvey Spector,Credit Card - Ramp,99,19998433.1
09/21/2021,Expense,Browse AI,,Tools & Subscription - G&A,99,19998532.1
09/21/2021,Expense,Browse AI,,Tools & Subscription - G&A,99,19998631.1
09/21/2021,Expense,Browse AI,,Tools & Subscription - G&A,99,19998730.1
09/21/2021,Expense,Browse AI,Harvey Spector,Credit Card - Ramp,99,19998829.1
09/21/2021,Expense,Browse AI,Harvey Spector,Credit Card - Ramp,99,19998928.1
09/22/2021,Expense,Income Capitals ,Income Capitals ,laptop - Macbook,-2281.65,19996646.45
09/22/2021,Expense,Dovetail,Harvey Spector,Credit Card - Ramp,125,19996771.45
09/22/2021,Expense,Income Capitals ,Income Capitals ,laptop - Macbook,-2281.65,19994489.8
09/22/2021,Expense,Dovetail,Harvey Spector,Credit Card - Ramp,125,19994614.8
09/22/2021,Expense,Dovetail,,Tools & Subscription - G&A,125,19994739.8
09/22/2021,Expense,Dovetail,,Tools & Subscription - G&A,125,19994864.8
09/22/2021,Expense,Income Capitals ,"Income Capitals , Pradeep Laptop Reimb",Account1,2281.65,19997146.45
09/22/2021,Expense,Dovetail,,Tools & Subscription - G&A,125,19997271.45
09/22/2021,Expense,Income Capitals ,"Income Capitals , Pradeep Laptop Reimb",Account1,2281.65,19999553.1
09/22/2021,Expense,Dovetail,Harvey Spector,Credit Card - Ramp,125,19999678.1
09/22/2021,Expense,Dovetail,,Tools & Subscription - G&A,125,19999803.1
09/22/2021,Expense,Income Capitals ,"Income Capitals , Pradeep Laptop Reimb",Account1,2281.65,20002084.75
09/22/2021,Expense,Income Capitals ,Income Capitals ,laptop - Macbook,-2281.65,19999803.1
09/22/2021,Expense,Income Capitals ,Income Capitals ,laptop - Macbook,-2281.65,19997521.45
09/22/2021,Expense,Income Capitals ,"Income Capitals , Pradeep Laptop Reimb",Account1,2281.65,19999803.1
09/27/2021,Transfer,,PaymentServiceB Checking **7257,Savings (6977),50000,20049803.1
09/27/2021,Transfer,,PaymentServiceB Checking **7257,Savings (6977),50000,20099803.1
09/27/2021,Transfer,,PaymentServiceB Checking **7257,Savings (6977),50000,20149803.1
09/27/2021,Transfer,,PaymentServiceB Checking **7257,Account1,-50000,20099803.1
09/27/2021,Expense,Income Capitals ,"Income Capitals , Akhil payment for time till Sep 3",Account1,14990,20114793.1
09/27/2021,Expense,Income Capitals ,Income Capitals ,Professional Service Charges,-14990,20099803.1
09/27/2021,Expense,Income Capitals ,"Income Capitals , Akhil payment for time till Sep 3",Account1,14990,20114793.1
09/27/2021,Expense,Income Capitals ,Income Capitals ,Professional Service Charges,-14990,20099803.1
09/27/2021,Transfer,,PaymentServiceB Checking **7257,Account1,-50000,20049803.1
09/27/2021,Transfer,,PaymentServiceB Checking **7257,Account1,-50000,19999803.1
09/27/2021,Expense,Income Capitals ,"Income Capitals , Akhil payment for time till Sep 3",Account1,14990,20014793.1
09/27/2021,Expense,Income Capitals ,Income Capitals ,Professional Service Charges,-14990,19999803.1
09/27/2021,Transfer,,PaymentServiceB Checking **7257,Savings (6977),50000,20049803.1
09/27/2021,Transfer,,PaymentServiceB Checking **7257,Account1,-50000,19999803.1
09/27/2021,Expense,Income Capitals ,"Income Capitals , Akhil payment for time till Sep 3",Account1,14990,20014793.1
09/27/2021,Expense,Income Capitals ,Income Capitals ,Professional Service Charges,-14990,19999803.1
09/30/2021,Expense,Adobe,,Tools & Subscription - S&M,15.96,19999819.06
09/30/2021,Expense,Adobe,Mike ross,Credit Card - Ramp,15.96,19999835.02
09/30/2021,Expense,Adobe,Mike ross,Credit Card - Ramp,15.96,19999850.98
09/30/2021,Expense,Adobe,,Tools & Subscription - S&M,15.96,19999866.94
09/30/2021,Expense,Adobe,Mike ross,Credit Card - Ramp,15.96,19999882.9
09/30/2021,Expense,Adobe,,Tools & Subscription - S&M,15.96,19999898.86
09/30/2021,Expense,Adobe,,Tools & Subscription - S&M,15.96,19999914.82
10/01/2021,Expense,Income Capitals ,Income Capitals ,Professional Service Charges,-4761.09,19995153.73
10/01/2021,Expense,Income Capitals ,Income Capitals ,laptop - Macbook,-2015.34,19993138.39
10/01/2021,Expense,Income Capitals ,Income Capitals ,laptop - Macbook,-2015.34,19991123.05
10/01/2021,Deposit,,Interest Accrual,Interest Received,0.95,19991124
10/01/2021,Expense,Slack,Mike ross,Credit Card - Ramp,78.46,19991202.46
10/01/2021,Expense,Slack,,Tools & Subscription - G&A,78.46,19991280.92
10/01/2021,Expense,Income Capitals ,"Income Capitals , Tejas - July Sal",Account1,4761.09,19996042.01
10/01/2021,Expense,Income Capitals ,"Income Capitals , Tejas - July Sal",Account1,4761.09,20000803.1
10/01/2021,Deposit,,Interest Accrual,Savings (6977),0.95,20000804.05
10/01/2021,Expense,Income Capitals ,"Income Capitals , Tejas - July Sal",Account1,4761.09,20005565.14
10/01/2021,Deposit,,Interest Accrual,Interest Received,0.95,20005566.09
10/01/2021,Deposit,,Interest Accrual,Interest Received,0.95,20005567.04
10/01/2021,Expense,Income Capitals ,Income Capitals ,Professional Service Charges,-4761.09,20000805.95
10/01/2021,Expense,Slack,,Tools & Subscription - G&A,78.46,20000884.41
10/01/2021,Expense,Income Capitals ,"Income Capitals , Aheilan Laptop",Account1,2015.34,20002899.75
10/01/2021,Expense,Income Capitals ,Income Capitals ,laptop - Macbook,-2015.34,20000884.41
10/01/2021,Expense,Slack,,Tools & Subscription - G&A,78.46,20000962.87
10/01/2021,Expense,Income Capitals ,"Income Capitals , Aheilan Laptop",Account1,2015.34,20002978.21
10/01/2021,Expense,Income Capitals ,Income Capitals ,Professional Service Charges,-4761.09,19998217.12
10/01/2021,Expense,Income Capitals ,"Income Capitals , Tejas - July Sal",Account1,4761.09,20002978.21
10/01/2021,Expense,Income Capitals ,Income Capitals ,laptop - Macbook,-2015.34,20000962.87
10/01/2021,Deposit,,Interest Accrual,Savings (6977),0.95,20000963.82
10/01/2021,Deposit,,Interest Accrual,Savings (6977),0.95,20000964.77
10/01/2021,Expense,Income Capitals ,"Income Capitals , Aheilan Laptop",Account1,2015.34,20002980.11
10/01/2021,Expense,Income Capitals ,Income Capitals ,Professional Service Charges,-4761.09,19998219.02
10/01/2021,Deposit,,Interest Accrual,Interest Received,0.95,19998219.97
10/01/2021,Expense,Slack,Mike ross,Credit Card - Ramp,78.46,19998298.43
10/01/2021,Expense,Slack,,Tools & Subscription - G&A,78.46,19998376.89
10/01/2021,Expense,Slack,Mike ross,Credit Card - Ramp,78.46,19998455.35
10/01/2021,Expense,Income Capitals ,"Income Capitals , Aheilan Laptop",Account1,2015.34,20000470.69
10/02/2021,Expense,Google G Suite,Mike ross,Credit Card - Ramp,69.95,20000540.64
10/02/2021,Expense,Google G Suite,,Tools & Subscription - G&A,69.95,20000610.59
10/02/2021,Expense,Google G Suite,Mike ross,Credit Card - Ramp,69.95,20000680.54
10/02/2021,Expense,Google G Suite,,Tools & Subscription - G&A,69.95,20000750.49
10/02/2021,Expense,Google G Suite,,Tools & Subscription - G&A,69.95,20000820.44
10/02/2021,Expense,Google G Suite,,Tools & Subscription - G&A,69.95,20000890.39
10/02/2021,Expense,Google G Suite,Mike ross,Credit Card - Ramp,69.95,20000960.34
10/03/2021,Expense,Mazurek Co,,Tools & Subscription - G&A,29.95,20000990.29
10/03/2021,Expense,Mazurek Co,Harvey Spector,Credit Card - Ramp,29.95,20001020.24
10/03/2021,Expense,Mazurek Co,,Tools & Subscription - G&A,29.95,20001050.19
10/03/2021,Expense,Mazurek Co,,Tools & Subscription - G&A,29.95,20001080.14
10/03/2021,Expense,Mazurek Co,Harvey Spector,Credit Card - Ramp,29.95,20001110.09
10/03/2021,Expense,Mazurek Co,,Tools & Subscription - G&A,29.95,20001140.04
10/03/2021,Expense,Mazurek Co,Harvey Spector,Credit Card - Ramp,29.95,20001169.99
10/04/2021,Expense,Roberts Zimmerman PLLC,"Roberts Zimmerman PLLC, Legal fees - Ryan Roberts",Account1,6000,20007169.99
10/04/2021,Expense,Roberts Zimmerman PLLC,"Roberts Zimmerman PLLC, Legal fees - Ryan Roberts",Account1,6000,20013169.99
10/04/2021,Expense,Roberts Zimmerman PLLC,"Roberts Zimmerman PLLC, Legal fees - Ryan Roberts",Account1,6000,20019169.99
10/04/2021,Expense,Roberts Zimmerman PLLC,Roberts Zimmerman PLLC,Legal & accounting services:Legal Fees,-6000,20013169.99
10/04/2021,Expense,Roberts Zimmerman PLLC,Roberts Zimmerman PLLC,Legal & accounting services:Legal Fees,-6000,20007169.99
10/04/2021,Expense,Roberts Zimmerman PLLC,Roberts Zimmerman PLLC,Legal & accounting services:Legal Fees,-6000,20001169.99
10/04/2021,Expense,Roberts Zimmerman PLLC,Roberts Zimmerman PLLC,Legal & accounting services:Legal Fees,-6000,19995169.99
10/04/2021,Expense,Roberts Zimmerman PLLC,"Roberts Zimmerman PLLC, Legal fees - Ryan Roberts",Account1,6000,20001169.99
10/06/2021,Expense,Conversion.Ai,Harvey Spector,Tools & Subscription - S&M,119,20001288.99
10/06/2021,Expense,Income Capitals ,Income Capitals ,Professional Service Charges,-3481.42,19997807.57
10/06/2021,Expense,Income Capitals ,"Income Capitals , Ahielan - Sept Sal",Account1,3481.42,20001288.99
10/06/2021,Expense,Income Capitals ,"Income Capitals , Ahielan - Sept Sal",Account1,3481.42,20004770.41
10/06/2021,Expense,Conversion.Ai,Harvey Spector,Credit Card - Ramp,119,20004889.41
10/06/2021,Expense,Income Capitals ,Income Capitals ,Professional Service Charges,-3481.42,20001407.99
10/06/2021,Expense,Income Capitals ,Income Capitals ,Professional Service Charges,-3481.42,19997926.57
10/06/2021,Expense,Conversion.Ai,Harvey Spector,Credit Card - Ramp,119,19998045.57
10/06/2021,Expense,Conversion.Ai,Harvey Spector,Credit Card - Ramp,119,19998164.57
10/06/2021,Expense,Conversion.Ai,Harvey Spector,Tools & Subscription - S&M,119,19998283.57
10/06/2021,Expense,Income Capitals ,Income Capitals ,Professional Service Charges,-3481.42,19994802.15
10/06/2021,Expense,Conversion.Ai,Harvey Spector,Tools & Subscription - S&M,119,19994921.15
10/06/2021,Expense,Conversion.Ai,Harvey Spector,Tools & Subscription - S&M,119,19995040.15
10/06/2021,Expense,Income Capitals ,"Income Capitals , Ahielan - Sept Sal",Account1,3481.42,19998521.57
10/06/2021,Expense,Income Capitals ,"Income Capitals , Ahielan - Sept Sal",Account1,3481.42,20002002.99
10/07/2021,Expense,Mailchimp,Mike ross,Credit Card - Ramp,20.51,20002023.5
10/07/2021,Expense,Mailchimp,Mike ross,Credit Card - Ramp,20.51,20002044.01
10/07/2021,Expense,Mailchimp,,Tools & Subscription - G&A,20.51,20002064.52
10/07/2021,Expense,Mailchimp,,Tools & Subscription - G&A,20.51,20002085.03
10/07/2021,Expense,Mailchimp,,Tools & Subscription - G&A,20.51,20002105.54
10/07/2021,Expense,Mailchimp,,Tools & Subscription - G&A,20.51,20002126.05
10/07/2021,Expense,Mailchimp,Mike ross,Credit Card - Ramp,20.51,20002146.56
10/11/2021,Expense,Heroku,Balapavan Tirumani,Credit Card - Ramp,7.01,20002153.57
10/11/2021,Expense,Heroku,Balapavan Tirumani,Tools & Subscription - S&M,7.01,20002160.58
10/11/2021,Expense,Heroku,Balapavan Tirumani,Tools & Subscription - S&M,7.01,20002167.59
10/11/2021,Expense,Heroku,Balapavan Tirumani,Tools & Subscription - S&M,7.01,20002174.6
10/11/2021,Expense,Heroku,Balapavan Tirumani,Tools & Subscription - S&M,7.01,20002181.61
10/11/2021,Expense,Heroku,Balapavan Tirumani,Credit Card - Ramp,7.01,20002188.62
10/11/2021,Expense,Heroku,Balapavan Tirumani,Credit Card - Ramp,7.01,20002195.63
10/13/2021,Expense,Zoom,,Tools & Subscription - G&A,170.51,20002366.14
10/13/2021,Expense,Figma,,Tools & Subscription - G&A,105,20002471.14
10/13/2021,Expense,Zoom,,Tools & Subscription - G&A,170.51,20002641.65
10/13/2021,Expense,Zoom,,Tools & Subscription - G&A,170.51,20002812.16
10/13/2021,Expense,Figma,,Tools & Subscription - G&A,105,20002917.16
10/13/2021,Expense,Zoom,Chris George,Credit Card - Ramp,170.51,20003087.67
10/13/2021,Expense,Figma,Mike ross,Credit Card - Ramp,105,20003192.67
10/13/2021,Expense,Figma,Mike ross,Credit Card - Ramp,105,20003297.67
10/13/2021,Expense,Figma,Mike ross,Credit Card - Ramp,105,20003402.67
10/13/2021,Expense,Zoom,Chris George,Credit Card - Ramp,170.51,20003573.18
10/13/2021,Expense,Zoom,Chris George,Credit Card - Ramp,170.51,20003743.69
10/13/2021,Expense,Figma,,Tools & Subscription - G&A,105,20003848.69
10/13/2021,Expense,Figma,,Tools & Subscription - G&A,105,20003953.69
10/13/2021,Expense,Zoom,,Tools & Subscription - G&A,170.51,20004124.2
10/18/2021,Expense,Ghost,,Tools & Subscription - G&A,31,20004155.2
10/18/2021,Expense,Ghost,,Tools & Subscription - G&A,31,20004186.2
10/18/2021,Expense,Ghost,Harvey Spector,Credit Card - Ramp,31,20004217.2
10/18/2021,Expense,Ghost,,Tools & Subscription - G&A,31,20004248.2
10/18/2021,Expense,Ghost,,Tools & Subscription - G&A,31,20004279.2
10/18/2021,Expense,Ghost,Harvey Spector,Credit Card - Ramp,31,20004310.2
10/18/2021,Expense,Ghost,Harvey Spector,Credit Card - Ramp,31,20004341.2
10/20/2021,Credit Card Payment,,RAMP BUSINESS CO,Account1,-994.1,20003347.1
10/20/2021,Expense,Namecheap,Harvey Spector,Credit Card - Ramp,1.18,20003348.28
10/20/2021,Credit Card Payment,,RAMP BUSINESS CO,Account1,-994.1,20002354.18
10/20/2021,Expense,Big Company ,Big Company ,Account1,-40000,19962354.18
10/20/2021,Expense,Namecheap,,Tools & Subscription - G&A,1.18,19962355.36
10/20/2021,Transfer,,PaymentServiceB Checking **7257,Account1,-40000,19922355.36
10/20/2021,Expense,Big Company ,Big Company ,Accounts Payable (A/P),-40000,19882355.36
10/20/2021,Credit Card Payment,,RAMP BUSINESS CO,Account1,-994.1,19881361.26
10/20/2021,Transfer,,PaymentServiceB Checking **7257,Account1,-40000,19841361.26
10/20/2021,Expense,Big Company ,Big Company ,Accounts Payable (A/P),-40000,19801361.26
10/20/2021,Expense,Namecheap,Harvey Spector,Credit Card - Ramp,1.18,19801362.44
10/20/2021,Expense,Big Company ,Big Company ,Accounts Payable (A/P),-40000,19761362.44
10/20/2021,Expense,Big Company ,Big Company ,Accounts Payable (A/P),-40000,19721362.44
10/20/2021,Expense,Namecheap,,Tools & Subscription - G&A,1.18,19721363.62
10/20/2021,Expense,Namecheap,,Tools & Subscription - G&A,1.18,19721364.8
10/20/2021,Credit Card Payment,,RAMP BUSINESS CO,Credit Card - Ramp,-994.1,19720370.7
10/20/2021,Credit Card Payment,,RAMP BUSINESS CO,Credit Card - Ramp,-994.1,19719376.6
10/20/2021,Transfer,,PaymentServiceB Checking **7257,Savings (6977),40000,19759376.6
10/20/2021,Expense,Namecheap,,Tools & Subscription - G&A,1.18,19759377.78
10/20/2021,Transfer,,PaymentServiceB Checking **7257,Savings (6977),40000,19799377.78
10/20/2021,Credit Card Payment,,RAMP BUSINESS CO,Credit Card - Ramp,-994.1,19798383.68
10/20/2021,Expense,Big Company ,Big Company ,Account1,-40000,19758383.68
10/20/2021,Expense,Big Company ,Big Company ,Account1,-40000,19718383.68
10/20/2021,Expense,Big Company ,Big Company ,Account1,-40000,19678383.68
10/20/2021,Credit Card Payment,,RAMP BUSINESS CO,Account1,-994.1,19677389.58
10/20/2021,Transfer,,PaymentServiceB Checking **7257,Account1,-40000,19637389.58
10/20/2021,Transfer,,PaymentServiceB Checking **7257,Account1,-40000,19597389.58
10/20/2021,Expense,Namecheap,Harvey Spector,Credit Card - Ramp,1.18,19597390.76
10/20/2021,Transfer,,PaymentServiceB Checking **7257,Savings (6977),40000,19637390.76
10/20/2021,Credit Card Payment,,RAMP BUSINESS CO,Credit Card - Ramp,-994.1,19636396.66
10/20/2021,Transfer,,PaymentServiceB Checking **7257,Savings (6977),40000,19676396.66
10/21/2021,Expense,Product Hunt,Harvey Spector,Advertising & marketing,79,19676475.66
10/21/2021,Expense,Product Hunt,Harvey Spector,Advertising & marketing,79,19676554.66
10/21/2021,Expense,Product Hunt,Harvey Spector,Advertising & marketing,79,19676633.66
10/21/2021,Expense,Product Hunt,Harvey Spector,Credit Card - Ramp,79,19676712.66
10/21/2021,Expense,Product Hunt,Harvey Spector,Credit Card - Ramp,79,19676791.66
10/21/2021,Expense,Product Hunt,Harvey Spector,Credit Card - Ramp,79,19676870.66
10/21/2021,Expense,Product Hunt,Harvey Spector,Credit Card - Ramp,79,19676949.66
10/21/2021,Expense,Product Hunt,Harvey Spector,Advertising & marketing,79,19677028.66
10/22/2021,Expense,Dovetail,,Tools & Subscription - G&A,27.48,19677056.14
10/22/2021,Expense,Dovetail,,Tools & Subscription - G&A,27.48,19677083.62
10/22/2021,Expense,Dovetail,,Tools & Subscription - G&A,27.48,19677111.1
10/22/2021,Expense,Dovetail,Harvey Spector,Credit Card - Ramp,27.48,19677138.58
10/22/2021,Expense,Dovetail,Harvey Spector,Credit Card - Ramp,27.48,19677166.06
10/22/2021,Expense,Dovetail,Harvey Spector,Credit Card - Ramp,27.48,19677193.54
10/22/2021,Expense,Dovetail,,Tools & Subscription - G&A,27.48,19677221.02
10/23/2021,Expense,Superhuman,,Professional Service Charges,30,19677251.02
10/23/2021,Expense,Superhuman,,Professional Service Charges,30,19677281.02
10/23/2021,Expense,Superhuman,,Professional Service Charges,30,19677311.02
10/23/2021,Expense,Superhuman,Mike ross,Credit Card - Ramp,30,19677341.02
10/23/2021,Expense,Superhuman,Mike ross,Credit Card - Ramp,30,19677371.02
10/23/2021,Expense,Superhuman,,Professional Service Charges,30,19677401.02
10/23/2021,Expense,Superhuman,Mike ross,Credit Card - Ramp,30,19677431.02
10/23/2021,Expense,Superhuman,Mike ross,Credit Card - Ramp,30,19677461.02
10/26/2021,Credit Card Credit,Superhuman,Mike ross,Credit Card - Ramp,-30,19677431.02
10/26/2021,Credit Card Credit,Superhuman,Mike ross,Credit Card - Ramp,-30,19677401.02
10/26/2021,Credit Card Credit,Superhuman,Mike ross,Credit Card - Ramp,-30,19677371.02
10/26/2021,Credit Card Credit,Superhuman,,Professional Service Charges,-30,19677341.02
10/26/2021,Credit Card Credit,Superhuman,,Professional Service Charges,-30,19677311.02
10/26/2021,Credit Card Credit,Superhuman,,Professional Service Charges,-30,19677281.02
10/26/2021,Credit Card Credit,Superhuman,Mike ross,Credit Card - Ramp,-30,19677251.02
10/26/2021,Credit Card Credit,Superhuman,,Professional Service Charges,-30,19677221.02
10/27/2021,Expense,Sendinblue,Balapavan Tirumani,Credit Card - Ramp,52.02,19677273.04
10/27/2021,Expense,Namecheap,,Tools & Subscription - G&A,6.16,19677279.2
10/27/2021,Expense,Splitbee,,Tools & Subscription - G&A,16.52,19677295.72
10/27/2021,Expense,Sendinblue,,Tools & Subscription - G&A,52.02,19677347.74
10/27/2021,Expense,Splitbee,Harris Jose,Credit Card - Ramp,16.52,19677364.26
10/27/2021,Expense,Sendinblue,Balapavan Tirumani,Credit Card - Ramp,52.02,19677416.28
10/27/2021,Expense,Namecheap,,Tools & Subscription - G&A,6.16,19677422.44
10/27/2021,Expense,Namecheap,Harris Jose,Credit Card - Ramp,6.16,19677428.6
10/27/2021,Expense,Splitbee,Harris Jose,Credit Card - Ramp,16.52,19677445.12
10/27/2021,Expense,Namecheap,Harris Jose,Credit Card - Ramp,6.16,19677451.28
10/27/2021,Expense,Namecheap,Harris Jose,Credit Card - Ramp,6.16,19677457.44
10/27/2021,Expense,Sendinblue,,Tools & Subscription - G&A,52.02,19677509.46
10/27/2021,Expense,Sendinblue,,Tools & Subscription - G&A,52.02,19677561.48
10/27/2021,Expense,Splitbee,,Tools & Subscription - G&A,16.52,19677578
10/27/2021,Expense,Namecheap,,Tools & Subscription - G&A,6.16,19677584.16
10/27/2021,Expense,Sendinblue,Balapavan Tirumani,Credit Card - Ramp,52.02,19677636.18
10/27/2021,Expense,Splitbee,Harris Jose,Credit Card - Ramp,16.52,19677652.7
10/27/2021,Expense,Namecheap,,Tools & Subscription - G&A,6.16,19677658.86
10/27/2021,Expense,Splitbee,,Tools & Subscription - G&A,16.52,19677675.38
10/27/2021,Expense,Sendinblue,,Tools & Subscription - G&A,52.02,19677727.4
10/27/2021,Expense,Splitbee,,Tools & Subscription - G&A,16.52,19677743.92
10/29/2021,Expense,Privacy policy,,Tools & Subscription - G&A,127,19677870.92
10/29/2021,Expense,Privacy policy,Harvey Spector,Credit Card - Ramp,127,19677997.92
10/29/2021,Expense,Privacy policy,,Tools & Subscription - G&A,127,19678124.92
10/29/2021,Expense,Privacy policy,Harvey Spector,Credit Card - Ramp,127,19678251.92
10/29/2021,Expense,Privacy policy,Harvey Spector,Credit Card - Ramp,127,19678378.92
10/29/2021,Expense,Privacy policy,,Tools & Subscription - G&A,127,19678505.92
10/29/2021,Expense,Privacy policy,,Tools & Subscription - G&A,127,19678632.92
10/31/2021,Expense,Adobe,,Tools & Subscription - S&M,16.62,19678649.54
10/31/2021,Expense,Adobe,,Tools & Subscription - S&M,16.62,19678666.16
10/31/2021,Bill,Big Company ,Service Expenses for the month of October 2021,Accounts Payable (A/P),40000,19718666.16
10/31/2021,Bill,Big Company ,,Outsources Services - India,40000,19758666.16
10/31/2021,Expense,Adobe,Mike ross,Credit Card - Ramp,16.62,19758682.78
10/31/2021,Expense,Adobe,,Tools & Subscription - S&M,16.62,19758699.4
10/31/2021,Bill,Big Company ,,Outsources Services - India,40000,19798699.4
10/31/2021,Bill,Big Company ,,Outsources Services - India,40000,19838699.4
10/31/2021,Expense,Adobe,Mike ross,Credit Card - Ramp,16.62,19838716.02
10/31/2021,Bill,Big Company ,Service Expenses for the month of October 2021,Accounts Payable (A/P),40000,19878716.02
10/31/2021,Bill,Big Company ,,Outsources Services - India,40000,19918716.02
10/31/2021,Bill,Big Company ,Service Expenses for the month of October 2021,Accounts Payable (A/P),40000,19958716.02
10/31/2021,Bill,Big Company ,Service Expenses for the month of October 2021,Accounts Payable (A/P),40000,19998716.02
10/31/2021,Expense,Adobe,,Tools & Subscription - S&M,16.62,19998732.64
10/31/2021,Expense,Adobe,Mike ross,Credit Card - Ramp,16.62,19998749.26
11/01/2021,Expense,Gradient,,Tools & Subscription - G&A,240,19998989.26
11/01/2021,Expense,Gradient,,Tools & Subscription - G&A,240,19999229.26
11/01/2021,Expense,Gradient,Mike ross,Credit Card - Ramp,240,19999469.26
11/01/2021,Expense,Gradient,,Tools & Subscription - G&A,240,19999709.26
11/01/2021,Expense,Gradient,Mike ross,Credit Card - Ramp,240,19999949.26
11/01/2021,Expense,Gradient,,Tools & Subscription - G&A,240,20000189.26
11/01/2021,Expense,Gradient,Mike ross,Credit Card - Ramp,240,20000429.26
11/02/2021,Expense,Google G Suite,,Tools & Subscription - G&A,76.63,20000505.89
11/02/2021,Expense,Income Capitals ,Income Capitals  Jade - Sept Sal,Account1,280,20000785.89
11/02/2021,Expense,Income Capitals ,Income Capitals  Jade - Sept Sal,Account1,280,20001065.89
11/02/2021,Expense,Income Capitals ,Income Capitals  Jade - Sept Sal,Account1,280,20001345.89
11/02/2021,Expense,Income Capitals ,Income Capitals  Jade - Oct Sal,Account1,2285,20003630.89
11/02/2021,Expense,Google G Suite,Mike ross,Credit Card - Ramp,76.63,20003707.52
11/02/2021,Expense,UsabilityHub,Chris George,Credit Card - Ramp,50,20003757.52
11/02/2021,Expense,UsabilityHub,Chris George,Credit Card - Ramp,20,20003777.52
11/02/2021,Expense,UsabilityHub,,Tools & Subscription - G&A,20,20003797.52
11/02/2021,Expense,Pony Express,Harvey Spector,Credit Card - Ramp,49,20003846.52
11/02/2021,Expense,Google G Suite,,Tools & Subscription - G&A,76.63,20003923.15
11/02/2021,Expense,Pony Express,,Tools & Subscription - G&A,49,20003972.15
11/02/2021,Expense,UsabilityHub,,Tools & Subscription - G&A,50,20004022.15
11/02/2021,Expense,UsabilityHub,,Tools & Subscription - G&A,50,20004072.15
11/02/2021,Expense,Income Capitals ,Income Capitals  Jade - Oct Sal,Account1,2285,20006357.15
11/02/2021,Expense,UsabilityHub,Chris George,Credit Card - Ramp,50,20006407.15
11/02/2021,Expense,Google G Suite,,Tools & Subscription - G&A,76.63,20006483.78
11/02/2021,Expense,UsabilityHub,,Tools & Subscription - G&A,50,20006533.78
11/02/2021,Expense,Pony Express,,Tools & Subscription - G&A,49,20006582.78
11/02/2021,Expense,UsabilityHub,,Tools & Subscription - G&A,20,20006602.78
11/02/2021,Expense,UsabilityHub,,Tools & Subscription - G&A,20,20006622.78
11/02/2021,Expense,Pony Express,,Tools & Subscription - G&A,49,20006671.78
11/02/2021,Expense,UsabilityHub,Chris George,Credit Card - Ramp,20,20006691.78
11/02/2021,Expense,Income Capitals ,Income Capitals ,Professional Service Charges,-280,20006411.78
11/02/2021,Expense,UsabilityHub,,Tools & Subscription - G&A,50,20006461.78
11/02/2021,Expense,Pony Express,,Tools & Subscription - G&A,49,20006510.78
11/02/2021,Expense,Income Capitals ,Income Capitals ,Professional Service Charges,-280,20006230.78
11/02/2021,Expense,Income Capitals ,Income Capitals  Jade - Sept Sal,Account1,280,20006510.78
11/02/2021,Expense,UsabilityHub,,Tools & Subscription - G&A,20,20006530.78
11/02/2021,Expense,Google G Suite,,Tools & Subscription - G&A,76.63,20006607.41
11/02/2021,Expense,Pony Express,Harvey Spector,Credit Card - Ramp,49,20006656.41
11/02/2021,Expense,Income Capitals ,Income Capitals  Jade - Oct Sal,Account1,2285,20008941.41
11/02/2021,Expense,Income Capitals ,Income Capitals ,Professional Service Charges,-280,20008661.41
11/02/2021,Expense,Income Capitals ,Income Capitals ,Professional Service Charges,-2285,20006376.41
11/02/2021,Expense,Google G Suite,Mike ross,Credit Card - Ramp,76.63,20006453.04
11/02/2021,Expense,UsabilityHub,Chris George,Credit Card - Ramp,50,20006503.04
11/02/2021,Expense,Google G Suite,Mike ross,Credit Card - Ramp,76.63,20006579.67
11/02/2021,Expense,Income Capitals ,Income Capitals ,Professional Service Charges,-2285,20004294.67
11/02/2021,Expense,Pony Express,Harvey Spector,Credit Card - Ramp,49,20004343.67
11/02/2021,Expense,UsabilityHub,Chris George,Credit Card - Ramp,20,20004363.67
11/02/2021,Expense,Income Capitals ,Income Capitals ,Professional Service Charges,-2285,20002078.67
11/02/2021,Expense,Income Capitals ,Income Capitals ,Professional Service Charges,-2285,19999793.67
11/02/2021,Expense,Income Capitals ,Income Capitals  Jade - Oct Sal,Account1,2285,20002078.67
11/02/2021,Expense,Income Capitals ,Income Capitals ,Professional Service Charges,-280,20001798.67
11/03/2021,Deposit,,International Wire Partner,Investment in India Subsidiary,45,20001843.67
11/03/2021,Deposit,,Interest Accrual,Savings (6977),1.67,20001845.34
11/03/2021,Deposit,,Interest Accrual,Interest Received,1.67,20001847.01
11/03/2021,Deposit,,Interest Accrual,Interest Received,1.67,20001848.68
11/03/2021,Deposit,,International Wire Partner,Investment in India Subsidiary,45,20001893.68
11/03/2021,Deposit,,Interest Accrual,Interest Received,1.67,20001895.35
11/03/2021,Expense,Mazurek Co,,Tools & Subscription - G&A,29.95,20001925.3
11/03/2021,Deposit,,International Wire Partner,Account1,-45,20001880.3
11/03/2021,Expense,Mazurek Co,,Tools & Subscription - G&A,29.95,20001910.25
11/03/2021,Expense,Mazurek Co,,Tools & Subscription - G&A,29.95,20001940.2
11/03/2021,Expense,Mazurek Co,Harvey Spector,Credit Card - Ramp,29.95,20001970.15
11/03/2021,Expense,Mazurek Co,Harvey Spector,Credit Card - Ramp,29.95,20002000.1
11/03/2021,Deposit,,Interest Accrual,Savings (6977),1.67,20002001.77
11/03/2021,Deposit,,Interest Accrual,Savings (6977),1.67,20002003.44
11/03/2021,Expense,Mazurek Co,,Tools & Subscription - G&A,29.95,20002033.39
11/03/2021,Deposit,,International Wire Partner,Account1,-45,20001988.39
11/03/2021,Deposit,,International Wire Partner,Investment in India Subsidiary,45,20002033.39
11/03/2021,Deposit,,International Wire Partner,Investment in India Subsidiary,45,20002078.39
11/03/2021,Expense,Mazurek Co,Harvey Spector,Credit Card - Ramp,29.95,20002108.34
11/03/2021,Deposit,,International Wire Partner,Account1,-45,20002063.34
11/03/2021,Deposit,,Interest Accrual,Interest Received,1.67,20002065.01
11/03/2021,Deposit,,International Wire Partner,Account1,-45,20002020.01
11/06/2021,Expense,Conversion.Ai,Harvey Spector,Tools & Subscription - S&M,119,20002139.01
11/06/2021,Expense,Conversion.Ai,Harvey Spector,Tools & Subscription - S&M,119,20002258.01
11/06/2021,Expense,Conversion.Ai,Harvey Spector,Credit Card - Ramp,119,20002377.01
11/06/2021,Expense,Conversion.Ai,Harvey Spector,Tools & Subscription - S&M,119,20002496.01
11/06/2021,Expense,Conversion.Ai,Harvey Spector,Credit Card - Ramp,119,20002615.01
11/06/2021,Expense,Conversion.Ai,Harvey Spector,Credit Card - Ramp,119,20002734.01
11/06/2021,Expense,Conversion.Ai,Harvey Spector,Tools & Subscription - S&M,119,20002853.01
11/07/2021,Expense,Mailchimp,Mike ross,Credit Card - Ramp,31.01,20002884.02
11/07/2021,Expense,Mailchimp,Mike ross,Credit Card - Ramp,31.01,20002915.03
11/07/2021,Expense,Mailchimp,,Tools & Subscription - G&A,31.01,20002946.04
11/07/2021,Expense,Mailchimp,Mike ross,Credit Card - Ramp,31.01,20002977.05
11/07/2021,Expense,Mailchimp,,Tools & Subscription - G&A,31.01,20003008.06
11/07/2021,Expense,Mailchimp,,Tools & Subscription - G&A,31.01,20003039.07
11/07/2021,Expense,Mailchimp,,Tools & Subscription - G&A,31.01,20003070.08
11/08/2021,Expense,Hcm Trends,,General business expenses:Memberships & subscriptions,1,20003071.08
11/08/2021,Expense,Hcm Trends,Harvey Spector,Credit Card - Ramp,1,20003072.08
11/08/2021,Expense,Hcm Trends,Harvey Spector,Credit Card - Ramp,1,20003073.08
11/08/2021,Expense,Hcm Trends,,General business expenses:Memberships & subscriptions,1,20003074.08
11/08/2021,Expense,Hcm Trends,,General business expenses:Memberships & subscriptions,1,20003075.08
11/08/2021,Expense,Hcm Trends,,General business expenses:Memberships & subscriptions,1,20003076.08
11/08/2021,Expense,Hcm Trends,Harvey Spector,Credit Card - Ramp,1,20003077.08
11/08/2021,Expense,Hcm Trends,Harvey Spector,Credit Card - Ramp,1,20003078.08
11/09/2021,Expense,Heroku,Balapavan Tirumani,Tools & Subscription - S&M,7,20003085.08
11/09/2021,Expense,Heroku,Balapavan Tirumani,Tools & Subscription - S&M,7,20003092.08
11/09/2021,Expense,Heroku,Balapavan Tirumani,Credit Card - Ramp,7,20003099.08
11/09/2021,Expense,Heroku,Balapavan Tirumani,Tools & Subscription - S&M,7,20003106.08
11/09/2021,Expense,Heroku,Balapavan Tirumani,Credit Card - Ramp,7,20003113.08
11/09/2021,Expense,Heroku,Balapavan Tirumani,Tools & Subscription - S&M,7,20003120.08
11/09/2021,Expense,Heroku,Balapavan Tirumani,Credit Card - Ramp,7,20003127.08
11/10/2021,Expense,Vistara,Mike ross,Credit Card - Ramp,62.49,20003189.57
11/10/2021,Expense,Otter,Harvey Spector,Credit Card - Ramp,12.99,20003202.56
11/10/2021,Expense,Otter,,Tools & Subscription - G&A,12.99,20003215.55
11/10/2021,Expense,Vistara,,Travel:Airfare,62.49,20003278.04
11/10/2021,Expense,Vistara,,Travel:Airfare,62.49,20003340.53
11/10/2021,Expense,Otter,,Tools & Subscription - G&A,12.99,20003353.52
11/10/2021,Expense,Vistara,Mike ross,Credit Card - Ramp,62.49,20003416.01
11/10/2021,Expense,Otter,,Tools & Subscription - G&A,12.99,20003429
11/10/2021,Expense,Vistara,,Travel:Airfare,62.49,20003491.49
11/10/2021,Expense,Vistara,Mike ross,Credit Card - Ramp,62.49,20003553.98
11/10/2021,Expense,Otter,,Tools & Subscription - G&A,12.99,20003566.97
11/10/2021,Expense,Otter,Harvey Spector,Credit Card - Ramp,12.99,20003579.96
11/10/2021,Expense,Otter,Harvey Spector,Credit Card - Ramp,12.99,20003592.95
11/10/2021,Expense,Vistara,,Travel:Airfare,62.49,20003655.44
11/11/2021,Expense,Gumroad,Harvey Spector,Professional Service Charges,48,20003703.44
11/11/2021,Expense,Gumroad,Harvey Spector,Credit Card - Ramp,48,20003751.44
11/11/2021,Expense,Gumroad,Harvey Spector,Professional Service Charges,48,20003799.44
11/11/2021,Expense,Gumroad,Harvey Spector,Professional Service Charges,48,20003847.44
11/11/2021,Expense,Gumroad,Harvey Spector,Credit Card - Ramp,48,20003895.44
11/11/2021,Expense,Gumroad,Harvey Spector,Professional Service Charges,48,20003943.44
11/11/2021,Expense,Gumroad,Harvey Spector,Credit Card - Ramp,48,20003991.44
11/11/2021,Expense,Gumroad,Harvey Spector,Credit Card - Ramp,48,20004039.44
11/12/2021,Expense,Intuit India,,Tools & Subscription - G&A,0.07,20004039.51
11/12/2021,Expense,Glimpse,Harvey Spector,Credit Card - Ramp,29,20004068.51
11/12/2021,Expense,Glimpse,Harvey Spector,Tools & Subscription,29,20004097.51
11/12/2021,Expense,Glimpse,Harvey Spector,Tools & Subscription,29,20004126.51
11/12/2021,Expense,Intuit India,,Tools & Subscription - G&A,5.05,20004131.56
11/12/2021,Expense,Glimpse,Harvey Spector,Tools & Subscription,29,20004160.56
11/12/2021,Expense,Glimpse,Harvey Spector,Credit Card - Ramp,29,20004189.56
11/12/2021,Expense,Intuit India,,Tools & Subscription - G&A,5.05,20004194.61
11/12/2021,Expense,Intuit India,,Tools & Subscription - G&A,0.07,20004194.68
11/12/2021,Expense,Glimpse,Harvey Spector,Credit Card - Ramp,29,20004223.68
11/12/2021,Expense,Intuit India,,Tools & Subscription - G&A,5.05,20004228.73
11/12/2021,Expense,Intuit India,Harvey Spector,Credit Card - Ramp,5.05,20004233.78
11/12/2021,Expense,Intuit India,Harvey Spector,Credit Card - Ramp,0.07,20004233.85
11/12/2021,Expense,Intuit India,,Tools & Subscription - G&A,0.07,20004233.92
11/12/2021,Expense,Intuit India,Harvey Spector,Credit Card - Ramp,0.07,20004233.99
11/12/2021,Expense,Intuit India,Harvey Spector,Credit Card - Ramp,5.05,20004239.04
11/12/2021,Expense,Intuit India,Harvey Spector,Credit Card - Ramp,0.07,20004239.11
11/12/2021,Expense,Intuit India,,Tools & Subscription - G&A,0.07,20004239.18
11/12/2021,Expense,Intuit India,,Tools & Subscription - G&A,5.05,20004244.23
11/12/2021,Expense,Intuit India,Harvey Spector,Credit Card - Ramp,5.05,20004249.28
11/12/2021,Expense,Glimpse,Harvey Spector,Tools & Subscription,29,20004278.28
11/13/2021,Expense,Figma,,Tools & Subscription - G&A,687,20004965.28
11/13/2021,Expense,Figma,Mike ross,Credit Card - Ramp,687,20005652.28
11/13/2021,Expense,Figma,,Tools & Subscription - G&A,687,20006339.28
11/13/2021,Expense,Figma,,Tools & Subscription - G&A,687,20007026.28
11/13/2021,Expense,Figma,Mike ross,Credit Card - Ramp,687,20007713.28
11/13/2021,Expense,Figma,,Tools & Subscription - G&A,687,20008400.28
11/13/2021,Expense,Figma,Mike ross,Credit Card - Ramp,687,20009087.28
11/15/2021,Expense,Intuit,Harvey Spector,Credit Card - Ramp,25,20009112.28
11/15/2021,Expense,Intuit,Harvey Spector,Credit Card - Ramp,25,20009137.28
11/15/2021,Expense,Intuit,,Tools & Subscription - G&A,25,20009162.28
11/15/2021,Expense,Intuit,,Tools & Subscription - G&A,25,20009187.28
11/15/2021,Expense,Intuit,Harvey Spector,Credit Card - Ramp,25,20009212.28
11/15/2021,Expense,Webflow,,Tools & Subscription - G&A,24,20009236.28
11/15/2021,Expense,Gumroad,Harvey Spector,Credit Card - Ramp,1,20009237.28
11/15/2021,Expense,Ghost,,Tools & Subscription - G&A,297.03,20009534.31
11/15/2021,Expense,Ghost,,Tools & Subscription - G&A,297.03,20009831.34
11/15/2021,Expense,Webflow,,Tools & Subscription - G&A,24,20009855.34
11/15/2021,Expense,Gumroad,Harvey Spector,Professional Service Charges,1,20009856.34
11/15/2021,Expense,Ghost,Harvey Spector,Credit Card - Ramp,297.03,20010153.37
11/15/2021,Expense,Gumroad,Harvey Spector,Professional Service Charges,1,20010154.37
11/15/2021,Expense,Webflow,Harvey Spector,Credit Card - Ramp,24,20010178.37
11/15/2021,Expense,Intuit,,Tools & Subscription - G&A,25,20010203.37
11/15/2021,Expense,Gumroad,Harvey Spector,Professional Service Charges,1,20010204.37
11/15/2021,Expense,Gumroad,Harvey Spector,Credit Card - Ramp,1,20010205.37
11/15/2021,Expense,Webflow,,Tools & Subscription - G&A,24,20010229.37
11/15/2021,Expense,Ghost,Harvey Spector,Credit Card - Ramp,297.03,20010526.4
11/15/2021,Expense,Gumroad,Harvey Spector,Professional Service Charges,1,20010527.4
11/15/2021,Expense,Webflow,,Tools & Subscription - G&A,24,20010551.4
11/15/2021,Expense,Ghost,,Tools & Subscription - G&A,297.03,20010848.43
11/15/2021,Expense,Webflow,Harvey Spector,Credit Card - Ramp,24,20010872.43
11/15/2021,Expense,Gumroad,Harvey Spector,Credit Card - Ramp,1,20010873.43
11/15/2021,Expense,Gumroad,Harvey Spector,Credit Card - Ramp,1,20010874.43
11/15/2021,Expense,Ghost,,Tools & Subscription - G&A,297.03,20011171.46
11/15/2021,Expense,Intuit,,Tools & Subscription - G&A,25,20011196.46
11/15/2021,Expense,Ghost,Harvey Spector,Credit Card - Ramp,297.03,20011493.49
11/15/2021,Expense,Webflow,Harvey Spector,Credit Card - Ramp,24,20011517.49
11/16/2021,Expense,Founder,Harvey Spector,Credit Card - Ramp,9.75,20011527.24
11/16/2021,Expense,Zapier,,Tools & Subscription - G&A,29.99,20011557.23
11/16/2021,Expense,Zapier,Harvey Spector,Credit Card - Ramp,29.99,20011587.22
11/16/2021,Expense,Zapier,Harvey Spector,Credit Card - Ramp,29.99,20011617.21
11/16/2021,Expense,Founder,Harvey Spector,Credit Card - Ramp,9.75,20011626.96
11/16/2021,Expense,Founder,,Legal & accounting services,9.75,20011636.71
11/16/2021,Expense,Zapier,Harvey Spector,Credit Card - Ramp,29.99,20011666.7
11/16/2021,Expense,Founder,,Legal & accounting services,9.75,20011676.45
11/16/2021,Expense,Founder,,Legal & accounting services,9.75,20011686.2
11/16/2021,Expense,Zapier,,Tools & Subscription - G&A,29.99,20011716.19
11/16/2021,Expense,Founder,Harvey Spector,Credit Card - Ramp,9.75,20011725.94
11/16/2021,Expense,Founder,,Legal & accounting services,9.75,20011735.69
11/16/2021,Expense,Zapier,,Tools & Subscription - G&A,29.99,20011765.68
11/16/2021,Expense,Founder,Harvey Spector,Credit Card - Ramp,9.75,20011775.43
11/16/2021,Expense,Zapier,,Tools & Subscription - G&A,29.99,20011805.42
11/18/2021,Credit Card Credit,Intuit India,,Tools & Subscription - G&A,-0.07,20011805.35
11/18/2021,Expense,Amazon,Harvey Spector,Tools & Subscription - G&A,13.69,20011819.04
11/18/2021,Credit Card Credit,Intuit India,,Tools & Subscription - G&A,-0.07,20011818.97
11/18/2021,Credit Card Credit,Intuit India,,Tools & Subscription - G&A,-0.07,20011818.9
11/18/2021,Credit Card Credit,Intuit India,Harvey Spector,Credit Card - Ramp,-0.07,20011818.83
11/18/2021,Expense,Amazon,Harvey Spector,Tools & Subscription - G&A,13.69,20011832.52
11/18/2021,Expense,Amazon,Harvey Spector,Credit Card - Ramp,13.69,20011846.21
11/18/2021,Expense,Amazon,Harvey Spector,Tools & Subscription - G&A,13.69,20011859.9
11/18/2021,Expense,Amazon,Harvey Spector,Credit Card - Ramp,13.69,20011873.59
11/18/2021,Credit Card Credit,Intuit India,Harvey Spector,Credit Card - Ramp,-0.07,20011873.52
11/18/2021,Expense,Amazon,Harvey Spector,Tools & Subscription - G&A,13.69,20011887.21
11/18/2021,Expense,Amazon,Harvey Spector,Credit Card - Ramp,13.69,20011900.9
11/18/2021,Credit Card Credit,Intuit India,Harvey Spector,Credit Card - Ramp,-0.07,20011900.83
11/18/2021,Credit Card Credit,Intuit India,,Tools & Subscription - G&A,-0.07,20011900.76
11/20/2021,Transfer,,PaymentServiceB Checking **7257,Account1,-30000,19981900.76
11/20/2021,Transfer,,PaymentServiceB Checking **7257,Savings (6977),30000,20011900.76
11/20/2021,Transfer,,PaymentServiceB Checking **7257,Savings (6977),30000,20041900.76
11/20/2021,Transfer,,PaymentServiceB Checking **7257,Account1,-30000,20011900.76
11/20/2021,Transfer,,PaymentServiceB Checking **7257,Account1,-30000,19981900.76
11/20/2021,Transfer,,PaymentServiceB Checking **7257,Savings (6977),30000,20011900.76
11/20/2021,Transfer,,PaymentServiceB Checking **7257,Savings (6977),30000,20041900.76
11/20/2021,Transfer,,PaymentServiceB Checking **7257,Account1,-30000,20011900.76
11/21/2021,Expense,Product Hunt,Harvey Spector,Credit Card - Ramp,79,20011979.76
11/21/2021,Expense,Product Hunt,Harvey Spector,Credit Card - Ramp,79,20012058.76
11/21/2021,Expense,Product Hunt,Harvey Spector,Credit Card - Ramp,79,20012137.76
11/21/2021,Expense,Product Hunt,Harvey Spector,Advertising & marketing,79,20012216.76
11/21/2021,Expense,Product Hunt,Harvey Spector,Credit Card - Ramp,79,20012295.76
11/21/2021,Expense,Product Hunt,Harvey Spector,Advertising & marketing,79,20012374.76
11/21/2021,Expense,Product Hunt,Harvey Spector,Advertising & marketing,79,20012453.76
11/21/2021,Expense,Product Hunt,Harvey Spector,Advertising & marketing,79,20012532.76
11/22/2021,Expense,Big Company ,Big Company ,Account1,-27000,19985532.76
11/22/2021,Expense,Dovetail,,Tools & Subscription - G&A,30,19985562.76
11/22/2021,Credit Card Payment,,RAMP BUSINESS CO,Credit Card - Ramp,-2211.87,19983350.89
11/22/2021,Expense,Big Company ,Big Company ,Account1,-27000,19956350.89
11/22/2021,Credit Card Payment,,RAMP BUSINESS CO,Account1,-2211.87,19954139.02
11/22/2021,Credit Card Payment,,RAMP BUSINESS CO,Account1,-2211.87,19951927.15
11/22/2021,Expense,Dovetail,,Tools & Subscription - G&A,30,19951957.15
11/22/2021,Expense,Big Company ,Big Company ,Accounts Payable (A/P),-27000,19924957.15
11/22/2021,Credit Card Payment,,RAMP BUSINESS CO,Credit Card - Ramp,-2211.87,19922745.28
11/22/2021,Credit Card Payment,,RAMP BUSINESS CO,Credit Card - Ramp,-2211.87,19920533.41
11/22/2021,Expense,Big Company ,Big Company ,Accounts Payable (A/P),-27000,19893533.41
11/22/2021,Expense,MensXP,Mike ross,Credit Card - Ramp,14.26,19893547.67
11/22/2021,Expense,MensXP,,General business expenses:Memberships & subscriptions,14.26,19893561.93
11/22/2021,Expense,Webflow,,Tools & Subscription - G&A,24,19893585.93
11/22/2021,Credit Card Payment,,RAMP BUSINESS CO,Account1,-2211.87,19891374.06
11/22/2021,Expense,Big Company ,Big Company ,Accounts Payable (A/P),-27000,19864374.06
11/22/2021,Expense,MensXP,Mike ross,Credit Card - Ramp,14.26,19864388.32
11/22/2021,Expense,Big Company ,Big Company ,Account1,-27000,19837388.32
11/22/2021,Credit Card Payment,,RAMP BUSINESS CO,Credit Card - Ramp,-2211.87,19835176.45
11/22/2021,Expense,MensXP,,General business expenses:Memberships & subscriptions,14.26,19835190.71
11/22/2021,Expense,Webflow,,Tools & Subscription - G&A,24,19835214.71
11/22/2021,Expense,Webflow,,Tools & Subscription - G&A,24,19835238.71
11/22/2021,Expense,Webflow,Harvey Spector,Credit Card - Ramp,24,19835262.71
11/22/2021,Expense,Dovetail,,Tools & Subscription - G&A,30,19835292.71
11/22/2021,Expense,Dovetail,Harvey Spector,Credit Card - Ramp,30,19835322.71
11/22/2021,Expense,MensXP,,General business expenses:Memberships & subscriptions,14.26,19835336.97
11/22/2021,Credit Card Payment,,RAMP BUSINESS CO,Account1,-2211.87,19833125.1
11/22/2021,Expense,MensXP,Mike ross,Credit Card - Ramp,14.26,19833139.36
11/22/2021,Expense,Webflow,Harvey Spector,Credit Card - Ramp,24,19833163.36
11/22/2021,Expense,Big Company ,Big Company ,Accounts Payable (A/P),-27000,19806163.36
11/22/2021,Expense,Dovetail,,Tools & Subscription - G&A,30,19806193.36
11/22/2021,Expense,Webflow,,Tools & Subscription - G&A,24,19806217.36
11/22/2021,Expense,MensXP,,General business expenses:Memberships & subscriptions,14.26,19806231.62
11/22/2021,Expense,MensXP,Mike ross,Credit Card - Ramp,14.26,19806245.88
11/22/2021,Expense,Big Company ,Big Company ,Account1,-27000,19779245.88
11/22/2021,Expense,Webflow,Harvey Spector,Credit Card - Ramp,24,19779269.88
11/22/2021,Expense,Dovetail,Harvey Spector,Credit Card - Ramp,30,19779299.88
11/22/2021,Expense,Dovetail,Harvey Spector,Credit Card - Ramp,30,19779329.88
11/23/2021,Expense,Super,,Tools & Subscription - G&A,12,19779341.88
11/23/2021,Expense,Super,Harvey Spector,Credit Card - Ramp,12,19779353.88
11/23/2021,Expense,Super,,Tools & Subscription - G&A,12,19779365.88
11/23/2021,Expense,Superhuman,Mike ross,Credit Card - Ramp,30,19779395.88
11/23/2021,Expense,Superhuman,Mike ross,Credit Card - Ramp,30,19779425.88
11/23/2021,Credit Card Credit,MensXP,,General business expenses:Memberships & subscriptions,-14.25,19779411.63
11/23/2021,Credit Card Credit,MensXP,,General business expenses:Memberships & subscriptions,-14.25,19779397.38
11/23/2021,Expense,Super,,Tools & Subscription - G&A,12,19779409.38
11/23/2021,Expense,Superhuman,,Professional Service Charges,30,19779439.38
11/23/2021,Credit Card Credit,MensXP,,General business expenses:Memberships & subscriptions,-14.25,19779425.13
11/23/2021,Expense,Super,,Tools & Subscription - G&A,12,19779437.13
11/23/2021,Expense,Super,Harvey Spector,Credit Card - Ramp,12,19779449.13
11/23/2021,Credit Card Credit,MensXP,Mike ross,Credit Card - Ramp,-14.25,19779434.88
11/23/2021,Credit Card Credit,MensXP,,General business expenses:Memberships & subscriptions,-14.25,19779420.63
11/23/2021,Credit Card Credit,MensXP,Mike ross,Credit Card - Ramp,-14.25,19779406.38
11/23/2021,Expense,Super,Harvey Spector,Credit Card - Ramp,12,19779418.38
11/23/2021,Expense,Superhuman,,Professional Service Charges,30,19779448.38
11/23/2021,Credit Card Credit,MensXP,Mike ross,Credit Card - Ramp,-14.25,19779434.13
11/23/2021,Expense,Superhuman,,Professional Service Charges,30,19779464.13
11/23/2021,Expense,Superhuman,Mike ross,Credit Card - Ramp,30,19779494.13
11/23/2021,Expense,Superhuman,,Professional Service Charges,30,19779524.13
11/23/2021,Credit Card Credit,MensXP,Mike ross,Credit Card - Ramp,-14.25,19779509.88
11/23/2021,Expense,Superhuman,Mike ross,Credit Card - Ramp,30,19779539.88
11/24/2021,Expense,Gum Co Cc Cristina Ga,,General business expenses:Memberships & subscriptions,19,19779558.88
11/24/2021,Expense,Gum Co Cc Cristina Ga,Harvey Spector,Credit Card - Ramp,19,19779577.88
11/24/2021,Expense,Gum Co Cc Cristina Ga,Harvey Spector,Credit Card - Ramp,19,19779596.88
11/24/2021,Expense,Gum Co Cc Cristina Ga,,General business expenses:Memberships & subscriptions,19,19779615.88
11/24/2021,Expense,Gum Co Cc Cristina Ga,,General business expenses:Memberships & subscriptions,19,19779634.88
11/24/2021,Expense,Gum Co Cc Cristina Ga,Harvey Spector,Credit Card - Ramp,19,19779653.88
11/24/2021,Expense,Gum Co Cc Cristina Ga,,General business expenses:Memberships & subscriptions,19,19779672.88
11/24/2021,Expense,Gum Co Cc Cristina Ga,Harvey Spector,Credit Card - Ramp,19,19779691.88
11/25/2021,Expense,Namecheap,,Tools & Subscription - G&A,20.14,19779712.02
11/25/2021,Expense,Namecheap,Harvey Spector,Credit Card - Ramp,20.14,19779732.16
11/25/2021,Expense,Namecheap,,Tools & Subscription - G&A,20.14,19779752.3
11/25/2021,Expense,Namecheap,,Tools & Subscription - G&A,20.14,19779772.44
11/25/2021,Expense,Namecheap,Harvey Spector,Credit Card - Ramp,20.14,19779792.58
11/25/2021,Expense,Namecheap,,Tools & Subscription - G&A,20.14,19779812.72
11/25/2021,Expense,Namecheap,Harvey Spector,Credit Card - Ramp,20.14,19779832.86
11/27/2021,Expense,Splitbee,,Tools & Subscription - G&A,16.52,19779849.38
11/27/2021,Expense,Splitbee,Harris Jose,Credit Card - Ramp,16.52,19779865.9
11/27/2021,Expense,Sendinblue,Balapavan Tirumani,Credit Card - Ramp,52.25,19779918.15
11/27/2021,Expense,Splitbee,,Tools & Subscription - G&A,16.52,19779934.67
11/27/2021,Expense,Sendinblue,Balapavan Tirumani,Credit Card - Ramp,52.25,19779986.92
11/27/2021,Expense,Sendinblue,,Tools & Subscription - G&A,52.25,19780039.17
11/27/2021,Expense,Sendinblue,,Tools & Subscription - G&A,52.25,19780091.42
11/27/2021,Expense,Sendinblue,Balapavan Tirumani,Credit Card - Ramp,52.25,19780143.67
11/27/2021,Expense,Sendinblue,,Tools & Subscription - G&A,52.25,19780195.92
11/27/2021,Expense,Splitbee,,Tools & Subscription - G&A,16.52,19780212.44
11/27/2021,Expense,Sendinblue,,Tools & Subscription - G&A,52.25,19780264.69
11/27/2021,Expense,Splitbee,Harris Jose,Credit Card - Ramp,16.52,19780281.21
11/27/2021,Expense,Splitbee,Harris Jose,Credit Card - Ramp,16.52,19780297.73
11/27/2021,Expense,Splitbee,,Tools & Subscription - G&A,16.52,19780314.25
11/30/2021,Expense,Adobe,Mike ross,Credit Card - Ramp,15.77,19780330.02
11/30/2021,Bill,Big Company ,,Outsources Services - India,27000,19807330.02
11/30/2021,Expense,Netlify,Balapavan Tirumani,Credit Card - Ramp,7,19807337.02
11/30/2021,Expense,Netlify,,Tools & Subscription - G&A,7,19807344.02
11/30/2021,Bill,Big Company ,Service Expenses for the month of November 2021,Accounts Payable (A/P),27000,19834344.02
11/30/2021,Expense,Adobe,,Tools & Subscription - S&M,15.77,19834359.79
11/30/2021,Expense,Netlify,Balapavan Tirumani,Credit Card - Ramp,7,19834366.79
11/30/2021,Expense,Adobe,,Tools & Subscription - S&M,15.77,19834382.56
11/30/2021,Bill,Big Company ,Service Expenses for the month of November 2021,Accounts Payable (A/P),27000,19861382.56
11/30/2021,Expense,Adobe,,Tools & Subscription - S&M,15.77,19861398.33
11/30/2021,Expense,Netlify,Balapavan Tirumani,Credit Card - Ramp,7,19861405.33
11/30/2021,Expense,Netlify,,Tools & Subscription - G&A,7,19861412.33
11/30/2021,Expense,Adobe,,Tools & Subscription - S&M,15.77,19861428.1
11/30/2021,Expense,Netlify,,Tools & Subscription - G&A,7,19861435.1
11/30/2021,Bill,Big Company ,,Outsources Services - India,27000,19888435.1
11/30/2021,Expense,Netlify,,Tools & Subscription - G&A,7,19888442.1
11/30/2021,Bill,Big Company ,Service Expenses for the month of November 2021,Accounts Payable (A/P),27000,19915442.1
11/30/2021,Bill,Big Company ,Service Expenses for the month of November 2021,Accounts Payable (A/P),27000,19942442.1
11/30/2021,Expense,Adobe,Mike ross,Credit Card - Ramp,15.77,19942457.87
11/30/2021,Bill,Big Company ,,Outsources Services - India,27000,19969457.87
11/30/2021,Bill,Big Company ,,Outsources Services - India,27000,19996457.87
11/30/2021,Expense,Adobe,Mike ross,Credit Card - Ramp,15.77,19996473.64
12/02/2021,Expense,,Si Tran,Professional Service Charges,-450,19996023.64
12/02/2021,Expense,Google G Suite,Mike ross,Credit Card - Ramp,72.39,19996096.03
12/02/2021,Expense,Google G Suite,,Tools & Subscription - G&A,72.39,19996168.42
12/02/2021,Deposit,,Interest Accrual,Interest Received,1.52,19996169.94
12/02/2021,Deposit,,Interest Accrual,Savings (6977),1.52,19996171.46
12/02/2021,Expense,Buffer,,Tools & Subscription - G&A,240,19996411.46
12/02/2021,Expense,Buffer,Harvey Spector,Credit Card - Ramp,240,19996651.46
12/02/2021,Deposit,,Interest Accrual,Interest Received,1.52,19996652.98
12/02/2021,Expense,,"Si Tran ,	Professional service",Account1,450,19997102.98
12/02/2021,Deposit,,Interest Accrual,Savings (6977),1.52,19997104.5
12/02/2021,Expense,Buffer,,Tools & Subscription - G&A,240,19997344.5
12/02/2021,Expense,Google G Suite,Mike ross,Credit Card - Ramp,72.39,19997416.89
12/02/2021,Deposit,,Interest Accrual,Interest Received,1.52,19997418.41
12/02/2021,Expense,Buffer,Harvey Spector,Credit Card - Ramp,240,19997658.41
12/02/2021,Expense,,"Si Tran ,	Professional service",Account1,450,19998108.41
12/02/2021,Expense,Google G Suite,,Tools & Subscription - G&A,72.39,19998180.8
12/02/2021,Expense,Google G Suite,Mike ross,Credit Card - Ramp,72.39,19998253.19
12/02/2021,Expense,Buffer,,Tools & Subscription - G&A,240,19998493.19
12/02/2021,Deposit,,Interest Accrual,Interest Received,1.52,19998494.71
12/02/2021,Expense,,"Si Tran ,	Professional service",Account1,450,19998944.71
12/02/2021,Expense,,"Si Tran ,	Professional service",Account1,450,19999394.71
12/02/2021,Expense,Buffer,Harvey Spector,Credit Card - Ramp,240,19999634.71
12/02/2021,Expense,,Si Tran,Professional Service Charges,-450,19999184.71
12/02/2021,Expense,Buffer,,Tools & Subscription - G&A,240,19999424.71
12/02/2021,Expense,,Si Tran,Professional Service Charges,-450,19998974.71
12/02/2021,Expense,Google G Suite,,Tools & Subscription - G&A,72.39,19999047.1
12/02/2021,Expense,,Si Tran,Professional Service Charges,-450,19998597.1
12/02/2021,Expense,Google G Suite,,Tools & Subscription - G&A,72.39,19998669.49
12/02/2021,Deposit,,Interest Accrual,Savings (6977),1.52,19998671.01
12/03/2021,Transfer,,PaymentServiceB Checking **7257,Account1,-50000,19948671.01
12/03/2021,Expense,Mazurek Co,,Tools & Subscription - G&A,29.95,19948700.96
12/03/2021,Transfer,,PaymentServiceB Checking **7257,Savings (6977),50000,19998700.96
12/03/2021,Expense,Mazurek Co,Harvey Spector,Credit Card - Ramp,29.95,19998730.91
12/03/2021,Expense,Perkins Coie LLP,Perkins Coie LLP,Legal & accounting services:Legal Fees,-26993,19971737.91
12/03/2021,Transfer,,PaymentServiceB Checking **7257,Savings (6977),50000,20021737.91
12/03/2021,Transfer,,PaymentServiceB Checking **7257,Account1,-50000,19971737.91
12/03/2021,Expense,Mazurek Co,,Tools & Subscription - G&A,29.95,19971767.86
12/03/2021,Expense,Perkins Coie LLP,Perkins Coie LLP -	Legal services,Account1,26993,19998760.86
12/03/2021,Expense,Perkins Coie LLP,Perkins Coie LLP,Legal & accounting services:Legal Fees,-26993,19971767.86
12/03/2021,Transfer,,PaymentServiceB Checking **7257,Account1,-50000,19921767.86
12/03/2021,Expense,Perkins Coie LLP,Perkins Coie LLP -	Legal services,Account1,26993,19948760.86
12/03/2021,Expense,Mazurek Co,,Tools & Subscription - G&A,29.95,19948790.81
12/03/2021,Expense,Mazurek Co,,Tools & Subscription - G&A,29.95,19948820.76
12/03/2021,Expense,Mazurek Co,Harvey Spector,Credit Card - Ramp,29.95,19948850.71
12/03/2021,Transfer,,PaymentServiceB Checking **7257,Account1,-50000,19898850.71
12/03/2021,Expense,Perkins Coie LLP,Perkins Coie LLP -	Legal services,Account1,26993,19925843.71
12/03/2021,Transfer,,PaymentServiceB Checking **7257,Savings (6977),50000,19975843.71
12/03/2021,Expense,Mazurek Co,Harvey Spector,Credit Card - Ramp,29.95,19975873.66
12/03/2021,Expense,Perkins Coie LLP,Perkins Coie LLP,Legal & accounting services:Legal Fees,-26993,19948880.66
12/03/2021,Expense,Perkins Coie LLP,Perkins Coie LLP,Legal & accounting services:Legal Fees,-26993,19921887.66
12/03/2021,Transfer,,PaymentServiceB Checking **7257,Savings (6977),50000,19971887.66
12/03/2021,Expense,Perkins Coie LLP,Perkins Coie LLP -	Legal services,Account1,26993,19998880.66
12/06/2021,Expense,Perkins Coie LLP,Perkins Coie LLP - 	Legal services,Account1,4358.12,20003238.78
12/06/2021,Expense,Perkins Coie LLP,Perkins Coie LLP,Legal & accounting services:Legal Fees,-4358.12,19998880.66
12/06/2021,Expense,Perkins Coie LLP,Perkins Coie LLP,Legal & accounting services:Legal Fees,-4358.12,19994522.54
12/06/2021,Expense,Perkins Coie LLP,Perkins Coie LLP,Legal & accounting services:Legal Fees,-4358.12,19990164.42
12/06/2021,Expense,Perkins Coie LLP,Perkins Coie LLP - 	Legal services,Account1,4358.12,19994522.54
12/06/2021,Expense,Perkins Coie LLP,Perkins Coie LLP,Legal & accounting services:Legal Fees,-4358.12,19990164.42
12/06/2021,Expense,Perkins Coie LLP,Perkins Coie LLP - 	Legal services,Account1,4358.12,19994522.54
12/06/2021,Expense,Perkins Coie LLP,Perkins Coie LLP - 	Legal services,Account1,4358.12,19998880.66
12/07/2021,Expense,Mailchimp,,Tools & Subscription - G&A,20.38,19998901.04
12/07/2021,Expense,Mailchimp,Mike ross,Credit Card - Ramp,20.38,19998921.42
12/07/2021,Expense,Mailchimp,,Tools & Subscription - G&A,20.38,19998941.8
12/07/2021,Expense,Mailchimp,Mike ross,Credit Card - Ramp,20.38,19998962.18
12/07/2021,Expense,Mailchimp,,Tools & Subscription - G&A,20.38,19998982.56
12/07/2021,Expense,Mailchimp,,Tools & Subscription - G&A,20.38,19999002.94
12/07/2021,Expense,Mailchimp,Mike ross,Credit Card - Ramp,20.38,19999023.32
12/09/2021,Expense,Income Capitals ,Income Capitals ,Professional Service Charges,-2310,19996713.32
12/09/2021,Expense,Heroku,Balapavan Tirumani,Credit Card - Ramp,12.13,19996725.45
12/09/2021,Expense,Income Capitals ,Income Capitals ,Professional Service Charges,-2310,19994415.45
12/09/2021,Expense,Income Capitals ,Deel is for contractual (salary) payments,Account1,2310,19996725.45
12/09/2021,Expense,Heroku,Balapavan Tirumani,Tools & Subscription - S&M,12.13,19996737.58
12/09/2021,Expense,Income Capitals ,Deel is for contractual (salary) payments,Account1,2310,19999047.58
12/09/2021,Expense,Heroku,Balapavan Tirumani,Credit Card - Ramp,12.13,19999059.71
12/09/2021,Expense,Income Capitals ,Income Capitals ,Professional Service Charges,-2310,19996749.71
12/09/2021,Expense,Heroku,Balapavan Tirumani,Tools & Subscription - S&M,12.13,19996761.84
12/09/2021,Expense,Heroku,Balapavan Tirumani,Tools & Subscription - S&M,12.13,19996773.97
12/09/2021,Expense,Income Capitals ,Income Capitals ,Professional Service Charges,-2310,19994463.97
12/09/2021,Expense,Heroku,Balapavan Tirumani,Tools & Subscription - S&M,12.13,19994476.1
12/09/2021,Expense,Income Capitals ,Deel is for contractual (salary) payments,Account1,2310,19996786.1
12/09/2021,Expense,Heroku,Balapavan Tirumani,Credit Card - Ramp,12.13,19996798.23
12/09/2021,Expense,Income Capitals ,Deel is for contractual (salary) payments,Account1,2310,19999108.23
12/10/2021,Deposit,,International Wire Partner,Professional Service Charges,422.5,19999530.73
12/10/2021,Deposit,,International Wire Partner - Returned,Account1,-422.5,19999108.23
12/10/2021,Deposit,,International Wire Partner,Professional Service Charges,422.5,19999530.73
12/10/2021,Deposit,,International Wire Partner - Returned,Account1,-422.5,19999108.23
12/10/2021,Deposit,,International Wire Partner,Professional Service Charges,422.5,19999530.73
12/10/2021,Deposit,,International Wire Partner,Professional Service Charges,422.5,19999953.23
12/10/2021,Deposit,,International Wire Partner - Returned,Account1,-422.5,19999530.73
12/10/2021,Deposit,,International Wire Partner - Returned,Account1,-422.5,19999108.23
12/12/2021,Expense,Intuit India,,Tools & Subscription - G&A,4.96,19999113.19
12/12/2021,Expense,Glimpse,Harvey Spector,Tools & Subscription,29,19999142.19
12/12/2021,Expense,Glimpse,Harvey Spector,Tools & Subscription,29,19999171.19
12/12/2021,Expense,Intuit India,,Tools & Subscription - G&A,4.96,19999176.15
12/12/2021,Expense,Intuit India,Harvey Spector,Credit Card - Ramp,4.96,19999181.11
12/12/2021,Expense,Intuit India,,Tools & Subscription - G&A,4.96,19999186.07
12/12/2021,Expense,Glimpse,Harvey Spector,Credit Card - Ramp,29,19999215.07
12/12/2021,Expense,Intuit India,,Tools & Subscription - G&A,4.96,19999220.03
12/12/2021,Expense,Glimpse,Harvey Spector,Tools & Subscription,29,19999249.03
12/12/2021,Expense,Intuit India,Harvey Spector,Credit Card - Ramp,4.96,19999253.99
12/12/2021,Expense,Glimpse,Harvey Spector,Credit Card - Ramp,29,19999282.99
12/12/2021,Expense,Intuit India,Harvey Spector,Credit Card - Ramp,4.96,19999287.95
12/12/2021,Expense,Glimpse,Harvey Spector,Credit Card - Ramp,29,19999316.95
12/12/2021,Expense,Glimpse,Harvey Spector,Tools & Subscription,29,19999345.95
12/13/2021,Expense,,TRAN HUYNH CO - Professional service,Account1,450,19999795.95
12/13/2021,Expense,,TRAN HUYNH CO - Professional service,Account1,450,20000245.95
12/13/2021,Expense,Figma,,Tools & Subscription - G&A,15,20000260.95
12/13/2021,Expense,,TRAN HUYNH CO - Professional service,Account1,450,20000710.95
12/13/2021,Expense,Figma,Mike ross,Credit Card - Ramp,15,20000725.95
12/13/2021,Expense,,TRAN HUYNH CO,Professional Service Charges,-450,20000275.95
12/13/2021,Expense,,TRAN HUYNH CO - Professional service,Account1,450,20000725.95
12/13/2021,Expense,Figma,Mike ross,Credit Card - Ramp,15,20000740.95
12/13/2021,Expense,Figma,Mike ross,Credit Card - Ramp,15,20000755.95
12/13/2021,Expense,Figma,,Tools & Subscription - G&A,15,20000770.95
12/13/2021,Expense,,TRAN HUYNH CO,Professional Service Charges,-450,20000320.95
12/13/2021,Expense,,TRAN HUYNH CO,Professional Service Charges,-450,19999870.95
12/13/2021,Expense,Figma,,Tools & Subscription - G&A,15,19999885.95
12/13/2021,Expense,Figma,,Tools & Subscription - G&A,15,19999900.95
12/13/2021,Expense,,TRAN HUYNH CO,Professional Service Charges,-450,19999450.95
12/14/2021,Expense,Intuit,,Tools & Subscription - G&A,25,19999475.95
12/14/2021,Expense,Intuit,,Tools & Subscription - G&A,25,19999500.95
12/14/2021,Expense,Intuit,Harvey Spector,Credit Card - Ramp,25,19999525.95
12/14/2021,Expense,Intuit,,Tools & Subscription - G&A,25,19999550.95
12/14/2021,Expense,Intuit,Harvey Spector,Credit Card - Ramp,25,19999575.95
12/14/2021,Expense,Intuit,,Tools & Subscription - G&A,25,19999600.95
12/14/2021,Expense,Intuit,Harvey Spector,Credit Card - Ramp,25,19999625.95
12/16/2021,Expense,Zapier,,Tools & Subscription - G&A,29.99,19999655.94
12/16/2021,Expense,Zapier,Harvey Spector,Credit Card - Ramp,29.99,19999685.93
12/16/2021,Expense,Zapier,,Tools & Subscription - G&A,29.99,19999715.92
12/16/2021,Expense,Zapier,,Tools & Subscription - G&A,29.99,19999745.91
12/16/2021,Expense,Zapier,,Tools & Subscription - G&A,29.99,19999775.9
12/16/2021,Expense,Zapier,Harvey Spector,Credit Card - Ramp,29.99,19999805.89
12/16/2021,Expense,Zapier,Harvey Spector,Credit Card - Ramp,29.99,19999835.88
12/17/2021,Expense,Gumroad,Harvey Spector,Credit Card - Ramp,49,19999884.88
12/17/2021,Expense,Gumroad,Harvey Spector,Credit Card - Ramp,49,19999933.88
12/17/2021,Expense,Gumroad,Harvey Spector,Professional Service Charges,49,19999982.88
12/17/2021,Expense,Gumroad,Harvey Spector,Credit Card - Ramp,49,20000031.88
12/17/2021,Expense,Gumroad,Harvey Spector,Credit Card - Ramp,49,20000080.88
12/17/2021,Expense,Gumroad,Harvey Spector,Professional Service Charges,49,20000129.88
12/17/2021,Expense,Gumroad,Harvey Spector,Professional Service Charges,49,20000178.88
12/17/2021,Expense,Gumroad,Harvey Spector,Professional Service Charges,49,20000227.88
12/20/2021,Expense,Marcus Monk,Harvey Spector,Credit Card - Ramp,25.07,20000252.95
12/20/2021,Expense,Marcus Monk,Harvey Spector,Office expenses:Office supplies,25.07,20000278.02
12/20/2021,Expense,Marcus Monk,Harvey Spector,Credit Card - Ramp,25.07,20000303.09
12/20/2021,Expense,Marcus Monk,Harvey Spector,Office expenses:Office supplies,25.07,20000328.16
12/20/2021,Expense,Marcus Monk,Harvey Spector,Office expenses:Office supplies,25.07,20000353.23
12/20/2021,Expense,Marcus Monk,Harvey Spector,Credit Card - Ramp,25.07,20000378.3
12/20/2021,Expense,Marcus Monk,Harvey Spector,Credit Card - Ramp,25.07,20000403.37
12/20/2021,Expense,Marcus Monk,Harvey Spector,Office expenses:Office supplies,25.07,20000428.44
12/21/2021,Credit Card Payment,,RAMP BUSINESS CO,Account1,-847.18,19999581.26
12/21/2021,Expense,Product Hunt,Harvey Spector,Credit Card - Ramp,79,19999660.26
12/21/2021,Credit Card Payment,,RAMP BUSINESS CO,Credit Card - Ramp,-847.18,19998813.08
12/21/2021,Credit Card Payment,,RAMP BUSINESS CO,Credit Card - Ramp,-847.18,19997965.9
12/21/2021,Credit Card Payment,,RAMP BUSINESS CO,Credit Card - Ramp,-847.18,19997118.72
12/21/2021,Expense,Product Hunt,Harvey Spector,Advertising & marketing,79,19997197.72
12/21/2021,Credit Card Payment,,RAMP BUSINESS CO,Account1,-847.18,19996350.54
12/21/2021,Expense,Product Hunt,Harvey Spector,Advertising & marketing,79,19996429.54
12/21/2021,Expense,Product Hunt,Harvey Spector,Advertising & marketing,79,19996508.54
12/21/2021,Expense,Product Hunt,Harvey Spector,Credit Card - Ramp,79,19996587.54
12/21/2021,Expense,Product Hunt,Harvey Spector,Credit Card - Ramp,79,19996666.54
12/21/2021,Credit Card Payment,,RAMP BUSINESS CO,Credit Card - Ramp,-847.18,19995819.36
12/21/2021,Credit Card Payment,,RAMP BUSINESS CO,Account1,-847.18,19994972.18
12/21/2021,Expense,Product Hunt,Harvey Spector,Advertising & marketing,79,19995051.18
12/21/2021,Credit Card Payment,,RAMP BUSINESS CO,Account1,-847.18,19994204
12/21/2021,Expense,Product Hunt,Harvey Spector,Credit Card - Ramp,79,19994283
12/22/2021,Expense,Amazon,Harvey Spector,Tools & Subscription - G&A,46.53,19994329.53
12/22/2021,Expense,Dovetail,Harvey Spector,Credit Card - Ramp,30,19994359.53
12/22/2021,Expense,Amazon,Harvey Spector,Tools & Subscription - G&A,46.57,19994406.1
12/22/2021,Expense,Amazon,Harvey Spector,Tools & Subscription - G&A,59.37,19994465.47
12/22/2021,Expense,Dovetail,,Tools & Subscription - G&A,30,19994495.47
12/22/2021,Expense,Amazon,Harvey Spector,Tools & Subscription - G&A,46.57,19994542.04
12/22/2021,Expense,Automate,,Tools & Subscription - G&A,29,19994571.04
12/22/2021,Expense,Automate,Balapavan Tirumani,Credit Card - Ramp,29,19994600.04
12/22/2021,Expense,Dovetail,Harvey Spector,Credit Card - Ramp,30,19994630.04
12/22/2021,Expense,Automate,Balapavan Tirumani,Credit Card - Ramp,29,19994659.04
12/22/2021,Expense,Amazon,Harvey Spector,Credit Card - Ramp,46.57,19994705.61
12/22/2021,Expense,Automate,,Tools & Subscription - G&A,29,19994734.61
12/22/2021,Expense,Amazon,Harvey Spector,Tools & Subscription - G&A,46.53,19994781.14
12/22/2021,Expense,Automate,Balapavan Tirumani,Credit Card - Ramp,29,19994810.14
12/22/2021,Expense,Amazon,Harvey Spector,Credit Card - Ramp,46.57,19994856.71
12/22/2021,Expense,Amazon,Harvey Spector,Tools & Subscription - G&A,59.37,19994916.08
12/22/2021,Expense,Amazon,Harvey Spector,Credit Card - Ramp,46.53,19994962.61
12/22/2021,Expense,Dovetail,,Tools & Subscription - G&A,30,19994992.61
12/22/2021,Expense,Dovetail,,Tools & Subscription - G&A,30,19995022.61
12/22/2021,Expense,Automate,,Tools & Subscription - G&A,29,19995051.61
12/22/2021,Expense,Amazon,Harvey Spector,Credit Card - Ramp,46.53,19995098.14
12/22/2021,Expense,Automate,,Tools & Subscription - G&A,29,19995127.14
12/22/2021,Expense,Amazon,Harvey Spector,Tools & Subscription - G&A,46.53,19995173.67
12/22/2021,Expense,Amazon,Harvey Spector,Tools & Subscription - G&A,46.53,19995220.2
12/22/2021,Expense,Amazon,Harvey Spector,Tools & Subscription - G&A,59.37,19995279.57
12/22/2021,Expense,Dovetail,,Tools & Subscription - G&A,30,19995309.57
12/22/2021,Expense,Amazon,Harvey Spector,Tools & Subscription - G&A,59.37,19995368.94
12/22/2021,Expense,Amazon,Harvey Spector,Tools & Subscription - G&A,46.57,19995415.51
12/22/2021,Expense,Amazon,Harvey Spector,Credit Card - Ramp,46.53,19995462.04
12/22/2021,Expense,Amazon,Harvey Spector,Tools & Subscription - G&A,46.57,19995508.61
12/22/2021,Expense,Amazon,Harvey Spector,Credit Card - Ramp,59.37,19995567.98
12/22/2021,Expense,Amazon,Harvey Spector,Credit Card - Ramp,59.37,19995627.35
12/22/2021,Expense,Dovetail,Harvey Spector,Credit Card - Ramp,30,19995657.35
12/22/2021,Expense,Amazon,Harvey Spector,Credit Card - Ramp,59.37,19995716.72
12/22/2021,Expense,Amazon,Harvey Spector,Credit Card - Ramp,46.57,19995763.29
12/23/2021,Expense,Superhuman,,Professional Service Charges,30,19995793.29
12/23/2021,Expense,Amazon Au,Harvey Spector,Credit Card - Ramp,57.23,19995850.52
12/23/2021,Expense,Amazon.co.uk,Harvey Spector,Credit Card - Ramp,29.68,19995880.2
12/23/2021,Expense,Amazon Au,Harvey Spector,Credit Card - Ramp,62.2,19995942.4
12/23/2021,Expense,Amazon Au,Harvey Spector,Tools & Subscription,62.2,19996004.6
12/23/2021,Expense,Amazon,Harvey Spector,Tools & Subscription - G&A,44.27,19996048.87
12/23/2021,Expense,Amazon.co.uk,Harvey Spector,Tools & Subscription,29.68,19996078.55
12/23/2021,Expense,Super,,Tools & Subscription - G&A,15.25,19996093.8
12/23/2021,Expense,Superhuman,Mike ross,Credit Card - Ramp,30,19996123.8
12/23/2021,Expense,Amazon Au,Harvey Spector,Tools & Subscription,57.23,19996181.03
12/23/2021,Expense,Amazon,Harvey Spector,Credit Card - Ramp,44.27,19996225.3
12/23/2021,Expense,Super,Harvey Spector,Credit Card - Ramp,15.25,19996240.55
12/23/2021,Expense,Amazon.co.uk,Harvey Spector,Credit Card - Ramp,29.68,19996270.23
12/23/2021,Expense,Amazon,Harvey Spector,Credit Card - Ramp,44.27,19996314.5
12/23/2021,Expense,Amazon Au,Harvey Spector,Credit Card - Ramp,62.2,19996376.7
12/23/2021,Expense,Amazon Au,Harvey Spector,Credit Card - Ramp,57.23,19996433.93
12/23/2021,Expense,Amazon.co.uk,Harvey Spector,Credit Card - Ramp,29.68,19996463.61
12/23/2021,Expense,Amazon Au,Harvey Spector,Credit Card - Ramp,62.2,19996525.81
12/23/2021,Expense,Superhuman,Mike ross,Credit Card - Ramp,30,19996555.81
12/23/2021,Expense,Amazon Au,Harvey Spector,Credit Card - Ramp,57.23,19996613.04
12/23/2021,Expense,Amazon Au,Harvey Spector,Tools & Subscription,57.23,19996670.27
12/23/2021,Expense,Amazon.co.uk,Harvey Spector,Tools & Subscription,29.68,19996699.95
12/23/2021,Expense,Amazon,Harvey Spector,Tools & Subscription - G&A,44.27,19996744.22
12/23/2021,Expense,Superhuman,Mike ross,Credit Card - Ramp,30,19996774.22
12/23/2021,Expense,Amazon,Harvey Spector,Credit Card - Ramp,44.27,19996818.49
12/23/2021,Expense,Amazon,Harvey Spector,Tools & Subscription - G&A,44.27,19996862.76
12/23/2021,Expense,Amazon Au,Harvey Spector,Tools & Subscription,62.2,19996924.96
12/23/2021,Expense,Superhuman,,Professional Service Charges,30,19996954.96
12/23/2021,Expense,Amazon Au,Harvey Spector,Tools & Subscription,57.23,19997012.19
12/23/2021,Expense,Super,Harvey Spector,Credit Card - Ramp,15.25,19997027.44
12/23/2021,Expense,Super,,Tools & Subscription - G&A,15.25,19997042.69
12/23/2021,Expense,Super,Harvey Spector,Credit Card - Ramp,15.25,19997057.94
12/23/2021,Expense,Amazon Au,Harvey Spector,Tools & Subscription,62.2,19997120.14
12/23/2021,Expense,Super,,Tools & Subscription - G&A,15.25,19997135.39
12/23/2021,Expense,Amazon,Harvey Spector,Tools & Subscription - G&A,44.27,19997179.66
12/23/2021,Expense,Superhuman,Mike ross,Credit Card - Ramp,30,19997209.66
12/23/2021,Expense,Amazon.co.uk,Harvey Spector,Tools & Subscription,29.68,19997239.34
12/23/2021,Expense,Amazon Au,Harvey Spector,Tools & Subscription,62.2,19997301.54
12/23/2021,Expense,Superhuman,,Professional Service Charges,30,19997331.54
12/23/2021,Expense,Amazon Au,Harvey Spector,Tools & Subscription,57.23,19997388.77
12/23/2021,Expense,Super,,Tools & Subscription - G&A,15.25,19997404.02
12/23/2021,Expense,Superhuman,,Professional Service Charges,30,19997434.02
12/23/2021,Expense,Amazon.co.uk,Harvey Spector,Tools & Subscription,29.68,19997463.7
12/24/2021,Expense,CleanShot X,Mike ross,Credit Card - Ramp,105.6,19997569.3
12/24/2021,Expense,CleanShot X,,Tools & Subscription - G&A,105.6,19997674.9
12/24/2021,Expense,CleanShot X,,Tools & Subscription - G&A,105.6,19997780.5
12/24/2021,Expense,CleanShot X,Mike ross,Credit Card - Ramp,105.6,19997886.1
12/24/2021,Expense,CleanShot X,,Tools & Subscription - G&A,105.6,19997991.7
12/24/2021,Expense,CleanShot X,Mike ross,Credit Card - Ramp,105.6,19998097.3
12/24/2021,Expense,CleanShot X,,Tools & Subscription - G&A,105.6,19998202.9
12/25/2021,Expense,Miro,,Tools & Subscription - G&A,38.42,19998241.32
12/25/2021,Expense,Miro,Mike ross,Credit Card - Ramp,38.42,19998279.74
12/25/2021,Expense,Miro,,Tools & Subscription - G&A,38.42,19998318.16
12/25/2021,Expense,Miro,,Tools & Subscription - G&A,38.42,19998356.58
12/25/2021,Expense,Miro,Mike ross,Credit Card - Ramp,38.42,19998395
12/25/2021,Expense,Miro,,Tools & Subscription - G&A,38.42,19998433.42
12/25/2021,Expense,Miro,Mike ross,Credit Card - Ramp,38.42,19998471.84
12/27/2021,Expense,Sendinblue,Balapavan Tirumani,Credit Card - Ramp,51.98,19998523.82
12/27/2021,Expense,Sendinblue,,Tools & Subscription - G&A,51.98,19998575.8
12/27/2021,Expense,Splitbee,,Tools & Subscription - G&A,16.52,19998592.32
12/27/2021,Expense,Splitbee,Harris Jose,Credit Card - Ramp,16.52,19998608.84
12/27/2021,Expense,Splitbee,,Tools & Subscription - G&A,16.52,19998625.36
12/27/2021,Expense,Sendinblue,Balapavan Tirumani,Credit Card - Ramp,51.98,19998677.34
12/27/2021,Expense,Sendinblue,,Tools & Subscription - G&A,51.98,19998729.32
12/27/2021,Expense,Splitbee,Harris Jose,Credit Card - Ramp,16.52,19998745.84
12/27/2021,Expense,Sendinblue,,Tools & Subscription - G&A,51.98,19998797.82
12/27/2021,Expense,Splitbee,Harris Jose,Credit Card - Ramp,16.52,19998814.34
12/27/2021,Expense,Splitbee,,Tools & Subscription - G&A,16.52,19998830.86
12/27/2021,Expense,Splitbee,,Tools & Subscription - G&A,16.52,19998847.38
12/27/2021,Expense,Sendinblue,Balapavan Tirumani,Credit Card - Ramp,51.98,19998899.36
12/27/2021,Expense,Sendinblue,,Tools & Subscription - G&A,51.98,19998951.34
12/29/2021,Expense,Big Company ,Big Company ,Accounts Payable (A/P),-24200,19974751.34
12/29/2021,Expense,Big Company ,Big Company ,Account1,-24200,19950551.34
12/29/2021,Expense,Netlify,Balapavan Tirumani,Credit Card - Ramp,14,19950565.34
12/29/2021,Expense,Big Company ,Big Company ,Accounts Payable (A/P),-24200,19926365.34
12/29/2021,Expense,Netlify,,Tools & Subscription - G&A,14,19926379.34
12/29/2021,Expense,Big Company ,Big Company ,Accounts Payable (A/P),-24200,19902179.34
12/29/2021,Expense,Netlify,,Tools & Subscription - G&A,14,19902193.34
12/29/2021,Expense,Netlify,Balapavan Tirumani,Credit Card - Ramp,14,19902207.34
12/29/2021,Expense,Big Company ,Big Company ,Account1,-24200,19878007.34
12/29/2021,Expense,Netlify,Balapavan Tirumani,Credit Card - Ramp,14,19878021.34
12/29/2021,Expense,Big Company ,Big Company ,Accounts Payable (A/P),-24200,19853821.34
12/29/2021,Expense,Netlify,,Tools & Subscription - G&A,14,19853835.34
12/29/2021,Expense,Netlify,,Tools & Subscription - G&A,14,19853849.34
12/29/2021,Expense,Big Company ,Big Company ,Account1,-24200,19829649.34
12/29/2021,Expense,Big Company ,Big Company ,Account1,-24200,19805449.34
12/31/2021,Expense,Adobe,,Tools & Subscription - S&M,16.01,19805465.35
12/31/2021,Journal Entry,,Provision for Expenses as on 31st Dec21,-Split-,212,19805677.35
12/31/2021,Expense,Adobe,Mike ross,Credit Card - Ramp,16.01,19805693.36
12/31/2021,Journal Entry,,Premium on Series seed preferred Stock,-Split-,-2499964.98,17305728.38
12/31/2021,Journal Entry,,Provision for Expenses as on 31st Dec21,-Split-,212,17305940.38
12/31/2021,Journal Entry,,Premium on Series seed preferred Stock,-Split-,2499964.98,19805905.36
12/31/2021,Journal Entry,,Provision for Delaware Tax,-Split-,785.34,19806690.7
12/31/2021,Bill,Big Company ,Service Expenses for the month of December 2021,Accounts Payable (A/P),24200,19830890.7
12/31/2021,Bill,Big Company ,,Outsources Services - India,24200,19855090.7
12/31/2021,Journal Entry,,Provision for Delaware Tax,-Split-,785.34,19855876.04
12/31/2021,Journal Entry,,Provision for Delaware Tax,-Split-,785.34,19856661.38
12/31/2021,Expense,Adobe,,Tools & Subscription - S&M,16.01,19856677.39
12/31/2021,Journal Entry,,Premium on Series seed preferred Stock,-Split-,-2499964.98,17356712.41
12/31/2021,Expense,Adobe,Mike ross,Credit Card - Ramp,16.01,17356728.42
12/31/2021,Journal Entry,,Provision for Expenses as on 31st Dec21,-Split-,212,17356940.42
12/31/2021,Bill,Big Company ,,Outsources Services - India,24200,17381140.42
12/31/2021,Bill,Big Company ,,Outsources Services - India,24200,17405340.42
12/31/2021,Expense,Adobe,,Tools & Subscription - S&M,16.01,17405356.43
12/31/2021,Journal Entry,,Provision for Expenses as on 31st Dec21,-Split-,212,17405568.43
12/31/2021,Journal Entry,,Provision for Expenses as on 31st Dec21,-Split-,212,17405780.43
12/31/2021,Journal Entry,,Provision for Delaware Tax,-Split-,785.34,17406565.77
12/31/2021,Bill,Big Company ,Service Expenses for the month of December 2021,Accounts Payable (A/P),24200,17430765.77
12/31/2021,Journal Entry,,Provision for Delaware Tax,-Split-,785.34,17431551.11
12/31/2021,Journal Entry,,Premium on Series seed preferred Stock,-Split-,-2499964.98,14931586.13
12/31/2021,Bill,Big Company ,Service Expenses for the month of December 2021,Accounts Payable (A/P),24200,14955786.13
12/31/2021,Journal Entry,,Premium on Series seed preferred Stock,-Split-,-2499964.98,12455821.15
12/31/2021,Expense,Adobe,Mike ross,Credit Card - Ramp,16.01,12455837.16
12/31/2021,Expense,Adobe,,Tools & Subscription - S&M,16.01,12455853.17
12/31/2021,Journal Entry,,Provision for Delaware Tax,-Split-,785.34,12456638.51
12/31/2021,Journal Entry,,Premium on Series seed preferred Stock,-Split-,2499964.98,14956603.49
12/31/2021,Journal Entry,,Provision for Delaware Tax,-Split-,785.34,14957388.83
12/31/2021,Journal Entry,,Premium on Series seed preferred Stock,-Split-,2499964.98,17457353.81
12/31/2021,Journal Entry,,Provision for Delaware Tax,-Split-,785.34,17458139.15
12/31/2021,Journal Entry,,Provision for Expenses as on 31st Dec21,-Split-,212,17458351.15
12/31/2021,Journal Entry,,Provision for Expenses as on 31st Dec21,-Split-,212,17458563.15
12/31/2021,Bill,Big Company ,Service Expenses for the month of December 2021,Accounts Payable (A/P),24200,17482763.15
12/31/2021,Journal Entry,,Premium on Series seed preferred Stock,-Split-,2499964.98,19982728.13
12/31/2021,Bill,Big Company ,,Outsources Services - India,24200,20006928.13
12/31/2021,Journal Entry,,Provision for Expenses as on 31st Dec21,-Split-,212,20007140.13
01/01/2022,Journal Entry,,Provision for Delaware Tax,-Split-,-785.34,20006354.79
01/01/2022,Journal Entry,,Provision for Delaware Tax,-Split-,-785.34,20005569.45
01/01/2022,Journal Entry,,Provision for Delaware Tax,-Split-,-785.34,20004784.11
01/01/2022,Journal Entry,,Provision for Delaware Tax,-Split-,-785.34,20003998.77
01/01/2022,Journal Entry,,Provision for Delaware Tax,-Split-,-785.34,20003213.43
01/01/2022,Journal Entry,,Provision for Delaware Tax,-Split-,-785.34,20002428.09
01/01/2022,Journal Entry,,Provision for Delaware Tax,-Split-,-785.34,20001642.75
01/01/2022,Journal Entry,,Provision for Delaware Tax,-Split-,-785.34,20000857.41
01/02/2022,Expense,Google G Suite,Mike ross,Credit Card - Ramp,73.99,20000931.4
01/02/2022,Expense,Google G Suite,,Tools & Subscription - G&A,73.99,20001005.39
01/02/2022,Expense,Google G Suite,,Tools & Subscription - G&A,73.99,20001079.38
01/02/2022,Expense,Google G Suite,,Tools & Subscription - G&A,73.99,20001153.37
01/02/2022,Expense,Google G Suite,Mike ross,Credit Card - Ramp,73.99,20001227.36
01/02/2022,Expense,Google G Suite,Mike ross,Credit Card - Ramp,73.99,20001301.35
01/02/2022,Expense,Google G Suite,,Tools & Subscription - G&A,73.99,20001375.34
01/03/2022,Expense,Mazurek Co,Harvey Spector,Credit Card - Ramp,29.95,20001405.29
01/03/2022,Expense,Amazon,Harvey Spector,Credit Card - Ramp,73.94,20001479.23
01/03/2022,Expense,Mazurek Co,Harvey Spector,Credit Card - Ramp,29.95,20001509.18
01/03/2022,Expense,Mazurek Co,,Tools & Subscription - G&A,29.95,20001539.13
01/03/2022,Expense,Mazurek Co,,Tools & Subscription - G&A,29.95,20001569.08
01/03/2022,Expense,Mazurek Co,,Tools & Subscription - G&A,29.95,20001599.03
01/03/2022,Expense,Amazon,Harvey Spector,Tools & Subscription - G&A,73.94,20001672.97
01/03/2022,Expense,Amazon,Harvey Spector,Credit Card - Ramp,73.94,20001746.91
01/03/2022,Expense,Amazon,Harvey Spector,Tools & Subscription - G&A,73.94,20001820.85
01/03/2022,Expense,Mazurek Co,Harvey Spector,Credit Card - Ramp,29.95,20001850.8
01/03/2022,Expense,Mazurek Co,,Tools & Subscription - G&A,29.95,20001880.75
01/03/2022,Expense,Amazon,Harvey Spector,Tools & Subscription - G&A,73.94,20001954.69
01/03/2022,Expense,Amazon,Harvey Spector,Credit Card - Ramp,73.94,20002028.63
01/03/2022,Expense,Amazon,Harvey Spector,Tools & Subscription - G&A,73.94,20002102.57
01/04/2022,Deposit,,Interest Accrual,Interest Received,2.01,20002104.58
01/04/2022,Deposit,,Interest Accrual,Savings (6977),2.01,20002106.59
01/04/2022,Expense,Namecheap,Harvey Spector,Credit Card - Ramp,14.32,20002120.91
01/04/2022,Deposit,,Interest Accrual,Savings (6977),2.01,20002122.92
01/04/2022,Deposit,,Interest Accrual,Interest Received,2.01,20002124.93
01/04/2022,Expense,Namecheap,,Tools & Subscription - G&A,14.32,20002139.25
01/04/2022,Expense,Namecheap,,Tools & Subscription - G&A,14.32,20002153.57
01/04/2022,Expense,Namecheap,,Tools & Subscription - G&A,14.32,20002167.89
01/04/2022,Deposit,,Interest Accrual,Interest Received,2.01,20002169.9
01/04/2022,Deposit,,Interest Accrual,Savings (6977),2.01,20002171.91
01/04/2022,Expense,Namecheap,Harvey Spector,Credit Card - Ramp,14.32,20002186.23
01/04/2022,Deposit,,Interest Accrual,Interest Received,2.01,20002188.24
01/04/2022,Expense,Namecheap,,Tools & Subscription - G&A,14.32,20002202.56
01/04/2022,Expense,Namecheap,Harvey Spector,Credit Card - Ramp,14.32,20002216.88
01/06/2022,Expense,Namecheap,,Tools & Subscription - G&A,7.98,20002224.86
01/06/2022,Expense,Namecheap,Harvey Spector,Credit Card - Ramp,7.98,20002232.84
01/06/2022,Expense,Namecheap,,Tools & Subscription - G&A,7.98,20002240.82
01/06/2022,Expense,Namecheap,Harvey Spector,Credit Card - Ramp,7.98,20002248.8
01/06/2022,Expense,Namecheap,Harvey Spector,Credit Card - Ramp,7.98,20002256.78
01/06/2022,Expense,Namecheap,,Tools & Subscription - G&A,7.98,20002264.76
01/06/2022,Expense,Namecheap,,Tools & Subscription - G&A,7.98,20002272.74
01/07/2022,Expense,Mailchimp,,Tools & Subscription - G&A,20.64,20002293.38
01/07/2022,Expense,Mailchimp,,Tools & Subscription - G&A,20.64,20002314.02
01/07/2022,Expense,Mailchimp,,Tools & Subscription - G&A,20.64,20002334.66
01/07/2022,Expense,Mailchimp,Mike ross,Credit Card - Ramp,20.64,20002355.3
01/07/2022,Expense,Mailchimp,Mike ross,Credit Card - Ramp,20.64,20002375.94
01/07/2022,Expense,Mailchimp,,Tools & Subscription - G&A,20.64,20002396.58
01/07/2022,Expense,Mailchimp,Mike ross,Credit Card - Ramp,20.64,20002417.22
01/11/2022,Expense,LinkedIn,,Tools & Subscription - G&A,33.22,20002450.44
01/11/2022,Expense,LinkedIn,Harvey Spector,Credit Card - Ramp,33.22,20002483.66
01/11/2022,Expense,LinkedIn,,Tools & Subscription - G&A,33.22,20002516.88
01/11/2022,Expense,Heroku,Balapavan Tirumani,Credit Card - Ramp,14,20002530.88
01/11/2022,Expense,Heroku,Balapavan Tirumani,Tools & Subscription - S&M,14,20002544.88
01/11/2022,Expense,LinkedIn,Harvey Spector,Credit Card - Ramp,33.22,20002578.1
01/11/2022,Expense,LinkedIn,,Tools & Subscription - G&A,33.22,20002611.32
01/11/2022,Expense,Heroku,Balapavan Tirumani,Credit Card - Ramp,14,20002625.32
01/11/2022,Expense,LinkedIn,Harvey Spector,Credit Card - Ramp,33.22,20002658.54
01/11/2022,Expense,Heroku,Balapavan Tirumani,Tools & Subscription - S&M,14,20002672.54
01/11/2022,Expense,LinkedIn,,Tools & Subscription - G&A,33.22,20002705.76
01/11/2022,Expense,Heroku,Balapavan Tirumani,Credit Card - Ramp,14,20002719.76
01/11/2022,Expense,Heroku,Balapavan Tirumani,Tools & Subscription - S&M,14,20002733.76
01/11/2022,Expense,Heroku,Balapavan Tirumani,Tools & Subscription - S&M,14,20002747.76
01/12/2022,Expense,Intuit India,,Tools & Subscription - G&A,5.08,20002752.84
01/12/2022,Expense,Intuit India,Harvey Spector,Credit Card - Ramp,5.08,20002757.92
01/12/2022,Expense,Glimpse,Harvey Spector,Credit Card - Ramp,29,20002786.92
01/12/2022,Expense,Glimpse,Harvey Spector,Tools & Subscription,29,20002815.92
01/12/2022,Expense,Intuit India,Harvey Spector,Credit Card - Ramp,5.08,20002821
01/12/2022,Expense,Intuit India,,Tools & Subscription - G&A,5.08,20002826.08
01/12/2022,Expense,Intuit India,Harvey Spector,Credit Card - Ramp,5.08,20002831.16
01/12/2022,Expense,Glimpse,Harvey Spector,Tools & Subscription,29,20002860.16
01/12/2022,Expense,Glimpse,Harvey Spector,Tools & Subscription,29,20002889.16
01/12/2022,Expense,Glimpse,Harvey Spector,Credit Card - Ramp,29,20002918.16
01/12/2022,Expense,Intuit India,,Tools & Subscription - G&A,5.08,20002923.24
01/12/2022,Expense,Intuit India,,Tools & Subscription - G&A,5.08,20002928.32
01/12/2022,Expense,Glimpse,Harvey Spector,Tools & Subscription,29,20002957.32
01/12/2022,Expense,Glimpse,Harvey Spector,Credit Card - Ramp,29,20002986.32
01/13/2022,Expense,Figma,,Tools & Subscription - G&A,15,20003001.32
01/13/2022,Expense,Figma,Mike ross,Credit Card - Ramp,15,20003016.32
01/13/2022,Expense,Figma,,Tools & Subscription - G&A,15,20003031.32
01/13/2022,Expense,Figma,Mike ross,Credit Card - Ramp,15,20003046.32
01/13/2022,Expense,Figma,Mike ross,Credit Card - Ramp,15,20003061.32
01/13/2022,Expense,Figma,,Tools & Subscription - G&A,15,20003076.32
01/13/2022,Expense,Figma,,Tools & Subscription - G&A,15,20003091.32
01/14/2022,Expense,Intuit,,Tools & Subscription - G&A,25,20003116.32
01/14/2022,Expense,Intuit,,Tools & Subscription - G&A,25,20003141.32
01/14/2022,Expense,Intuit,Harvey Spector,Credit Card - Ramp,25,20003166.32
01/14/2022,Expense,Intuit,Harvey Spector,Credit Card - Ramp,25,20003191.32
01/14/2022,Expense,Intuit,,Tools & Subscription - G&A,25,20003216.32
01/14/2022,Expense,Intuit,Harvey Spector,Credit Card - Ramp,25,20003241.32
01/14/2022,Expense,Intuit,,Tools & Subscription - G&A,25,20003266.32
01/16/2022,Expense,Zapier,Harvey Spector,Credit Card - Ramp,29.99,20003296.31
01/16/2022,Expense,Zapier,,Tools & Subscription - G&A,29.99,20003326.3
01/16/2022,Expense,Zapier,Harvey Spector,Credit Card - Ramp,29.99,20003356.29
01/16/2022,Expense,Zapier,,Tools & Subscription - G&A,29.99,20003386.28
01/16/2022,Expense,Zapier,,Tools & Subscription - G&A,29.99,20003416.27
01/16/2022,Expense,Zapier,Harvey Spector,Credit Card - Ramp,29.99,20003446.26
01/16/2022,Expense,Zapier,,Tools & Subscription - G&A,29.99,20003476.25
01/17/2022,Expense,ErgoTune,Mike ross,Credit Card - Ramp,466.28,20003942.53
01/17/2022,Expense,Orbitkey,,Tools & Subscription - G&A,104.79,20004047.32
01/17/2022,Expense,ErgoTune,,Office expenses,466.28,20004513.6
01/17/2022,Expense,Orbitkey,Mike ross,Credit Card - Ramp,104.79,20004618.39
01/17/2022,Expense,Orbitkey,Mike ross,Credit Card - Ramp,104.79,20004723.18
01/17/2022,Expense,ErgoTune,Mike ross,Credit Card - Ramp,466.28,20005189.46
01/17/2022,Expense,ErgoTune,,Office expenses,466.28,20005655.74
01/17/2022,Expense,Orbitkey,,Tools & Subscription - G&A,104.79,20005760.53
01/17/2022,Expense,Orbitkey,,Tools & Subscription - G&A,104.79,20005865.32
01/17/2022,Expense,ErgoTune,,Office expenses,466.28,20006331.6
01/17/2022,Expense,ErgoTune,Mike ross,Credit Card - Ramp,466.28,20006797.88
01/17/2022,Expense,Orbitkey,Mike ross,Credit Card - Ramp,104.79,20006902.67
01/17/2022,Expense,ErgoTune,Mike ross,Credit Card - Ramp,466.28,20007368.95
01/17/2022,Expense,Orbitkey,,Tools & Subscription - G&A,104.79,20007473.74
01/17/2022,Expense,ErgoTune,,Office expenses,466.28,20007940.02
01/18/2022,Expense,Income Capitals ,Income Capitals ,Professional Service Charges,-2310,20005630.02
01/18/2022,Deposit,,CompanyB,Account1,-150000,19855630.02
01/18/2022,Expense,,CompanyB,Account1,150000,20005630.02
01/18/2022,Deposit,,CompanyB,Investment in Australia Subsidiary,150000,20155630.02
01/18/2022,Expense,Income Capitals ,Income Capitals ,Professional Service Charges,-2310,20153320.02
01/18/2022,Transfer,,PaymentServiceB Checking **7257,Savings (6977),150000,20303320.02
01/18/2022,Deposit,,CompanyB,Investment in Australia Subsidiary,150000,20453320.02
01/18/2022,Expense,Income Capitals ,Income Capitals ,Account1,2310,20455630.02
01/18/2022,Expense,Income Capitals ,Income Capitals ,Professional Service Charges,-2310,20453320.02
01/18/2022,Expense,,CompanyB,Investment in Australia Subsidiary,-150000,20303320.02
01/18/2022,Expense,,CompanyB,Investment in Australia Subsidiary,-150000,20153320.02
01/18/2022,Transfer,,PaymentServiceB Checking **7257,Account1,-150000,20003320.02
01/18/2022,Expense,Income Capitals ,Income Capitals ,Account1,2310,20005630.02
01/18/2022,Deposit,,CompanyB,Account1,-150000,19855630.02
01/18/2022,Expense,Income Capitals ,Income Capitals ,Account1,2310,19857940.02
01/18/2022,Transfer,,PaymentServiceB Checking **7257,Savings (6977),150000,20007940.02
01/18/2022,Expense,,CompanyB,Account1,150000,20157940.02
01/18/2022,Transfer,,PaymentServiceB Checking **7257,Account1,-150000,20007940.02
01/18/2022,Deposit,,CompanyB,Investment in Australia Subsidiary,150000,20157940.02
01/18/2022,Expense,Income Capitals ,Income Capitals ,Professional Service Charges,-2310,20155630.02
01/18/2022,Transfer,,PaymentServiceB Checking **7257,Savings (6977),150000,20305630.02
01/18/2022,Expense,,CompanyB,Account1,150000,20455630.02
01/18/2022,Expense,,CompanyB,Investment in Australia Subsidiary,-150000,20305630.02
01/18/2022,Deposit,,CompanyB,Account1,-150000,20155630.02
01/18/2022,Expense,Income Capitals ,Income Capitals ,Account1,2310,20157940.02
01/18/2022,Transfer,,PaymentServiceB Checking **7257,Account1,-150000,20007940.02
01/18/2022,Deposit,,CompanyB,Investment in Australia Subsidiary,150000,20157940.02
01/18/2022,Expense,,CompanyB,Investment in Australia Subsidiary,-150000,20007940.02
01/18/2022,Transfer,,PaymentServiceB Checking **7257,Account1,-150000,19857940.02
01/18/2022,Deposit,,CompanyB,Account1,-150000,19707940.02
01/18/2022,Transfer,,PaymentServiceB Checking **7257,Savings (6977),150000,19857940.02
01/18/2022,Expense,,CompanyB,Account1,150000,20007940.02
01/20/2022,Credit Card Payment,,RAMP BUSINESS CO,Account1,-1739.88,20006200.14
01/20/2022,Expense,Zoom,,Tools & Subscription - G&A,149.9,20006350.04
01/20/2022,Expense,,CompanyB,Account1,120000,20126350.04
01/20/2022,Credit Card Payment,,RAMP BUSINESS CO,Account1,-1739.88,20124610.16
01/20/2022,Expense,,CompanyB,Account1,120000,20244610.16
01/20/2022,Expense,,CompanyB,Investment in Australia Subsidiary,-120000,20124610.16
01/20/2022,Expense,,CompanyB,Account1,120000,20244610.16
01/20/2022,Credit Card Payment,,RAMP BUSINESS CO,Credit Card - Ramp,-1739.88,20242870.28
01/20/2022,Transfer,,PaymentServiceB Checking **7257,Account1,-120000,20122870.28
01/20/2022,Expense,Zoom,,Tools & Subscription - G&A,149.9,20123020.18
01/20/2022,Expense,,CompanyB,Account1,120000,20243020.18
01/20/2022,Expense,,CompanyB,Investment in Australia Subsidiary,-120000,20123020.18
01/20/2022,Expense,Zoom,,Tools & Subscription - G&A,149.9,20123170.08
01/20/2022,Transfer,,PaymentServiceB Checking **7257,Savings (6977),120000,20243170.08
01/20/2022,Expense,Zoom,Harvey Spector,Credit Card - Ramp,149.9,20243319.98
01/20/2022,Credit Card Payment,,RAMP BUSINESS CO,Credit Card - Ramp,-1739.88,20241580.1
01/20/2022,Transfer,,PaymentServiceB Checking **7257,Savings (6977),120000,20361580.1
01/20/2022,Credit Card Payment,,RAMP BUSINESS CO,Credit Card - Ramp,-1739.88,20359840.22
01/20/2022,Transfer,,PaymentServiceB Checking **7257,Account1,-120000,20239840.22
01/20/2022,Expense,Zoom,Harvey Spector,Credit Card - Ramp,149.9,20239990.12
01/20/2022,Expense,Zoom,Harvey Spector,Credit Card - Ramp,149.9,20240140.02
01/20/2022,Credit Card Payment,,RAMP BUSINESS CO,Account1,-1739.88,20238400.14
01/20/2022,Credit Card Payment,,RAMP BUSINESS CO,Account1,-1739.88,20236660.26
01/20/2022,Transfer,,PaymentServiceB Checking **7257,Account1,-120000,20116660.26
01/20/2022,Transfer,,PaymentServiceB Checking **7257,Account1,-120000,19996660.26
01/20/2022,Expense,,CompanyB,Investment in Australia Subsidiary,-120000,19876660.26
01/20/2022,Transfer,,PaymentServiceB Checking **7257,Savings (6977),120000,19996660.26
01/20/2022,Credit Card Payment,,RAMP BUSINESS CO,Credit Card - Ramp,-1739.88,19994920.38
01/20/2022,Transfer,,PaymentServiceB Checking **7257,Savings (6977),120000,20114920.38
01/20/2022,Expense,Zoom,,Tools & Subscription - G&A,149.9,20115070.28
01/20/2022,Expense,,CompanyB,Investment in Australia Subsidiary,-120000,19995070.28
01/22/2022,Expense,Automate,Balapavan Tirumani,Credit Card - Ramp,29,19995099.28
01/22/2022,Expense,Dovetail,,Tools & Subscription - G&A,30,19995129.28
01/22/2022,Expense,Automate,,Tools & Subscription - G&A,29,19995158.28
01/22/2022,Expense,Automate,,Tools & Subscription - G&A,29,19995187.28
01/22/2022,Expense,Dovetail,,Tools & Subscription - G&A,30,19995217.28
01/22/2022,Expense,Dovetail,Harvey Spector,Credit Card - Ramp,30,19995247.28
01/22/2022,Expense,Automate,Balapavan Tirumani,Credit Card - Ramp,29,19995276.28
01/22/2022,Expense,Automate,Balapavan Tirumani,Credit Card - Ramp,29,19995305.28
01/22/2022,Expense,Dovetail,Harvey Spector,Credit Card - Ramp,30,19995335.28
01/22/2022,Expense,Automate,,Tools & Subscription - G&A,29,19995364.28
01/22/2022,Expense,Dovetail,,Tools & Subscription - G&A,30,19995394.28
01/22/2022,Expense,Dovetail,,Tools & Subscription - G&A,30,19995424.28
01/22/2022,Expense,Automate,,Tools & Subscription - G&A,29,19995453.28
01/22/2022,Expense,Dovetail,Harvey Spector,Credit Card - Ramp,30,19995483.28
01/23/2022,Expense,Super,Harvey Spector,Credit Card - Ramp,12,19995495.28
01/23/2022,Expense,Superhuman,Mike ross,Credit Card - Ramp,30,19995525.28
01/23/2022,Expense,Superhuman,,Professional Service Charges,30,19995555.28
01/23/2022,Expense,Super,,Tools & Subscription - G&A,12,19995567.28
01/23/2022,Expense,Superhuman,,Professional Service Charges,30,19995597.28
01/23/2022,Expense,Superhuman,Mike ross,Credit Card - Ramp,30,19995627.28
01/23/2022,Expense,Super,Harvey Spector,Credit Card - Ramp,12,19995639.28
01/23/2022,Expense,Super,Harvey Spector,Credit Card - Ramp,12,19995651.28
01/23/2022,Expense,Super,,Tools & Subscription - G&A,12,19995663.28
01/23/2022,Expense,Superhuman,,Professional Service Charges,30,19995693.28
01/23/2022,Expense,Superhuman,Mike ross,Credit Card - Ramp,30,19995723.28
01/23/2022,Expense,Super,,Tools & Subscription - G&A,12,19995735.28
01/23/2022,Expense,Super,,Tools & Subscription - G&A,12,19995747.28
01/23/2022,Expense,Superhuman,Mike ross,Credit Card - Ramp,30,19995777.28
01/23/2022,Expense,Superhuman,,Professional Service Charges,30,19995807.28
01/24/2022,Expense,,CompanyB,Account1,150000,20145807.28
01/24/2022,Transfer,,PaymentServiceB Checking **7257,Savings (6977),50000,20195807.28
01/24/2022,Transfer,,PaymentServiceB Checking **7257,Savings (6977),50000,20245807.28
01/24/2022,Expense,,CompanyB,Investment in Australia Subsidiary,-30000,20215807.28
01/24/2022,Expense,,CompanyB,Investment in Australia Subsidiary,-150000,20065807.28
01/24/2022,Deposit,,CompanyB,Investment in Australia Subsidiary,150000,20215807.28
01/24/2022,Expense,,CompanyB,Investment in Australia Subsidiary,-150000,20065807.28
01/24/2022,Expense,,CompanyB,Investment in Australia Subsidiary,-30000,20035807.28
01/24/2022,Expense,,CompanyB,Investment in Australia Subsidiary,-150000,19885807.28
01/24/2022,Deposit,,CompanyB,Investment in Australia Subsidiary,150000,20035807.28
01/24/2022,Deposit,,CompanyB,Investment in Australia Subsidiary,150000,20185807.28
01/24/2022,Transfer,,PaymentServiceB Checking **7257,Account1,-50000,20135807.28
01/24/2022,Transfer,,PaymentServiceB Checking **7257,Savings (6977),50000,20185807.28
01/24/2022,Expense,,CompanyB,Account1,30000,20215807.28
01/24/2022,Expense,,CompanyB,Investment in Australia Subsidiary,-30000,20185807.28
01/24/2022,Deposit,,CompanyB,Investment in Australia Subsidiary,150000,20335807.28
01/24/2022,Transfer,,PaymentServiceB Checking **7257,Savings (6977),50000,20385807.28
01/24/2022,Expense,,CompanyB,Investment in Australia Subsidiary,-30000,20355807.28
01/24/2022,Expense,,CompanyB,Investment in Australia Subsidiary,-150000,20205807.28
01/24/2022,Expense,,CompanyB,Account1,150000,20355807.28
01/24/2022,Deposit,,CompanyB,Account1,-150000,20205807.28
01/24/2022,Expense,,CompanyB,Account1,30000,20235807.28
01/24/2022,Expense,,CompanyB,Account1,150000,20385807.28
01/24/2022,Deposit,,CompanyB,Account1,-150000,20235807.28
01/24/2022,Deposit,,CompanyB,Account1,-150000,20085807.28
01/24/2022,Transfer,,PaymentServiceB Checking **7257,Account1,-50000,20035807.28
01/24/2022,Transfer,,PaymentServiceB Checking **7257,Account1,-50000,19985807.28
01/24/2022,Deposit,,CompanyB,Account1,-150000,19835807.28
01/24/2022,Expense,,CompanyB,Account1,30000,19865807.28
01/24/2022,Transfer,,PaymentServiceB Checking **7257,Account1,-50000,19815807.28
01/24/2022,Expense,,CompanyB,Account1,30000,19845807.28
01/24/2022,Expense,,CompanyB,Account1,150000,19995807.28
01/25/2022,Expense,GitKraken,Ahielan Ravichandran,Credit Card - Ramp,59.4,19995866.68
01/25/2022,Transfer,,PaymentServiceB Checking **7257,Account1,-20000,19975866.68
01/25/2022,Expense,GitKraken,,Tools & Subscription - G&A,59.4,19975926.08
01/25/2022,Expense,Big Company ,Big Company ,Accounts Payable (A/P),-22000,19953926.08
01/25/2022,Expense,GitKraken,,Tools & Subscription - G&A,59.4,19953985.48
01/25/2022,Expense,Miro,,Tools & Subscription - G&A,90,19954075.48
01/25/2022,Expense,Miro,Mike ross,Credit Card - Ramp,90,19954165.48
01/25/2022,Transfer,,PaymentServiceB Checking **7257,Account1,-20000,19934165.48
01/25/2022,Expense,GitKraken,Ahielan Ravichandran,Credit Card - Ramp,59.4,19934224.88
01/25/2022,Expense,Big Company ,Big Company ,Account1,-22000,19912224.88
01/25/2022,Expense,Big Company ,Big Company ,Account1,-22000,19890224.88
01/25/2022,Expense,Miro,Mike ross,Credit Card - Ramp,90,19890314.88
01/25/2022,Expense,Miro,Mike ross,Credit Card - Ramp,90,19890404.88
01/25/2022,Expense,GitKraken,Ahielan Ravichandran,Credit Card - Ramp,59.4,19890464.28
01/25/2022,Expense,Miro,,Tools & Subscription - G&A,90,19890554.28
01/25/2022,Transfer,,PaymentServiceB Checking **7257,Savings (6977),20000,19910554.28
01/25/2022,Expense,Big Company ,Big Company ,Account1,-22000,19888554.28
01/25/2022,Transfer,,PaymentServiceB Checking **7257,Account1,-20000,19868554.28
01/25/2022,Expense,Big Company ,Big Company ,Accounts Payable (A/P),-22000,19846554.28
01/25/2022,Expense,GitKraken,,Tools & Subscription - G&A,59.4,19846613.68
01/25/2022,Expense,Big Company ,Big Company ,Account1,-22000,19824613.68
01/25/2022,Transfer,,PaymentServiceB Checking **7257,Savings (6977),20000,19844613.68
01/25/2022,Expense,Big Company ,Big Company ,Accounts Payable (A/P),-22000,19822613.68
01/25/2022,Transfer,,PaymentServiceB Checking **7257,Savings (6977),20000,19842613.68
01/25/2022,Expense,GitKraken,,Tools & Subscription - G&A,59.4,19842673.08
01/25/2022,Expense,Miro,,Tools & Subscription - G&A,90,19842763.08
01/25/2022,Transfer,,PaymentServiceB Checking **7257,Savings (6977),20000,19862763.08
01/25/2022,Expense,Miro,,Tools & Subscription - G&A,90,19862853.08
01/25/2022,Transfer,,PaymentServiceB Checking **7257,Account1,-20000,19842853.08
01/25/2022,Expense,Big Company ,Big Company ,Accounts Payable (A/P),-22000,19820853.08
01/27/2022,Expense,Sendinblue,,Tools & Subscription - G&A,51.92,19820905
01/27/2022,Expense,Splitbee,,Tools & Subscription - G&A,16.52,19820921.52
01/27/2022,Expense,Sendinblue,,Tools & Subscription - G&A,51.92,19820973.44
01/27/2022,Expense,Sendinblue,Balapavan Tirumani,Credit Card - Ramp,51.92,19821025.36
01/27/2022,Expense,Sendinblue,Balapavan Tirumani,Credit Card - Ramp,51.92,19821077.28
01/27/2022,Expense,Splitbee,Harris Jose,Credit Card - Ramp,16.52,19821093.8
01/27/2022,Expense,Sendinblue,,Tools & Subscription - G&A,51.92,19821145.72
01/27/2022,Expense,Sendinblue,,Tools & Subscription - G&A,51.92,19821197.64
01/27/2022,Expense,Splitbee,Harris Jose,Credit Card - Ramp,16.52,19821214.16
01/27/2022,Expense,Splitbee,,Tools & Subscription - G&A,16.52,19821230.68
01/27/2022,Expense,Splitbee,Harris Jose,Credit Card - Ramp,16.52,19821247.2
01/27/2022,Expense,Splitbee,,Tools & Subscription - G&A,16.52,19821263.72
01/27/2022,Expense,Sendinblue,Balapavan Tirumani,Credit Card - Ramp,51.92,19821315.64
01/27/2022,Expense,Splitbee,,Tools & Subscription - G&A,16.52,19821332.16
01/31/2022,Bill,Big Company ,,Outsources Services - India,31325,19852657.16
01/31/2022,Expense,Adobe,,Tools & Subscription - S&M,15.56,19852672.72
01/31/2022,Bill,Big Company ,"Service Expenses for the month of January 2022 
INR 2335626 @ 74.56",Accounts Payable (A/P),31325,19883997.72
01/31/2022,Expense,Adobe,,Tools & Subscription - S&M,15.56,19884013.28
01/31/2022,Bill,Big Company ,"Service Expenses for the month of January 2022 
INR 2335626 @ 74.56",Accounts Payable (A/P),31325,19915338.28
01/31/2022,Bill,Big Company ,,Outsources Services - India,31325,19946663.28
01/31/2022,Bill,Big Company ,"Service Expenses for the month of January 2022 
INR 2335626 @ 74.56",Accounts Payable (A/P),31325,19977988.28
01/31/2022,Expense,Adobe,Mike ross,Credit Card - Ramp,15.56,19978003.84
01/31/2022,Bill,Big Company ,,Outsources Services - India,31325,20009328.84
01/31/2022,Expense,Adobe,,Tools & Subscription - S&M,15.56,20009344.4
01/31/2022,Bill,Big Company ,"Service Expenses for the month of January 2022 
INR 2335626 @ 74.56",Accounts Payable (A/P),31325,20040669.4
01/31/2022,Expense,Adobe,Mike ross,Credit Card - Ramp,15.56,20040684.96
01/31/2022,Expense,Adobe,Mike ross,Credit Card - Ramp,15.56,20040700.52
01/31/2022,Expense,Adobe,,Tools & Subscription - S&M,15.56,20040716.08
01/31/2022,Bill,Big Company ,,Outsources Services - India,31325,20072041.08
02/01/2022,Expense,Slack,,Tools & Subscription - G&A,55.45,20072096.53
02/01/2022,Expense,Slack,,Tools & Subscription - G&A,55.45,20072151.98
02/01/2022,Expense,Slack,Mike ross,Credit Card - Ramp,55.45,20072207.43
02/01/2022,Expense,Calendly,Harvey Spector,Credit Card - Ramp,40,20072247.43
02/01/2022,Expense,Calendly,Harvey Spector,Credit Card - Ramp,40,20072287.43
02/01/2022,Expense,Slack,,Tools & Subscription - G&A,55.45,20072342.88
02/01/2022,Expense,Calendly,,Tools & Subscription - G&A,40,20072382.88
02/01/2022,Expense,Slack,,Tools & Subscription - G&A,55.45,20072438.33
02/01/2022,Expense,Slack,Mike ross,Credit Card - Ramp,55.45,20072493.78
02/01/2022,Expense,Calendly,Harvey Spector,Credit Card - Ramp,40,20072533.78
02/01/2022,Expense,Slack,Mike ross,Credit Card - Ramp,55.45,20072589.23
02/01/2022,Expense,Calendly,,Tools & Subscription - G&A,40,20072629.23
02/01/2022,Expense,Calendly,,Tools & Subscription - G&A,40,20072669.23
02/01/2022,Expense,Calendly,,Tools & Subscription - G&A,40,20072709.23
02/02/2022,Expense,Google G Suite,Mike ross,Credit Card - Ramp,78.87,20072788.1
02/02/2022,Expense,Google G Suite,,Tools & Subscription - G&A,78.87,20072866.97
02/02/2022,Expense,Google G Suite,,Tools & Subscription - G&A,78.87,20072945.84
02/02/2022,Expense,Google G Suite,Mike ross,Credit Card - Ramp,78.87,20073024.71
02/02/2022,Expense,Google G Suite,,Tools & Subscription - G&A,78.87,20073103.58
02/02/2022,Expense,Google G Suite,Mike ross,Credit Card - Ramp,78.87,20073182.45
02/02/2022,Expense,Google G Suite,,Tools & Subscription - G&A,78.87,20073261.32
02/03/2022,Expense,Mazurek Co,Harvey Spector,Credit Card - Ramp,29.95,20073291.27
02/03/2022,Expense,Mazurek Co,Harvey Spector,Credit Card - Ramp,29.95,20073321.22
02/03/2022,Expense,Mazurek Co,,Tools & Subscription - G&A,29.95,20073351.17
02/03/2022,Expense,Mazurek Co,,Tools & Subscription - G&A,29.95,20073381.12
02/03/2022,Expense,Mazurek Co,Harvey Spector,Credit Card - Ramp,29.95,20073411.07
02/03/2022,Expense,Mazurek Co,,Tools & Subscription - G&A,29.95,20073441.02
02/03/2022,Expense,Mazurek Co,,Tools & Subscription - G&A,29.95,20073470.97
02/04/2022,Deposit,,Interest Accrual,Interest Received,1.68,20073472.65
02/04/2022,Deposit,,Interest Accrual,Interest Received,1.68,20073474.33
02/04/2022,Deposit,,Interest Accrual,Interest Received,1.68,20073476.01
02/04/2022,Deposit,,Interest Accrual,Savings (6977),1.68,20073477.69
02/04/2022,Deposit,,Interest Accrual,Interest Received,1.68,20073479.37
02/04/2022,Deposit,,Interest Accrual,Savings (6977),1.68,20073481.05
02/04/2022,Deposit,,Interest Accrual,Savings (6977),1.68,20073482.73
02/07/2022,Expense,Mailchimp,Mike ross,Credit Card - Ramp,20.57,20073503.3
02/07/2022,Expense,Mailchimp,,Tools & Subscription - G&A,20.57,20073523.87
02/07/2022,Expense,Mailchimp,Mike ross,Credit Card - Ramp,20.57,20073544.44
02/07/2022,Expense,Mailchimp,,Tools & Subscription - G&A,20.57,20073565.01
02/07/2022,Expense,1Password,,Tools & Subscription - G&A,50.59,20073615.6
02/07/2022,Expense,1Password,,Tools & Subscription - G&A,50.59,20073666.19
02/07/2022,Expense,1Password,Mike ross,Credit Card - Ramp,50.59,20073716.78
02/07/2022,Expense,1Password,,Tools & Subscription - G&A,50.59,20073767.37
02/07/2022,Expense,Mailchimp,,Tools & Subscription - G&A,20.57,20073787.94
02/07/2022,Expense,Mailchimp,Mike ross,Credit Card - Ramp,20.57,20073808.51
02/07/2022,Expense,Mailchimp,,Tools & Subscription - G&A,20.57,20073829.08
02/07/2022,Expense,1Password,Mike ross,Credit Card - Ramp,50.59,20073879.67
02/07/2022,Expense,1Password,,Tools & Subscription - G&A,50.59,20073930.26
02/07/2022,Expense,1Password,Mike ross,Credit Card - Ramp,50.59,20073980.85
02/09/2022,Expense,Usersnap,,Tools & Subscription - G&A,19,20073999.85
02/09/2022,Expense,Heroku,Balapavan Tirumani,Tools & Subscription - S&M,14,20074013.85
02/09/2022,Expense,Income Capitals ,Income Capitals ,Account1,1740,20075753.85
02/09/2022,Expense,Income Capitals ,Income Capitals ,Professional Service Charges,-1740,20074013.85
02/09/2022,Expense,Income Capitals ,Income Capitals ,Account1,1740,20075753.85
02/09/2022,Expense,Usersnap,,Tools & Subscription - G&A,19,20075772.85
02/09/2022,Expense,Usersnap,Harris Jose,Credit Card - Ramp,19,20075791.85
02/09/2022,Expense,Income Capitals ,Income Capitals ,Professional Service Charges,-1740,20074051.85
02/09/2022,Expense,Heroku,Balapavan Tirumani,Tools & Subscription - S&M,14,20074065.85
02/09/2022,Expense,Heroku,Balapavan Tirumani,Credit Card - Ramp,14,20074079.85
02/09/2022,Expense,Heroku,Balapavan Tirumani,Credit Card - Ramp,14,20074093.85
02/09/2022,Expense,Income Capitals ,Income Capitals ,Professional Service Charges,-1740,20072353.85
02/09/2022,Expense,Income Capitals ,Income Capitals ,Account1,1740,20074093.85
02/09/2022,Expense,Usersnap,,Tools & Subscription - G&A,19,20074112.85
02/09/2022,Expense,Usersnap,Harris Jose,Credit Card - Ramp,19,20074131.85
02/09/2022,Expense,Heroku,Balapavan Tirumani,Credit Card - Ramp,14,20074145.85
02/09/2022,Expense,Income Capitals ,Income Capitals ,Account1,1740,20075885.85
02/09/2022,Expense,Heroku,Balapavan Tirumani,Tools & Subscription - S&M,14,20075899.85
02/09/2022,Expense,Usersnap,,Tools & Subscription - G&A,19,20075918.85
02/09/2022,Expense,Heroku,Balapavan Tirumani,Tools & Subscription - S&M,14,20075932.85
02/09/2022,Expense,Income Capitals ,Income Capitals ,Professional Service Charges,-1740,20074192.85
02/09/2022,Expense,Usersnap,Harris Jose,Credit Card - Ramp,19,20074211.85
02/10/2022,Expense,Pause Cafe,Harvey Spector,Meals & Entertainment,32.22,20074244.07
02/10/2022,Expense,Pause Cafe,Harvey Spector,Credit Card - Ramp,32.22,20074276.29
02/10/2022,Expense,Pause Cafe,Harvey Spector,Meals & Entertainment,32.22,20074308.51
02/10/2022,Expense,Pause Cafe,Harvey Spector,Meals & Entertainment,32.22,20074340.73
02/10/2022,Expense,Pause Cafe,Harvey Spector,Credit Card - Ramp,32.22,20074372.95
02/10/2022,Expense,Pause Cafe,Harvey Spector,Credit Card - Ramp,32.22,20074405.17
02/10/2022,Expense,Pause Cafe,Harvey Spector,Meals & Entertainment,32.22,20074437.39
02/10/2022,Expense,Pause Cafe,Harvey Spector,Credit Card - Ramp,32.22,20074469.61
02/11/2022,Expense,LinkedIn,Harvey Spector,Credit Card - Ramp,32.55,20074502.16
02/11/2022,Expense,LinkedIn,Harvey Spector,Credit Card - Ramp,32.55,20074534.71
02/11/2022,Expense,LinkedIn,,Tools & Subscription - G&A,32.55,20074567.26
02/11/2022,Expense,LinkedIn,Harvey Spector,Credit Card - Ramp,32.55,20074599.81
02/11/2022,Expense,LinkedIn,,Tools & Subscription - G&A,32.55,20074632.36
02/11/2022,Expense,LinkedIn,,Tools & Subscription - G&A,32.55,20074664.91
02/11/2022,Expense,LinkedIn,,Tools & Subscription - G&A,32.55,20074697.46
02/12/2022,Expense,Intuit India,,Tools & Subscription - G&A,16.6,20074714.06
02/12/2022,Expense,Glimpse,Harvey Spector,Credit Card - Ramp,29,20074743.06
02/12/2022,Expense,Intuit India,,Tools & Subscription - G&A,16.6,20074759.66
02/12/2022,Expense,Glimpse,Harvey Spector,Tools & Subscription,29,20074788.66
02/12/2022,Expense,Glimpse,Harvey Spector,Tools & Subscription,29,20074817.66
02/12/2022,Expense,Intuit India,Harvey Spector,Credit Card - Ramp,16.6,20074834.26
02/12/2022,Expense,Glimpse,Harvey Spector,Tools & Subscription,29,20074863.26
02/12/2022,Expense,Glimpse,Harvey Spector,Credit Card - Ramp,29,20074892.26
02/12/2022,Expense,Intuit India,Harvey Spector,Credit Card - Ramp,16.6,20074908.86
02/12/2022,Expense,Intuit India,,Tools & Subscription - G&A,16.6,20074925.46
02/12/2022,Expense,Intuit India,,Tools & Subscription - G&A,16.6,20074942.06
02/12/2022,Expense,Glimpse,Harvey Spector,Tools & Subscription,29,20074971.06
02/12/2022,Expense,Intuit India,Harvey Spector,Credit Card - Ramp,16.6,20074987.66
02/12/2022,Expense,Glimpse,Harvey Spector,Credit Card - Ramp,29,20075016.66
02/13/2022,Expense,Figma,,Tools & Subscription - G&A,35,20075051.66
02/13/2022,Expense,Graphics Press,Mike ross,Credit Card - Ramp,230,20075281.66
02/13/2022,Expense,Figma,,Tools & Subscription - G&A,35,20075316.66
02/13/2022,Expense,Graphics Press,,Tools & Subscription - G&A,230,20075546.66
02/13/2022,Expense,Figma,Mike ross,Credit Card - Ramp,35,20075581.66
02/13/2022,Expense,Graphics Press,Mike ross,Credit Card - Ramp,230,20075811.66
02/13/2022,Expense,Figma,,Tools & Subscription - G&A,35,20075846.66
02/13/2022,Expense,Graphics Press,,Tools & Subscription - G&A,230,20076076.66
02/13/2022,Expense,Figma,,Tools & Subscription - G&A,35,20076111.66
02/13/2022,Expense,Graphics Press,Mike ross,Credit Card - Ramp,230,20076341.66
02/13/2022,Expense,Figma,Mike ross,Credit Card - Ramp,35,20076376.66
02/13/2022,Expense,Graphics Press,,Tools & Subscription - G&A,230,20076606.66
02/13/2022,Expense,Graphics Press,,Tools & Subscription - G&A,230,20076836.66
02/13/2022,Expense,Figma,Mike ross,Credit Card - Ramp,35,20076871.66
02/14/2022,Expense,Intuit,Harvey Spector,Credit Card - Ramp,50,20076921.66
02/14/2022,Expense,Intuit,,Tools & Subscription - G&A,50,20076971.66
02/14/2022,Expense,Intuit,Harvey Spector,Credit Card - Ramp,50,20077021.66
02/14/2022,Expense,Intuit,Harvey Spector,Credit Card - Ramp,50,20077071.66
02/14/2022,Expense,Intuit,,Tools & Subscription - G&A,50,20077121.66
02/14/2022,Expense,Intuit,,Tools & Subscription - G&A,50,20077171.66
02/14/2022,Expense,Intuit,,Tools & Subscription - G&A,50,20077221.66
02/16/2022,Expense,Zapier,,Tools & Subscription - G&A,29.99,20077251.65
02/16/2022,Expense,Zapier,Harvey Spector,Credit Card - Ramp,29.99,20077281.64
02/16/2022,Expense,Kula,Harvey Spector,Credit Card - Ramp,3000,20080281.64
02/16/2022,Expense,Gumroad,Harvey Spector,Professional Service Charges,6.99,20080288.63
02/16/2022,Expense,Gumroad,Harvey Spector,Credit Card - Ramp,6.99,20080295.62
02/16/2022,Expense,Zapier,,Tools & Subscription - G&A,29.99,20080325.61
02/16/2022,Expense,Kula,,Tools & Subscription - G&A,3000,20083325.61
02/16/2022,Expense,Gumroad,Harvey Spector,Professional Service Charges,6.99,20083332.6
02/16/2022,Expense,Kula,,Tools & Subscription - G&A,3000,20086332.6
02/16/2022,Expense,Kula,,Tools & Subscription - G&A,3000,20089332.6
02/16/2022,Expense,Gumroad,Harvey Spector,Credit Card - Ramp,6.99,20089339.59
02/16/2022,Expense,Zapier,,Tools & Subscription - G&A,29.99,20089369.58
02/16/2022,Expense,Kula,,Tools & Subscription - G&A,3000,20092369.58
02/16/2022,Expense,Gumroad,Harvey Spector,Professional Service Charges,6.99,20092376.57
02/16/2022,Expense,Gumroad,Harvey Spector,Professional Service Charges,6.99,20092383.56
02/16/2022,Expense,Zapier,Harvey Spector,Credit Card - Ramp,29.99,20092413.55
02/16/2022,Expense,Gumroad,Harvey Spector,Credit Card - Ramp,6.99,20092420.54
02/16/2022,Expense,Zapier,,Tools & Subscription - G&A,29.99,20092450.53
02/16/2022,Expense,Kula,Harvey Spector,Credit Card - Ramp,3000,20095450.53
02/16/2022,Expense,Zapier,Harvey Spector,Credit Card - Ramp,29.99,20095480.52
02/16/2022,Expense,Kula,Harvey Spector,Credit Card - Ramp,3000,20098480.52
02/16/2022,Expense,Gumroad,Harvey Spector,Credit Card - Ramp,6.99,20098487.51
02/17/2022,Credit Card Credit,Glimpse,Harvey Spector,Tools & Subscription,-29,20098458.51
02/17/2022,Credit Card Credit,Glimpse,Harvey Spector,Credit Card - Ramp,-29,20098429.51
02/17/2022,Credit Card Credit,Glimpse,Harvey Spector,Credit Card - Ramp,-29,20098400.51
02/17/2022,Credit Card Credit,Glimpse,Harvey Spector,Tools & Subscription,-29,20098371.51
02/17/2022,Credit Card Credit,Glimpse,Harvey Spector,Tools & Subscription,-29,20098342.51
02/17/2022,Credit Card Credit,Glimpse,Harvey Spector,Credit Card - Ramp,-29,20098313.51
02/17/2022,Credit Card Credit,Glimpse,Harvey Spector,Credit Card - Ramp,-29,20098284.51
02/17/2022,Credit Card Credit,Glimpse,Harvey Spector,Tools & Subscription,-29,20098255.51
02/17/2022,Credit Card Credit,Glimpse,Harvey Spector,Tools & Subscription,-29,20098226.51
02/17/2022,Credit Card Credit,Glimpse,Harvey Spector,Credit Card - Ramp,-29,20098197.51
02/17/2022,Credit Card Credit,Glimpse,Harvey Spector,Tools & Subscription,-29,20098168.51
02/17/2022,Credit Card Credit,Glimpse,Harvey Spector,Tools & Subscription,-29,20098139.51
02/17/2022,Credit Card Credit,Glimpse,Harvey Spector,Tools & Subscription,-29,20098110.51
02/17/2022,Credit Card Credit,Glimpse,Harvey Spector,Credit Card - Ramp,-29,20098081.51
02/18/2022,Expense,Superhuman,Harvey Spector,Credit Card - Ramp,30,20098111.51
02/18/2022,Expense,Superhuman,,Professional Service Charges,30,20098141.51
02/18/2022,Expense,Superhuman,,Professional Service Charges,30,20098171.51
02/18/2022,Expense,Superhuman,,Professional Service Charges,30,20098201.51
02/18/2022,Expense,Superhuman,Harvey Spector,Credit Card - Ramp,30,20098231.51
02/18/2022,Expense,Superhuman,,Professional Service Charges,30,20098261.51
02/18/2022,Expense,Superhuman,Harvey Spector,Credit Card - Ramp,30,20098291.51
02/18/2022,Expense,Superhuman,Harvey Spector,Credit Card - Ramp,30,20098321.51
02/22/2022,Expense,Automate,Balapavan Tirumani,Credit Card - Ramp,29,20098350.51
02/22/2022,Expense,Dovetail,,Tools & Subscription - G&A,30,20098380.51
02/22/2022,Expense,Automate,,Tools & Subscription - G&A,29,20098409.51
02/22/2022,Expense,Dovetail,Harvey Spector,Credit Card - Ramp,30,20098439.51
02/22/2022,Expense,Dovetail,Harvey Spector,Credit Card - Ramp,30,20098469.51
02/22/2022,Expense,Automate,Balapavan Tirumani,Credit Card - Ramp,29,20098498.51
02/22/2022,Expense,Dovetail,,Tools & Subscription - G&A,30,20098528.51
02/22/2022,Expense,Automate,,Tools & Subscription - G&A,29,20098557.51
02/22/2022,Expense,Automate,Balapavan Tirumani,Credit Card - Ramp,29,20098586.51
02/22/2022,Expense,Dovetail,,Tools & Subscription - G&A,30,20098616.51
02/22/2022,Expense,Automate,,Tools & Subscription - G&A,29,20098645.51
02/22/2022,Expense,Dovetail,,Tools & Subscription - G&A,30,20098675.51
02/22/2022,Expense,Automate,,Tools & Subscription - G&A,29,20098704.51
02/22/2022,Expense,Dovetail,Harvey Spector,Credit Card - Ramp,30,20098734.51
02/23/2022,Expense,The New York Times,,General business expenses:Memberships & subscriptions,1.45,20098735.96
02/23/2022,Expense,Superhuman,,Professional Service Charges,30,20098765.96
02/23/2022,Credit Card Payment,,RAMP BUSINESS CO,Account1,-4164.53,20094601.43
02/23/2022,Expense,Super,,Tools & Subscription - G&A,12,20094613.43
02/23/2022,Expense,Super,,Tools & Subscription - G&A,12,20094625.43
02/23/2022,Expense,Superhuman,,Professional Service Charges,30,20094655.43
02/23/2022,Expense,The New York Times,,General business expenses:Memberships & subscriptions,1.45,20094656.88
02/23/2022,Expense,Super,Harvey Spector,Credit Card - Ramp,12,20094668.88
02/23/2022,Credit Card Payment,,RAMP BUSINESS CO,Credit Card - Ramp,-4164.53,20090504.35
02/23/2022,Expense,Superhuman,,Professional Service Charges,30,20090534.35
02/23/2022,Expense,The New York Times,Mike ross,Credit Card - Ramp,1.45,20090535.8
02/23/2022,Credit Card Payment,,RAMP BUSINESS CO,Account1,-4164.53,20086371.27
02/23/2022,Expense,Super,Harvey Spector,Credit Card - Ramp,12,20086383.27
02/23/2022,Credit Card Payment,,RAMP BUSINESS CO,Account1,-4164.53,20082218.74
02/23/2022,Expense,Superhuman,Mike ross,Credit Card - Ramp,30,20082248.74
02/23/2022,Expense,The New York Times,Mike ross,Credit Card - Ramp,1.45,20082250.19
02/23/2022,Expense,Superhuman,Mike ross,Credit Card - Ramp,30,20082280.19
02/23/2022,Expense,The New York Times,Mike ross,Credit Card - Ramp,1.45,20082281.64
02/23/2022,Expense,The New York Times,,General business expenses:Memberships & subscriptions,1.45,20082283.09
02/23/2022,Credit Card Payment,,RAMP BUSINESS CO,Credit Card - Ramp,-4164.53,20078118.56
02/23/2022,Credit Card Payment,,RAMP BUSINESS CO,Credit Card - Ramp,-4164.53,20073954.03
02/23/2022,Expense,Super,Harvey Spector,Credit Card - Ramp,12,20073966.03
02/23/2022,Expense,Super,,Tools & Subscription - G&A,12,20073978.03
02/23/2022,Credit Card Payment,,RAMP BUSINESS CO,Account1,-4164.53,20069813.5
02/23/2022,Expense,Superhuman,,Professional Service Charges,30,20069843.5
02/23/2022,Expense,The New York Times,,General business expenses:Memberships & subscriptions,1.45,20069844.95
02/23/2022,Expense,Super,,Tools & Subscription - G&A,12,20069856.95
02/23/2022,Credit Card Payment,,RAMP BUSINESS CO,Credit Card - Ramp,-4164.53,20065692.42
02/23/2022,Expense,The New York Times,Mike ross,Credit Card - Ramp,1.45,20065693.87
02/23/2022,Expense,Superhuman,Mike ross,Credit Card - Ramp,30,20065723.87
02/23/2022,Expense,Superhuman,Mike ross,Credit Card - Ramp,30,20065753.87
02/24/2022,Expense,Hypefury,,Tools & Subscription - G&A,95,20065848.87
02/24/2022,Expense,Hypefury,Harvey Spector,Credit Card - Ramp,95,20065943.87
02/24/2022,Expense,Hypefury,,Tools & Subscription - G&A,95,20066038.87
02/24/2022,Expense,Hypefury,Harvey Spector,Credit Card - Ramp,95,20066133.87
02/24/2022,Expense,Hypefury,,Tools & Subscription - G&A,95,20066228.87
02/24/2022,Expense,Hypefury,,Tools & Subscription - G&A,95,20066323.87
02/24/2022,Expense,Hypefury,Harvey Spector,Credit Card - Ramp,95,20066418.87
02/25/2022,Expense,Miro,,Tools & Subscription - G&A,90,20066508.87
02/25/2022,Expense,Big Company ,Big Company ,Account1,-26000,20040508.87
02/25/2022,Expense,Big Company ,Big Company ,Account1,-26000,20014508.87
02/25/2022,Expense,Miro,,Tools & Subscription - G&A,90,20014598.87
02/25/2022,Expense,Miro,,Tools & Subscription - G&A,90,20014688.87
02/25/2022,Expense,Big Company ,Big Company ,Accounts Payable (A/P),-26000,19988688.87
02/25/2022,Expense,Big Company ,Big Company ,Accounts Payable (A/P),-26000,19962688.87
02/25/2022,Expense,Miro,,Tools & Subscription - G&A,90,19962778.87
02/25/2022,Expense,Big Company ,Big Company ,Accounts Payable (A/P),-26000,19936778.87
02/25/2022,Expense,Big Company ,Big Company ,Account1,-26000,19910778.87
02/25/2022,Expense,Big Company ,Big Company ,Accounts Payable (A/P),-26000,19884778.87
02/25/2022,Expense,Big Company ,Big Company ,Account1,-26000,19858778.87
02/25/2022,Expense,Miro,Mike ross,Credit Card - Ramp,90,19858868.87
02/25/2022,Expense,Miro,Mike ross,Credit Card - Ramp,90,19858958.87
02/25/2022,Expense,Miro,Mike ross,Credit Card - Ramp,90,19859048.87
02/27/2022,Expense,Splitbee,Harris Jose,Credit Card - Ramp,16.52,19859065.39
02/27/2022,Expense,Splitbee,,Tools & Subscription - G&A,16.52,19859081.91
02/27/2022,Expense,Sendinblue,,Tools & Subscription - G&A,51.82,19859133.73
02/27/2022,Expense,Sendinblue,,Tools & Subscription - G&A,51.82,19859185.55
02/27/2022,Expense,Sendinblue,Balapavan Tirumani,Credit Card - Ramp,51.82,19859237.37
02/27/2022,Expense,Sendinblue,Balapavan Tirumani,Credit Card - Ramp,51.82,19859289.19
02/27/2022,Expense,Splitbee,Harris Jose,Credit Card - Ramp,16.52,19859305.71
02/27/2022,Expense,Splitbee,,Tools & Subscription - G&A,16.52,19859322.23
02/27/2022,Expense,Splitbee,,Tools & Subscription - G&A,16.52,19859338.75
02/27/2022,Expense,Splitbee,,Tools & Subscription - G&A,16.52,19859355.27
02/27/2022,Expense,Sendinblue,,Tools & Subscription - G&A,51.82,19859407.09
02/27/2022,Expense,Sendinblue,Balapavan Tirumani,Credit Card - Ramp,51.82,19859458.91
02/27/2022,Expense,Splitbee,Harris Jose,Credit Card - Ramp,16.52,19859475.43
02/27/2022,Expense,Sendinblue,,Tools & Subscription - G&A,51.82,19859527.25
02/28/2022,Expense,Adobe,Mike ross,Credit Card - Ramp,15.98,19859543.23
02/28/2022,Bill,Big Company ,,Outsources Services - India,18988,19878531.23
02/28/2022,Bill,Big Company ,,Outsources Services - India,18988,19897519.23
02/28/2022,Bill,Big Company ,"Service Expenses for the month of February 2022 
INR 1429589 @ 75.29",Accounts Payable (A/P),18988,19916507.23
02/28/2022,Expense,Adobe,,Tools & Subscription - S&M,15.98,19916523.21
02/28/2022,Bill,Big Company ,"Service Expenses for the month of February 2022 
INR 1429589 @ 75.29",Accounts Payable (A/P),18988,19935511.21
02/28/2022,Expense,Adobe,,Tools & Subscription - S&M,15.98,19935527.19
02/28/2022,Expense,Adobe,,Tools & Subscription - S&M,15.98,19935543.17
02/28/2022,Bill,Big Company ,,Outsources Services - India,18988,19954531.17
02/28/2022,Bill,Big Company ,"Service Expenses for the month of February 2022 
INR 1429589 @ 75.29",Accounts Payable (A/P),18988,19973519.17
02/28/2022,Expense,Adobe,Mike ross,Credit Card - Ramp,15.98,19973535.15
02/28/2022,Bill,Big Company ,,Outsources Services - India,18988,19992523.15
02/28/2022,Expense,Adobe,Mike ross,Credit Card - Ramp,15.98,19992539.13
02/28/2022,Bill,Big Company ,"Service Expenses for the month of February 2022 
INR 1429589 @ 75.29",Accounts Payable (A/P),18988,20011527.13
02/28/2022,Expense,Adobe,,Tools & Subscription - S&M,15.98,20011543.11
03/01/2022,Expense,Delaware Corp & Tax We,Harvey Spector,Credit Card - Ramp,785.34,20012328.45
03/01/2022,Expense,Calendly,,Tools & Subscription - G&A,40,20012368.45
03/01/2022,Expense,Delaware Corp & Tax We,,Legal & accounting services,785.34,20013153.79
03/01/2022,Expense,Delaware Corp & Tax We,Harvey Spector,Credit Card - Ramp,785.34,20013939.13
03/01/2022,Expense,Calendly,,Tools & Subscription - G&A,40,20013979.13
03/01/2022,Expense,Calendly,Harvey Spector,Credit Card - Ramp,40,20014019.13
03/01/2022,Expense,Delaware Corp & Tax We,,Legal & accounting services,785.34,20014804.47
03/01/2022,Expense,Delaware Corp & Tax We,Harvey Spector,Credit Card - Ramp,785.34,20015589.81
03/01/2022,Expense,Calendly,Harvey Spector,Credit Card - Ramp,40,20015629.81
03/01/2022,Expense,Delaware Corp & Tax We,Harvey Spector,Credit Card - Ramp,785.34,20016415.15
03/01/2022,Expense,Delaware Corp & Tax We,,Legal & accounting services,785.34,20017200.49
03/01/2022,Expense,Calendly,,Tools & Subscription - G&A,40,20017240.49
03/01/2022,Expense,Delaware Corp & Tax We,,Legal & accounting services,785.34,20018025.83
03/01/2022,Expense,Calendly,,Tools & Subscription - G&A,40,20018065.83
03/01/2022,Expense,Calendly,Harvey Spector,Credit Card - Ramp,40,20018105.83
03/02/2022,Deposit,,Interest Accrual,Savings (6977),1.29,20018107.12
03/02/2022,Deposit,,Interest Accrual,Interest Received,1.29,20018108.41
03/02/2022,Deposit,,Interest Accrual,Interest Received,1.29,20018109.7
03/02/2022,Deposit,,Interest Accrual,Interest Received,1.29,20018110.99
03/02/2022,Deposit,,Interest Accrual,Savings (6977),1.29,20018112.28
03/02/2022,Deposit,,Interest Accrual,Interest Received,1.29,20018113.57
03/02/2022,Deposit,,Interest Accrual,Savings (6977),1.29,20018114.86
03/03/2022,Expense,Google G Suite,Mike ross,Credit Card - Ramp,85.39,20018200.25
03/03/2022,Expense,Google G Suite,Mike ross,Credit Card - Ramp,85.39,20018285.64
03/03/2022,Expense,Mazurek Co,Harvey Spector,Credit Card - Ramp,29.95,20018315.59
03/03/2022,Expense,Google G Suite,Mike ross,Credit Card - Ramp,85.39,20018400.98
03/03/2022,Expense,Mazurek Co,,Tools & Subscription - G&A,29.95,20018430.93
03/03/2022,Expense,Mazurek Co,,Tools & Subscription - G&A,29.95,20018460.88
03/03/2022,Expense,Mazurek Co,Harvey Spector,Credit Card - Ramp,29.95,20018490.83
03/03/2022,Expense,Google G Suite,,Tools & Subscription - G&A,85.39,20018576.22
03/03/2022,Expense,Google G Suite,,Tools & Subscription - G&A,85.39,20018661.61
03/03/2022,Expense,Mazurek Co,,Tools & Subscription - G&A,29.95,20018691.56
03/03/2022,Expense,Mazurek Co,,Tools & Subscription - G&A,29.95,20018721.51
03/03/2022,Expense,Google G Suite,,Tools & Subscription - G&A,85.39,20018806.9
03/03/2022,Expense,Mazurek Co,Harvey Spector,Credit Card - Ramp,29.95,20018836.85
03/03/2022,Expense,Google G Suite,,Tools & Subscription - G&A,85.39,20018922.24
03/07/2022,Expense,Mailchimp,Mike ross,Credit Card - Ramp,20.19,20018942.43
03/07/2022,Expense,Mailchimp,,Tools & Subscription - G&A,20.19,20018962.62
03/07/2022,Expense,Mailchimp,Mike ross,Credit Card - Ramp,20.19,20018982.81
03/07/2022,Expense,Cgi Federal,Mike ross,Tools & Subscription,165.38,20019148.19
03/07/2022,Expense,Cgi Federal,Mike ross,Credit Card - Ramp,165.38,20019313.57
03/07/2022,Expense,Mailchimp,,Tools & Subscription - G&A,20.19,20019333.76
03/07/2022,Expense,Cgi Federal,Mike ross,Tools & Subscription,165.38,20019499.14
03/07/2022,Expense,Cgi Federal,Mike ross,Credit Card - Ramp,165.38,20019664.52
03/07/2022,Expense,Mailchimp,,Tools & Subscription - G&A,20.19,20019684.71
03/07/2022,Expense,Cgi Federal,Mike ross,Tools & Subscription,165.38,20019850.09
03/07/2022,Expense,Mailchimp,,Tools & Subscription - G&A,20.19,20019870.28
03/07/2022,Expense,Cgi Federal,Mike ross,Tools & Subscription,165.38,20020035.66
03/07/2022,Expense,Cgi Federal,Mike ross,Credit Card - Ramp,165.38,20020201.04
03/07/2022,Expense,Mailchimp,Mike ross,Credit Card - Ramp,20.19,20020221.23
03/08/2022,Expense,Big Company ,Big Company ,Account1,-75000,19945221.23
03/08/2022,Expense,Big Company ,Big Company ,Accounts Payable (A/P),-75000,19870221.23
03/08/2022,Expense,Big Company ,Big Company ,Account1,-75000,19795221.23
03/08/2022,Expense,Big Company ,Big Company ,Account1,-75000,19720221.23
03/08/2022,Expense,Big Company ,Big Company ,Account1,-75000,19645221.23
03/08/2022,Expense,Big Company ,Big Company ,Accounts Payable (A/P),-75000,19570221.23
03/08/2022,Expense,Big Company ,Big Company ,Accounts Payable (A/P),-75000,19495221.23
03/08/2022,Expense,Big Company ,Big Company ,Accounts Payable (A/P),-75000,19420221.23
03/09/2022,Expense,Usersnap,,Tools & Subscription - G&A,19,19420240.23
03/09/2022,Expense,Lemon Squeezy,Chris George,Credit Card - Ramp,99,19420339.23
03/09/2022,Expense,Streamline Trial Over,Chris George,Credit Card - Ramp,182.4,19420521.63
03/09/2022,Expense,Heroku,Balapavan Tirumani,Credit Card - Ramp,14,19420535.63
03/09/2022,Expense,Usersnap,,Tools & Subscription - G&A,19,19420554.63
03/09/2022,Expense,Heroku,Balapavan Tirumani,Tools & Subscription - S&M,14,19420568.63
03/09/2022,Expense,Streamline Trial Over,Chris George,Tools & Subscription,182.4,19420751.03
03/09/2022,Expense,Heroku,Balapavan Tirumani,Credit Card - Ramp,14,19420765.03
03/09/2022,Expense,Usersnap,Harris Jose,Credit Card - Ramp,19,19420784.03
03/09/2022,Expense,Lemon Squeezy,,Tools & Subscription - G&A,99,19420883.03
03/09/2022,Expense,Streamline Trial Over,Chris George,Credit Card - Ramp,182.4,19421065.43
03/09/2022,Expense,Usersnap,Harris Jose,Credit Card - Ramp,19,19421084.43
03/09/2022,Expense,Lemon Squeezy,,Tools & Subscription - G&A,99,19421183.43
03/09/2022,Expense,Streamline Trial Over,Chris George,Tools & Subscription,182.4,19421365.83
03/09/2022,Expense,Lemon Squeezy,,Tools & Subscription - G&A,99,19421464.83
03/09/2022,Expense,Usersnap,,Tools & Subscription - G&A,19,19421483.83
03/09/2022,Expense,Lemon Squeezy,Chris George,Credit Card - Ramp,99,19421582.83
03/09/2022,Expense,Heroku,Balapavan Tirumani,Tools & Subscription - S&M,14,19421596.83
03/09/2022,Expense,Streamline Trial Over,Chris George,Credit Card - Ramp,182.4,19421779.23
03/09/2022,Expense,Usersnap,Harris Jose,Credit Card - Ramp,19,19421798.23
03/09/2022,Expense,Heroku,Balapavan Tirumani,Tools & Subscription - S&M,14,19421812.23
03/09/2022,Expense,Streamline Trial Over,Chris George,Tools & Subscription,182.4,19421994.63
03/09/2022,Expense,Heroku,Balapavan Tirumani,Tools & Subscription - S&M,14,19422008.63
03/09/2022,Expense,Heroku,Balapavan Tirumani,Credit Card - Ramp,14,19422022.63
03/09/2022,Expense,Streamline Trial Over,Chris George,Tools & Subscription,182.4,19422205.03
03/09/2022,Expense,Lemon Squeezy,Chris George,Credit Card - Ramp,99,19422304.03
03/09/2022,Expense,Lemon Squeezy,,Tools & Subscription - G&A,99,19422403.03
03/09/2022,Expense,Usersnap,,Tools & Subscription - G&A,19,19422422.03
03/10/2022,Expense,Pause Cafe,Harvey Spector,Credit Card - Ramp,8,19422430.03
03/10/2022,Expense,Pause Cafe,Harvey Spector,Credit Card - Ramp,8,19422438.03
03/10/2022,Expense,Pause Cafe,Harvey Spector,Meals & Entertainment,8,19422446.03
03/10/2022,Expense,Pause Cafe,Harvey Spector,Meals & Entertainment,8,19422454.03
03/10/2022,Expense,Pause Cafe,Harvey Spector,Credit Card - Ramp,8,19422462.03
03/10/2022,Expense,Pause Cafe,Harvey Spector,Meals & Entertainment,8,19422470.03
03/10/2022,Expense,Pause Cafe,Harvey Spector,Credit Card - Ramp,8,19422478.03
03/10/2022,Expense,Pause Cafe,Harvey Spector,Meals & Entertainment,8,19422486.03
03/12/2022,Expense,Intuit India,Harvey Spector,Credit Card - Ramp,16.39,19422502.42
03/12/2022,Expense,Intuit India,,Tools & Subscription - G&A,16.39,19422518.81
03/12/2022,Expense,Intuit India,,Tools & Subscription - G&A,16.39,19422535.2
03/12/2022,Expense,Intuit India,,Tools & Subscription - G&A,16.39,19422551.59
03/12/2022,Expense,Intuit India,Harvey Spector,Credit Card - Ramp,16.39,19422567.98
03/12/2022,Expense,Intuit India,Harvey Spector,Credit Card - Ramp,16.39,19422584.37
03/12/2022,Expense,Intuit India,,Tools & Subscription - G&A,16.39,19422600.76
03/13/2022,Expense,Figma,,Tools & Subscription - G&A,75,19422675.76
03/13/2022,Expense,Figma,Mike ross,Credit Card - Ramp,75,19422750.76
03/13/2022,Expense,Figma,Mike ross,Credit Card - Ramp,75,19422825.76
03/13/2022,Expense,Figma,,Tools & Subscription - G&A,75,19422900.76
03/13/2022,Expense,Figma,,Tools & Subscription - G&A,75,19422975.76
03/13/2022,Expense,Figma,,Tools & Subscription - G&A,75,19423050.76
03/13/2022,Expense,Figma,Mike ross,Credit Card - Ramp,75,19423125.76
03/14/2022,Expense,LinkedIn,Harvey Spector,Credit Card - Ramp,94.37,19423220.13
03/14/2022,Expense,Intuit,,Tools & Subscription - G&A,50,19423270.13
03/14/2022,Expense,LinkedIn,Harvey Spector,Credit Card - Ramp,94.37,19423364.5
03/14/2022,Expense,Intuit,Harvey Spector,Credit Card - Ramp,50,19423414.5
03/14/2022,Expense,LinkedIn,,Tools & Subscription - G&A,94.37,19423508.87
03/14/2022,Expense,LinkedIn,,Tools & Subscription - G&A,94.37,19423603.24
03/14/2022,Expense,LinkedIn,Harvey Spector,Credit Card - Ramp,94.37,19423697.61
03/14/2022,Expense,LinkedIn,,Tools & Subscription - G&A,94.37,19423791.98
03/14/2022,Expense,Intuit,,Tools & Subscription - G&A,50,19423841.98
03/14/2022,Expense,Intuit,,Tools & Subscription - G&A,50,19423891.98
03/14/2022,Expense,Intuit,Harvey Spector,Credit Card - Ramp,50,19423941.98
03/14/2022,Expense,Intuit,Harvey Spector,Credit Card - Ramp,50,19423991.98
03/14/2022,Expense,LinkedIn,,Tools & Subscription - G&A,94.37,19424086.35
03/14/2022,Expense,Intuit,,Tools & Subscription - G&A,50,19424136.35
03/16/2022,Expense,Zapier,,Tools & Subscription - G&A,29.99,19424166.34
03/16/2022,Expense,Zapier,,Tools & Subscription - G&A,29.99,19424196.33
03/16/2022,Expense,Zapier,,Tools & Subscription - G&A,29.99,19424226.32
03/16/2022,Expense,Zapier,,Tools & Subscription - G&A,29.99,19424256.31
03/16/2022,Expense,Zapier,Harvey Spector,Credit Card - Ramp,29.99,19424286.3
03/16/2022,Expense,Zapier,Harvey Spector,Credit Card - Ramp,29.99,19424316.29
03/16/2022,Expense,Zapier,Harvey Spector,Credit Card - Ramp,29.99,19424346.28
03/17/2022,Expense,Loom,,Tools & Subscription - G&A,192,19424538.28
03/17/2022,Expense,Loom,,Tools & Subscription - G&A,192,19424730.28
03/17/2022,Expense,Loom,Mike ross,Credit Card - Ramp,192,19424922.28
03/17/2022,Expense,Loom,Mike ross,Credit Card - Ramp,192,19425114.28
03/17/2022,Expense,Loom,,Tools & Subscription - G&A,192,19425306.28
03/17/2022,Expense,Loom,Mike ross,Credit Card - Ramp,192,19425498.28
03/17/2022,Expense,Loom,,Tools & Subscription - G&A,192,19425690.28
03/18/2022,Expense,Superhuman,Harvey Spector,Credit Card - Ramp,30,19425720.28
03/18/2022,Expense,Superhuman,Harvey Spector,Credit Card - Ramp,30,19425750.28
03/18/2022,Expense,Superhuman,,Professional Service Charges,30,19425780.28
03/18/2022,Expense,Superhuman,Harvey Spector,Credit Card - Ramp,30,19425810.28
03/18/2022,Expense,Superhuman,,Professional Service Charges,30,19425840.28
03/18/2022,Expense,Superhuman,,Professional Service Charges,30,19425870.28
03/18/2022,Expense,Superhuman,Harvey Spector,Credit Card - Ramp,30,19425900.28
03/18/2022,Expense,Superhuman,,Professional Service Charges,30,19425930.28
03/20/2022,Expense,The New York Times,Mike ross,Credit Card - Ramp,1.48,19425931.76
03/20/2022,Expense,The New York Times,,General business expenses:Memberships & subscriptions,1.48,19425933.24
03/20/2022,Expense,The New York Times,,General business expenses:Memberships & subscriptions,1.48,19425934.72
03/20/2022,Expense,The New York Times,Mike ross,Credit Card - Ramp,1.48,19425936.2
03/20/2022,Expense,The New York Times,Mike ross,Credit Card - Ramp,1.48,19425937.68
03/20/2022,Expense,The New York Times,Mike ross,Credit Card - Ramp,1.48,19425939.16
03/20/2022,Expense,The New York Times,,General business expenses:Memberships & subscriptions,1.48,19425940.64
03/20/2022,Expense,The New York Times,,General business expenses:Memberships & subscriptions,1.48,19425942.12
03/22/2022,Expense,Dovetail,Harvey Spector,Credit Card - Ramp,30,19425972.12
03/22/2022,Expense,Automate,Balapavan Tirumani,Credit Card - Ramp,29,19426001.12
03/22/2022,Credit Card Payment,,RAMP BUSINESS CO,Credit Card - Ramp,-2246.35,19423754.77
03/22/2022,Expense,Dovetail,,Tools & Subscription - G&A,30,19423784.77
03/22/2022,Credit Card Payment,,RAMP BUSINESS CO,Account1,-2246.35,19421538.42
03/22/2022,Expense,Automate,,Tools & Subscription - G&A,29,19421567.42
03/22/2022,Credit Card Payment,,RAMP BUSINESS CO,Account1,-2246.35,19419321.07
03/22/2022,Expense,Dovetail,,Tools & Subscription - G&A,30,19419351.07
03/22/2022,Credit Card Payment,,RAMP BUSINESS CO,Credit Card - Ramp,-2246.35,19417104.72
03/22/2022,Expense,Dovetail,,Tools & Subscription - G&A,30,19417134.72
03/22/2022,Expense,Automate,,Tools & Subscription - G&A,29,19417163.72
03/22/2022,Expense,Automate,Balapavan Tirumani,Credit Card - Ramp,29,19417192.72
03/22/2022,Credit Card Payment,,RAMP BUSINESS CO,Credit Card - Ramp,-2246.35,19414946.37
03/22/2022,Expense,Dovetail,Harvey Spector,Credit Card - Ramp,30,19414976.37
03/22/2022,Expense,Automate,Balapavan Tirumani,Credit Card - Ramp,29,19415005.37
03/22/2022,Expense,Automate,,Tools & Subscription - G&A,29,19415034.37
03/22/2022,Credit Card Payment,,RAMP BUSINESS CO,Credit Card - Ramp,-2246.35,19412788.02
03/22/2022,Credit Card Payment,,RAMP BUSINESS CO,Account1,-2246.35,19410541.67
03/22/2022,Expense,Automate,,Tools & Subscription - G&A,29,19410570.67
03/22/2022,Expense,Dovetail,,Tools & Subscription - G&A,30,19410600.67
03/22/2022,Expense,Dovetail,Harvey Spector,Credit Card - Ramp,30,19410630.67
03/22/2022,Credit Card Payment,,RAMP BUSINESS CO,Account1,-2246.35,19408384.32
03/23/2022,Expense,Super,,Tools & Subscription - G&A,12,19408396.32
03/23/2022,Expense,Super,Harvey Spector,Credit Card - Ramp,12,19408408.32
03/23/2022,Expense,Superhuman,Mike ross,Credit Card - Ramp,30,19408438.32
03/23/2022,Expense,Lounge Lovers,Chris George,Office expenses,747.4,19409185.72
03/23/2022,Expense,Lounge Lovers,Chris George,Office expenses,246.64,19409432.36
03/23/2022,Expense,Superhuman,,Professional Service Charges,30,19409462.36
03/23/2022,Expense,Lounge Lovers,Chris George,Office expenses,246.64,19409709
03/23/2022,Expense,Super,,Tools & Subscription - G&A,12,19409721
03/23/2022,Expense,Superhuman,,Professional Service Charges,30,19409751
03/23/2022,Expense,Lounge Lovers,Chris George,Office expenses,747.4,19410498.4
03/23/2022,Expense,Super,,Tools & Subscription - G&A,12,19410510.4
03/23/2022,Expense,Lounge Lovers,Chris George,Credit Card - Ramp,747.4,19411257.8
03/23/2022,Expense,Lounge Lovers,Chris George,Office expenses,246.64,19411504.44
03/23/2022,Expense,Lounge Lovers,Chris George,Office expenses,747.4,19412251.84
03/23/2022,Expense,Superhuman,,Professional Service Charges,30,19412281.84
03/23/2022,Expense,Superhuman,,Professional Service Charges,30,19412311.84
03/23/2022,Expense,Super,,Tools & Subscription - G&A,12,19412323.84
03/23/2022,Expense,Super,Harvey Spector,Credit Card - Ramp,12,19412335.84
03/23/2022,Expense,Lounge Lovers,Chris George,Credit Card - Ramp,747.4,19413083.24
03/23/2022,Expense,Lounge Lovers,Chris George,Credit Card - Ramp,246.64,19413329.88
03/23/2022,Expense,Superhuman,Mike ross,Credit Card - Ramp,30,19413359.88
03/23/2022,Expense,Lounge Lovers,Chris George,Credit Card - Ramp,747.4,19414107.28
03/23/2022,Expense,Lounge Lovers,Chris George,Credit Card - Ramp,246.64,19414353.92
03/23/2022,Expense,Lounge Lovers,Chris George,Office expenses,747.4,19415101.32
03/23/2022,Expense,Lounge Lovers,Chris George,Credit Card - Ramp,747.4,19415848.72
03/23/2022,Expense,Superhuman,Mike ross,Credit Card - Ramp,30,19415878.72
03/23/2022,Expense,Lounge Lovers,Chris George,Credit Card - Ramp,246.64,19416125.36
03/23/2022,Expense,Superhuman,Mike ross,Credit Card - Ramp,30,19416155.36
03/23/2022,Expense,Super,Harvey Spector,Credit Card - Ramp,12,19416167.36
03/23/2022,Expense,Lounge Lovers,Chris George,Office expenses,246.64,19416414
03/23/2022,Expense,Lounge Lovers,Chris George,Credit Card - Ramp,246.64,19416660.64
03/25/2022,Expense,Miro,,Tools & Subscription - G&A,90,19416750.64
03/25/2022,Expense,Miro,,Tools & Subscription - G&A,90,19416840.64
03/25/2022,Expense,Miro,,Tools & Subscription - G&A,90,19416930.64
03/25/2022,Expense,Miro,Mike ross,Credit Card - Ramp,90,19417020.64
03/25/2022,Expense,Miro,Mike ross,Credit Card - Ramp,90,19417110.64
03/25/2022,Expense,Miro,,Tools & Subscription - G&A,90,19417200.64
03/25/2022,Expense,Miro,Mike ross,Credit Card - Ramp,90,19417290.64
03/27/2022,Expense,Sendinblue,Balapavan Tirumani,Credit Card - Ramp,51.18,19417341.82
03/27/2022,Expense,Sendinblue,,Tools & Subscription - G&A,51.18,19417393
03/27/2022,Expense,Splitbee,,Tools & Subscription - G&A,16.52,19417409.52
03/27/2022,Expense,Sendinblue,Balapavan Tirumani,Credit Card - Ramp,51.18,19417460.7
03/27/2022,Expense,Sendinblue,,Tools & Subscription - G&A,51.18,19417511.88
03/27/2022,Expense,Splitbee,Harris Jose,Credit Card - Ramp,16.52,19417528.4
03/27/2022,Expense,Splitbee,Harris Jose,Credit Card - Ramp,16.52,19417544.92
03/27/2022,Expense,Splitbee,,Tools & Subscription - G&A,16.52,19417561.44
03/27/2022,Expense,Sendinblue,Balapavan Tirumani,Credit Card - Ramp,51.18,19417612.62
03/27/2022,Expense,Sendinblue,,Tools & Subscription - G&A,51.18,19417663.8
03/27/2022,Expense,Splitbee,,Tools & Subscription - G&A,16.52,19417680.32
03/27/2022,Expense,Splitbee,,Tools & Subscription - G&A,16.52,19417696.84
03/27/2022,Expense,Splitbee,Harris Jose,Credit Card - Ramp,16.52,19417713.36
03/27/2022,Expense,Sendinblue,,Tools & Subscription - G&A,51.18,19417764.54
03/31/2022,Bill,Big Company ,,Outsources Services - India,27336,19445100.54
03/31/2022,Expense,Adobe,,Tools & Subscription - S&M,16.55,19445117.09
03/31/2022,Expense,Adobe,,Tools & Subscription - S&M,16.55,19445133.64
03/31/2022,Bill,Big Company ,,Outsources Services - India,27336,19472469.64
03/31/2022,Bill,Big Company ,"Service Expenses for the month of March 2022 
INR 2075049 @ 75.91",Accounts Payable (A/P),27336,19499805.64
03/31/2022,Expense,Adobe,Mike ross,Credit Card - Ramp,16.55,19499822.19
03/31/2022,Expense,Adobe,Mike ross,Credit Card - Ramp,16.55,19499838.74
03/31/2022,Bill,Big Company ,"Service Expenses for the month of March 2022 
INR 2075049 @ 75.91",Accounts Payable (A/P),27336,19527174.74
03/31/2022,Bill,Big Company ,,Outsources Services - India,27336,19554510.74
03/31/2022,Bill,Big Company ,,Outsources Services - India,27336,19581846.74
03/31/2022,Bill,Big Company ,"Service Expenses for the month of March 2022 
INR 2075049 @ 75.91",Accounts Payable (A/P),27336,19609182.74
03/31/2022,Bill,Big Company ,"Service Expenses for the month of March 2022 
INR 2075049 @ 75.91",Accounts Payable (A/P),27336,19636518.74
03/31/2022,Expense,Adobe,,Tools & Subscription - S&M,16.55,19636535.29
03/31/2022,Expense,Adobe,Mike ross,Credit Card - Ramp,16.55,19636551.84
03/31/2022,Expense,Adobe,,Tools & Subscription - S&M,16.55,19636568.39
04/01/2022,Expense,Google Australia Pty Ltd,Mike ross,Credit Card - Ramp,87.71,19636656.1
04/01/2022,Expense,Calendly,Harvey Spector,Credit Card - Ramp,40,19636696.1
04/01/2022,Expense,Google Australia Pty Ltd,Mike ross,Tools & Subscription - G&A,87.71,19636783.81
04/01/2022,Expense,Google Australia Pty Ltd,Mike ross,Tools & Subscription - G&A,87.71,19636871.52
04/01/2022,Expense,Calendly,,Tools & Subscription - G&A,40,19636911.52
04/01/2022,Expense,Google Australia Pty Ltd,Mike ross,Credit Card - Ramp,87.71,19636999.23
04/01/2022,Expense,Calendly,,Tools & Subscription - G&A,40,19637039.23
04/01/2022,Expense,Calendly,Harvey Spector,Credit Card - Ramp,40,19637079.23
04/01/2022,Expense,Google Australia Pty Ltd,Mike ross,Credit Card - Ramp,87.71,19637166.94
04/01/2022,Expense,Calendly,Harvey Spector,Credit Card - Ramp,40,19637206.94
04/01/2022,Expense,Google Australia Pty Ltd,Mike ross,Tools & Subscription - G&A,87.71,19637294.65
04/01/2022,Expense,Calendly,,Tools & Subscription - G&A,40,19637334.65
04/01/2022,Expense,Calendly,,Tools & Subscription - G&A,40,19637374.65
04/01/2022,Expense,Google Australia Pty Ltd,Mike ross,Tools & Subscription - G&A,87.71,19637462.36
04/02/2022,Deposit,,Interest Accrual,Interest Received,1.49,19637463.85
04/02/2022,Deposit,,Interest Accrual,Interest Received,1.49,19637465.34
04/02/2022,Deposit,,Interest Accrual,Savings (6977),1.49,19637466.83
04/02/2022,Deposit,,Interest Accrual,Savings (6977),1.49,19637468.32
04/02/2022,Deposit,,Interest Accrual,Interest Received,1.49,19637469.81
04/02/2022,Deposit,,Interest Accrual,Savings (6977),1.49,19637471.3
04/02/2022,Deposit,,Interest Accrual,Interest Received,1.49,19637472.79
04/03/2022,Expense,Mazurek Co,Harvey Spector,Credit Card - Ramp,29.95,19637502.74
04/03/2022,Deposit,,Interest Accrual,Interest Received,0.05,19637502.79
04/03/2022,Deposit,,Interest Accrual,Savings (6977),0.05,19637502.84
04/03/2022,Deposit,,Interest Accrual,Interest Received,0.05,19637502.89
04/03/2022,Expense,Mazurek Co,,Tools & Subscription - G&A,29.95,19637532.84
04/03/2022,Expense,Mazurek Co,,Tools & Subscription - G&A,29.95,19637562.79
04/03/2022,Expense,Mazurek Co,,Tools & Subscription - G&A,29.95,19637592.74
04/03/2022,Expense,Mazurek Co,,Tools & Subscription - G&A,29.95,19637622.69
04/03/2022,Expense,Mazurek Co,Harvey Spector,Credit Card - Ramp,29.95,19637652.64
04/03/2022,Deposit,,Interest Accrual,Savings (6977),0.05,19637652.69
04/03/2022,Deposit,,Interest Accrual,Interest Received,0.05,19637652.74
04/03/2022,Deposit,,Interest Accrual,Savings (6977),0.05,19637652.79
04/03/2022,Expense,Mazurek Co,Harvey Spector,Credit Card - Ramp,29.95,19637682.74
04/03/2022,Deposit,,Interest Accrual,Interest Received,0.05,19637682.79
04/07/2022,Expense,Mailchimp,,Tools & Subscription - G&A,20.3,19637703.09
04/07/2022,Expense,Mailchimp,Mike ross,Credit Card - Ramp,20.3,19637723.39
04/07/2022,Expense,Mailchimp,Mike ross,Credit Card - Ramp,20.3,19637743.69
04/07/2022,Expense,Mailchimp,,Tools & Subscription - G&A,20.3,19637763.99
04/07/2022,Expense,Mailchimp,,Tools & Subscription - G&A,20.3,19637784.29
04/07/2022,Expense,Mailchimp,Mike ross,Credit Card - Ramp,20.3,19637804.59
04/07/2022,Expense,Mailchimp,,Tools & Subscription - G&A,20.3,19637824.89
04/09/2022,Expense,Usersnap,,Tools & Subscription - G&A,19,19637843.89
04/09/2022,Expense,Usersnap,,Tools & Subscription - G&A,19,19637862.89
04/09/2022,Expense,Usersnap,Harris Jose,Credit Card - Ramp,19,19637881.89
04/09/2022,Expense,Usersnap,,Tools & Subscription - G&A,19,19637900.89
04/09/2022,Expense,Usersnap,Harris Jose,Credit Card - Ramp,19,19637919.89
04/09/2022,Expense,Usersnap,Harris Jose,Credit Card - Ramp,19,19637938.89
04/09/2022,Expense,Usersnap,,Tools & Subscription - G&A,19,19637957.89
04/10/2022,Expense,Pause Cafe,Harvey Spector,Credit Card - Ramp,7,19637964.89
04/10/2022,Expense,Pause Cafe,Harvey Spector,Meals & Entertainment,7,19637971.89
04/10/2022,Expense,Pause Cafe,Harvey Spector,Meals & Entertainment,7,19637978.89
04/10/2022,Expense,Pause Cafe,Harvey Spector,Credit Card - Ramp,7,19637985.89
04/10/2022,Expense,Pause Cafe,Harvey Spector,Credit Card - Ramp,7,19637992.89
04/10/2022,Expense,Pause Cafe,Harvey Spector,Meals & Entertainment,7,19637999.89
04/10/2022,Expense,Pause Cafe,Harvey Spector,Meals & Entertainment,7,19638006.89
04/10/2022,Expense,Pause Cafe,Harvey Spector,Credit Card - Ramp,7,19638013.89
04/11/2022,Expense,Heroku,Balapavan Tirumani,Credit Card - Ramp,23.64,19638037.53
04/11/2022,Expense,Heroku,Balapavan Tirumani,Credit Card - Ramp,23.64,19638061.17
04/11/2022,Expense,Heroku,Balapavan Tirumani,Tools & Subscription - S&M,23.64,19638084.81
04/11/2022,Expense,Heroku,Balapavan Tirumani,Tools & Subscription - S&M,23.64,19638108.45
04/11/2022,Expense,Heroku,Balapavan Tirumani,Credit Card - Ramp,23.64,19638132.09
04/11/2022,Expense,Heroku,Balapavan Tirumani,Tools & Subscription - S&M,23.64,19638155.73
04/11/2022,Expense,Heroku,Balapavan Tirumani,Tools & Subscription - S&M,23.64,19638179.37
04/12/2022,Expense,Intuit India,,Tools & Subscription - G&A,16.46,19638195.83
04/12/2022,Expense,Intuit India,,Tools & Subscription - G&A,16.46,19638212.29
04/12/2022,Expense,Intuit India,,Tools & Subscription - G&A,16.46,19638228.75
04/12/2022,Expense,Intuit India,,Tools & Subscription - G&A,16.46,19638245.21
04/12/2022,Expense,Intuit India,Harvey Spector,Credit Card - Ramp,16.46,19638261.67
04/12/2022,Expense,Intuit India,Harvey Spector,Credit Card - Ramp,16.46,19638278.13
04/12/2022,Expense,Intuit India,Harvey Spector,Credit Card - Ramp,16.46,19638294.59
04/13/2022,Expense,Figma,Mike ross,Credit Card - Ramp,135,19638429.59
04/13/2022,Expense,Figma,,Tools & Subscription - G&A,135,19638564.59
04/13/2022,Expense,Figma,Mike ross,Credit Card - Ramp,135,19638699.59
04/13/2022,Expense,Figma,,Tools & Subscription - G&A,135,19638834.59
04/13/2022,Expense,Figma,,Tools & Subscription - G&A,135,19638969.59
04/13/2022,Expense,Figma,Mike ross,Credit Card - Ramp,135,19639104.59
04/13/2022,Expense,Figma,,Tools & Subscription - G&A,135,19639239.59
04/14/2022,Expense,Intuit,,Tools & Subscription - G&A,50,19639289.59
04/14/2022,Expense,LinkedIn,,Tools & Subscription - G&A,94.57,19639384.16
04/14/2022,Expense,LinkedIn,Harvey Spector,Credit Card - Ramp,94.57,19639478.73
04/14/2022,Expense,Intuit,Harvey Spector,Credit Card - Ramp,50,19639528.73
04/14/2022,Expense,Intuit,,Tools & Subscription - G&A,50,19639578.73
04/14/2022,Expense,LinkedIn,Harvey Spector,Credit Card - Ramp,94.57,19639673.3
04/14/2022,Expense,LinkedIn,Harvey Spector,Credit Card - Ramp,94.57,19639767.87
04/14/2022,Expense,Intuit,Harvey Spector,Credit Card - Ramp,50,19639817.87
04/14/2022,Expense,Intuit,Harvey Spector,Credit Card - Ramp,50,19639867.87
04/14/2022,Expense,LinkedIn,,Tools & Subscription - G&A,94.57,19639962.44
04/14/2022,Expense,LinkedIn,,Tools & Subscription - G&A,94.57,19640057.01
04/14/2022,Expense,Intuit,,Tools & Subscription - G&A,50,19640107.01
04/14/2022,Expense,Intuit,,Tools & Subscription - G&A,50,19640157.01
04/14/2022,Expense,LinkedIn,,Tools & Subscription - G&A,94.57,19640251.58
04/16/2022,Expense,LinkedIn,Harvey Spector,Credit Card - Ramp,27.41,19640278.99
04/16/2022,Expense,Zapier,Harvey Spector,Credit Card - Ramp,29.99,19640308.98
04/16/2022,Expense,Zapier,Harvey Spector,Credit Card - Ramp,29.99,19640338.97
04/16/2022,Expense,LinkedIn,,Tools & Subscription - G&A,27.41,19640366.38
04/16/2022,Expense,LinkedIn,Harvey Spector,Credit Card - Ramp,27.41,19640393.79
04/16/2022,Expense,Zapier,,Tools & Subscription - G&A,29.99,19640423.78
04/16/2022,Expense,Zapier,,Tools & Subscription - G&A,29.99,19640453.77
04/16/2022,Expense,LinkedIn,,Tools & Subscription - G&A,27.41,19640481.18
04/16/2022,Expense,Zapier,,Tools & Subscription - G&A,29.99,19640511.17
04/16/2022,Expense,Zapier,,Tools & Subscription - G&A,29.99,19640541.16
04/16/2022,Expense,Zapier,Harvey Spector,Credit Card - Ramp,29.99,19640571.15
04/16/2022,Expense,LinkedIn,,Tools & Subscription - G&A,27.41,19640598.56
04/16/2022,Expense,LinkedIn,Harvey Spector,Credit Card - Ramp,27.41,19640625.97
04/16/2022,Expense,LinkedIn,,Tools & Subscription - G&A,27.41,19640653.38
04/17/2022,Expense,The New York Times,,General business expenses:Memberships & subscriptions,1.49,19640654.87
04/17/2022,Expense,The New York Times,Mike ross,Credit Card - Ramp,1.49,19640656.36
04/17/2022,Expense,The New York Times,Mike ross,Credit Card - Ramp,1.49,19640657.85
04/17/2022,Expense,The New York Times,Mike ross,Credit Card - Ramp,1.49,19640659.34
04/17/2022,Expense,The New York Times,,General business expenses:Memberships & subscriptions,1.49,19640660.83
04/17/2022,Expense,The New York Times,,General business expenses:Memberships & subscriptions,1.49,19640662.32
04/17/2022,Expense,The New York Times,Mike ross,Credit Card - Ramp,1.49,19640663.81
04/17/2022,Expense,The New York Times,,General business expenses:Memberships & subscriptions,1.49,19640665.3
04/18/2022,Expense,Superhuman,,Professional Service Charges,30,19640695.3
04/18/2022,Expense,Superhuman,Harvey Spector,Credit Card - Ramp,30,19640725.3
04/18/2022,Expense,Superhuman,Harvey Spector,Credit Card - Ramp,30,19640755.3
04/18/2022,Expense,Superhuman,Harvey Spector,Credit Card - Ramp,30,19640785.3
04/18/2022,Expense,Superhuman,Harvey Spector,Credit Card - Ramp,30,19640815.3
04/18/2022,Expense,Superhuman,,Professional Service Charges,30,19640845.3
04/18/2022,Expense,Superhuman,,Professional Service Charges,30,19640875.3
04/18/2022,Expense,Superhuman,,Professional Service Charges,30,19640905.3
04/20/2022,Expense,Pallet Job Postings,,Tools & Subscription - G&A,750,19641655.3
04/20/2022,Expense,Pallet Job Postings,Harvey Spector,Credit Card - Ramp,750,19642405.3
04/20/2022,Expense,Pallet Job Postings,Harvey Spector,Credit Card - Ramp,750,19643155.3
04/20/2022,Credit Card Payment,,RAMP BUSINESS CO,Credit Card - Ramp,-1961.2,19641194.1
04/20/2022,Credit Card Payment,,RAMP BUSINESS CO,Credit Card - Ramp,-1961.2,19639232.9
04/20/2022,Credit Card Payment,,RAMP BUSINESS CO,Account1,-1961.2,19637271.7
04/20/2022,Expense,Pallet Job Postings,,Tools & Subscription - G&A,750,19638021.7
04/20/2022,Expense,Pallet Job Postings,,Tools & Subscription - G&A,750,19638771.7
04/20/2022,Expense,Pallet Job Postings,Harvey Spector,Credit Card - Ramp,750,19639521.7
04/20/2022,Credit Card Payment,,RAMP BUSINESS CO,Credit Card - Ramp,-1961.2,19637560.5
04/20/2022,Credit Card Payment,,RAMP BUSINESS CO,Account1,-1961.2,19635599.3
04/20/2022,Credit Card Payment,,RAMP BUSINESS CO,Account1,-1961.2,19633638.1
04/20/2022,Expense,Pallet Job Postings,,Tools & Subscription - G&A,750,19634388.1
04/20/2022,Credit Card Payment,,RAMP BUSINESS CO,Account1,-1961.2,19632426.9
04/20/2022,Credit Card Payment,,RAMP BUSINESS CO,Credit Card - Ramp,-1961.2,19630465.7
04/22/2022,Expense,Automate,,Tools & Subscription - G&A,29,19630494.7
04/22/2022,Expense,Dovetail,,Tools & Subscription - G&A,36,19630530.7
04/22/2022,Expense,Automate,Balapavan Tirumani,Credit Card - Ramp,29,19630559.7
04/22/2022,Expense,Automate,,Tools & Subscription - G&A,29,19630588.7
04/22/2022,Expense,Dovetail,,Tools & Subscription - G&A,36,19630624.7
04/22/2022,Expense,Dovetail,Harvey Spector,Credit Card - Ramp,36,19630660.7
04/22/2022,Expense,Dovetail,,Tools & Subscription - G&A,36,19630696.7
04/22/2022,Expense,Dovetail,Harvey Spector,Credit Card - Ramp,36,19630732.7
04/22/2022,Expense,Automate,Balapavan Tirumani,Credit Card - Ramp,29,19630761.7
04/22/2022,Expense,Automate,Balapavan Tirumani,Credit Card - Ramp,29,19630790.7
04/22/2022,Expense,Dovetail,Harvey Spector,Credit Card - Ramp,36,19630826.7
04/22/2022,Expense,Automate,,Tools & Subscription - G&A,29,19630855.7
04/22/2022,Expense,Dovetail,,Tools & Subscription - G&A,36,19630891.7
04/22/2022,Expense,Automate,,Tools & Subscription - G&A,29,19630920.7
04/23/2022,Expense,Superhuman,,Professional Service Charges,30,19630950.7
04/23/2022,Expense,Super,,Tools & Subscription - G&A,12,19630962.7
04/23/2022,Expense,Superhuman,Mike ross,Credit Card - Ramp,30,19630992.7
04/23/2022,Expense,Superhuman,,Professional Service Charges,30,19631022.7
04/23/2022,Expense,Super,Harvey Spector,Credit Card - Ramp,12,19631034.7
04/23/2022,Expense,Superhuman,Mike ross,Credit Card - Ramp,30,19631064.7
04/23/2022,Expense,Super,,Tools & Subscription - G&A,12,19631076.7
04/23/2022,Expense,Superhuman,,Professional Service Charges,30,19631106.7
04/23/2022,Expense,Superhuman,Mike ross,Credit Card - Ramp,30,19631136.7
04/23/2022,Expense,Super,Harvey Spector,Credit Card - Ramp,12,19631148.7
04/23/2022,Expense,Superhuman,Mike ross,Credit Card - Ramp,30,19631178.7
04/23/2022,Expense,Super,,Tools & Subscription - G&A,12,19631190.7
04/23/2022,Expense,Super,Harvey Spector,Credit Card - Ramp,12,19631202.7
04/23/2022,Expense,Super,,Tools & Subscription - G&A,12,19631214.7
04/23/2022,Expense,Superhuman,,Professional Service Charges,30,19631244.7
04/25/2022,Expense,Miro,Mike ross,Credit Card - Ramp,90,19631334.7
04/25/2022,Expense,Miro,,Tools & Subscription - G&A,90,19631424.7
04/25/2022,Expense,Miro,Mike ross,Credit Card - Ramp,90,19631514.7
04/25/2022,Expense,Miro,,Tools & Subscription - G&A,90,19631604.7
04/25/2022,Expense,Miro,Mike ross,Credit Card - Ramp,90,19631694.7
04/25/2022,Expense,Miro,,Tools & Subscription - G&A,90,19631784.7
04/25/2022,Expense,Miro,,Tools & Subscription - G&A,90,19631874.7
04/26/2022,Expense,Demand Curve,,Tools & Subscription - G&A,148,19632022.7
04/26/2022,Expense,Demand Curve,,Tools & Subscription - G&A,148,19632170.7
04/26/2022,Expense,Demand Curve,,Tools & Subscription - G&A,148,19632318.7
04/26/2022,Expense,Demand Curve,,Tools & Subscription - G&A,148,19632466.7
04/26/2022,Expense,Demand Curve,Harvey Spector,Credit Card - Ramp,148,19632614.7
04/26/2022,Expense,Demand Curve,Harvey Spector,Credit Card - Ramp,148,19632762.7
04/26/2022,Expense,Demand Curve,Harvey Spector,Credit Card - Ramp,148,19632910.7
04/27/2022,Expense,Sendinblue,,Tools & Subscription - G&A,50.94,19632961.64
04/27/2022,Expense,Splitbee,,Tools & Subscription - G&A,16.52,19632978.16
04/27/2022,Expense,Sendinblue,Balapavan Tirumani,Credit Card - Ramp,50.94,19633029.1
04/27/2022,Expense,Splitbee,,Tools & Subscription - G&A,16.52,19633045.62
04/27/2022,Expense,Sendinblue,,Tools & Subscription - G&A,50.94,19633096.56
04/27/2022,Expense,Sendinblue,,Tools & Subscription - G&A,50.94,19633147.5
04/27/2022,Expense,Splitbee,,Tools & Subscription - G&A,16.52,19633164.02
04/27/2022,Expense,Sendinblue,Balapavan Tirumani,Credit Card - Ramp,50.94,19633214.96
04/27/2022,Expense,Splitbee,Harris Jose,Credit Card - Ramp,16.52,19633231.48
04/27/2022,Expense,Splitbee,,Tools & Subscription - G&A,16.52,19633248
04/27/2022,Expense,Sendinblue,,Tools & Subscription - G&A,50.94,19633298.94
04/27/2022,Expense,Sendinblue,Balapavan Tirumani,Credit Card - Ramp,50.94,19633349.88
04/27/2022,Expense,Splitbee,Harris Jose,Credit Card - Ramp,16.52,19633366.4
04/27/2022,Expense,Splitbee,Harris Jose,Credit Card - Ramp,16.52,19633382.92
04/30/2022,Expense,Adobe,Mike ross,Credit Card - Ramp,15.8,19633398.72
04/30/2022,Expense,Adobe,,Tools & Subscription - S&M,15.8,19633414.52
04/30/2022,Bill,Big Company ,"Service Expenses for the month of April 2022 
INR 1966508 @ 76.42",Accounts Payable (A/P),25732.9,19659147.42
04/30/2022,Bill,Big Company ,"Service Expenses for the month of April 2022 
INR 1966508 @ 76.42",Accounts Payable (A/P),25732.9,19684880.32
04/30/2022,Bill,Big Company ,,Outsources Services - India,25732.9,19710613.22
04/30/2022,Bill,Big Company ,"Service Expenses for the month of April 2022 
INR 1966508 @ 76.42",Accounts Payable (A/P),25732.9,19736346.12
04/30/2022,Bill,Big Company ,"Service Expenses for the month of April 2022 
INR 1966508 @ 76.42",Accounts Payable (A/P),25732.9,19762079.02
04/30/2022,Expense,Adobe,,Tools & Subscription - S&M,15.8,19762094.82
04/30/2022,Expense,Adobe,Mike ross,Credit Card - Ramp,15.8,19762110.62
04/30/2022,Expense,Adobe,,Tools & Subscription - S&M,15.8,19762126.42
04/30/2022,Bill,Big Company ,,Outsources Services - India,25732.9,19787859.32
04/30/2022,Expense,Adobe,Mike ross,Credit Card - Ramp,15.8,19787875.12
04/30/2022,Expense,Adobe,,Tools & Subscription - S&M,15.8,19787890.92
04/30/2022,Bill,Big Company ,,Outsources Services - India,25732.9,19813623.82
04/30/2022,Bill,Big Company ,,Outsources Services - India,25732.9,19839356.72
05/01/2022,Expense,Google G Suite,Mike ross,Credit Card - Ramp,79.43,19839436.15
05/01/2022,Expense,Google G Suite,Mike ross,Credit Card - Ramp,79.43,19839515.58
05/01/2022,Expense,Google G Suite,,Tools & Subscription - G&A,79.43,19839595.01
05/01/2022,Expense,Google G Suite,,Tools & Subscription - G&A,79.43,19839674.44
05/01/2022,Expense,Google G Suite,,Tools & Subscription - G&A,79.43,19839753.87
05/01/2022,Expense,Google G Suite,,Tools & Subscription - G&A,79.43,19839833.3
05/01/2022,Expense,Google G Suite,Mike ross,Credit Card - Ramp,79.43,19839912.73
05/02/2022,Deposit,,Interest Accrual,Interest Received,1.39,19839914.12
05/02/2022,Deposit,,Interest Accrual,Interest Received,1.39,19839915.51
05/02/2022,Deposit,,Interest Accrual,Interest Received,1.39,19839916.9
05/02/2022,Deposit,,Interest Accrual,Savings (6977),1.39,19839918.29
05/02/2022,Deposit,,Interest Accrual,Savings (6977),1.39,19839919.68
05/02/2022,Deposit,,Interest Accrual,Savings (6977),1.39,19839921.07
05/02/2022,Deposit,,Interest Accrual,Interest Received,1.39,19839922.46
05/03/2022,Expense,Earlywork,Mike ross,Credit Card - Ramp,70.14,19839992.6
05/03/2022,Expense,Earlywork,Mike ross,Credit Card - Ramp,70.14,19840062.74
05/03/2022,Expense,Earlywork,Mike ross,Credit Card - Ramp,70.14,19840132.88
05/03/2022,Expense,Mazurek Co,Harvey Spector,Credit Card - Ramp,29.95,19840162.83
05/03/2022,Expense,Mazurek Co,Harvey Spector,Credit Card - Ramp,29.95,19840192.78
05/03/2022,Expense,Mazurek Co,,Tools & Subscription - G&A,29.95,19840222.73
05/03/2022,Expense,Mazurek Co,,Tools & Subscription - G&A,29.95,19840252.68
05/03/2022,Expense,Earlywork,Mike ross,Professional Service Charges,70.14,19840322.82
05/03/2022,Expense,Earlywork,Mike ross,Professional Service Charges,70.14,19840392.96
05/03/2022,Expense,Mazurek Co,,Tools & Subscription - G&A,29.95,19840422.91
05/03/2022,Expense,Mazurek Co,Harvey Spector,Credit Card - Ramp,29.95,19840452.86
05/03/2022,Expense,Earlywork,Mike ross,Professional Service Charges,70.14,19840523
05/03/2022,Expense,Earlywork,Mike ross,Credit Card - Ramp,70.14,19840593.14
05/03/2022,Expense,Earlywork,Mike ross,Professional Service Charges,70.14,19840663.28
05/03/2022,Expense,Mazurek Co,,Tools & Subscription - G&A,29.95,19840693.23
05/06/2022,Expense,The Carrington,Mike ross,Credit Card - Ramp,28,19840721.23
05/06/2022,Expense,Jane Surry Hills Restaurant,,Meals & Entertainment,179.99,19840901.22
05/06/2022,Expense,Cuckoo Callay,Mike ross,Credit Card - Ramp,42.01,19840943.23
05/06/2022,Expense,Jane Surry Hills Restaurant,Mike ross,Credit Card - Ramp,179.99,19841123.22
05/06/2022,Expense,The Carrington,,Meals & Entertainment,28,19841151.22
05/06/2022,Expense,The Carrington,,Meals & Entertainment,28,19841179.22
05/06/2022,Expense,Cuckoo Callay,Mike ross,Credit Card - Ramp,42.01,19841221.23
05/06/2022,Expense,The Carrington,Mike ross,Credit Card - Ramp,28,19841249.23
05/06/2022,Expense,Jane Surry Hills Restaurant,Mike ross,Credit Card - Ramp,179.99,19841429.22
05/06/2022,Expense,Cuckoo Callay,Mike ross,Meals & Entertainment,42.01,19841471.23
05/06/2022,Expense,Cuckoo Callay,Mike ross,Meals & Entertainment,42.01,19841513.24
05/06/2022,Expense,Cuckoo Callay,Mike ross,Meals & Entertainment,42.01,19841555.25
05/06/2022,Expense,Jane Surry Hills Restaurant,Mike ross,Credit Card - Ramp,179.99,19841735.24
05/06/2022,Expense,The Carrington,,Meals & Entertainment,28,19841763.24
05/06/2022,Expense,The Carrington,,Meals & Entertainment,28,19841791.24
05/06/2022,Expense,Jane Surry Hills Restaurant,,Meals & Entertainment,179.99,19841971.23
05/06/2022,Expense,Jane Surry Hills Restaurant,,Meals & Entertainment,179.99,19842151.22
05/06/2022,Expense,Cuckoo Callay,Mike ross,Meals & Entertainment,42.01,19842193.23
05/06/2022,Expense,The Carrington,Mike ross,Credit Card - Ramp,28,19842221.23
05/06/2022,Expense,Jane Surry Hills Restaurant,,Meals & Entertainment,179.99,19842401.22
05/06/2022,Expense,Cuckoo Callay,Mike ross,Credit Card - Ramp,42.01,19842443.23
05/06/2022,Expense,The Carrington,Mike ross,Credit Card - Ramp,28,19842471.23
05/06/2022,Expense,Cuckoo Callay,Mike ross,Credit Card - Ramp,42.01,19842513.24
05/06/2022,Expense,Jane Surry Hills Restaurant,Mike ross,Credit Card - Ramp,179.99,19842693.23
05/07/2022,Expense,Mailchimp,,Tools & Subscription - G&A,19.95,19842713.18
05/07/2022,Expense,Mailchimp,Mike ross,Credit Card - Ramp,19.95,19842733.13
05/07/2022,Expense,Mailchimp,,Tools & Subscription - G&A,19.95,19842753.08
05/07/2022,Expense,Mailchimp,,Tools & Subscription - G&A,19.95,19842773.03
05/07/2022,Expense,Mailchimp,Mike ross,Credit Card - Ramp,19.95,19842792.98
05/07/2022,Expense,Mailchimp,Mike ross,Credit Card - Ramp,19.95,19842812.93
05/07/2022,Expense,Mailchimp,,Tools & Subscription - G&A,19.95,19842832.88
05/09/2022,Expense,Pragmaticengineer.Com,Harvey Spector,Credit Card - Ramp,15,19842847.88
05/09/2022,Expense,Usersnap,,Tools & Subscription - G&A,19,19842866.88
05/09/2022,Expense,Heroku,Balapavan Tirumani,Credit Card - Ramp,30,19842896.88
05/09/2022,Expense,Heroku,Balapavan Tirumani,Tools & Subscription - S&M,30,19842926.88
05/09/2022,Expense,Heroku,Balapavan Tirumani,Credit Card - Ramp,30,19842956.88
05/09/2022,Expense,Heroku,Balapavan Tirumani,Credit Card - Ramp,30,19842986.88
05/09/2022,Expense,Pragmaticengineer.Com,Harvey Spector,Credit Card - Ramp,15,19843001.88
05/09/2022,Expense,Usersnap,Harris Jose,Credit Card - Ramp,19,19843020.88
05/09/2022,Expense,Usersnap,Harris Jose,Credit Card - Ramp,19,19843039.88
05/09/2022,Expense,Pragmaticengineer.Com,,Tools & Subscription - G&A,15,19843054.88
05/09/2022,Expense,Usersnap,Harris Jose,Credit Card - Ramp,19,19843073.88
05/09/2022,Expense,Heroku,Balapavan Tirumani,Tools & Subscription - S&M,30,19843103.88
05/09/2022,Expense,Heroku,Balapavan Tirumani,Tools & Subscription - S&M,30,19843133.88
05/09/2022,Expense,Pragmaticengineer.Com,,Tools & Subscription - G&A,15,19843148.88
05/09/2022,Expense,Pragmaticengineer.Com,,Tools & Subscription - G&A,15,19843163.88
05/09/2022,Expense,Usersnap,,Tools & Subscription - G&A,19,19843182.88
05/09/2022,Expense,Heroku,Balapavan Tirumani,Tools & Subscription - S&M,30,19843212.88
05/09/2022,Expense,Pragmaticengineer.Com,Harvey Spector,Credit Card - Ramp,15,19843227.88
05/09/2022,Expense,Usersnap,,Tools & Subscription - G&A,19,19843246.88
05/09/2022,Expense,Usersnap,,Tools & Subscription - G&A,19,19843265.88
05/09/2022,Expense,Pragmaticengineer.Com,,Tools & Subscription - G&A,15,19843280.88
05/10/2022,Expense,Pause Cafe,Harvey Spector,Meals & Entertainment,7,19843287.88
05/10/2022,Expense,Pause Cafe,Harvey Spector,Meals & Entertainment,7,19843294.88
05/10/2022,Expense,Jino Joseph & Associates,JINO JOSEPH & AS,Account1,60,19843354.88
05/10/2022,Expense,Pause Cafe,Harvey Spector,Meals & Entertainment,7,19843361.88
05/10/2022,Expense,Jino Joseph & Associates,JINO JOSEPH & AS,Professional Service Charges,-60,19843301.88
05/10/2022,Expense,Jino Joseph & Associates,JINO JOSEPH & AS,Account1,60,19843361.88
05/10/2022,Expense,Pause Cafe,Harvey Spector,Credit Card - Ramp,7,19843368.88
05/10/2022,Expense,Pause Cafe,Harvey Spector,Meals & Entertainment,7,19843375.88
05/10/2022,Expense,Jino Joseph & Associates,JINO JOSEPH & AS,Professional Service Charges,-60,19843315.88
05/10/2022,Expense,Jino Joseph & Associates,JINO JOSEPH & AS,Professional Service Charges,-60,19843255.88
05/10/2022,Expense,Pause Cafe,Harvey Spector,Credit Card - Ramp,7,19843262.88
05/10/2022,Expense,Jino Joseph & Associates,JINO JOSEPH & AS,Account1,60,19843322.88
05/10/2022,Expense,Jino Joseph & Associates,JINO JOSEPH & AS,Account1,60,19843382.88
05/10/2022,Expense,Pause Cafe,Harvey Spector,Credit Card - Ramp,7,19843389.88
05/10/2022,Expense,Pause Cafe,Harvey Spector,Credit Card - Ramp,7,19843396.88
05/10/2022,Expense,Jino Joseph & Associates,JINO JOSEPH & AS,Professional Service Charges,-60,19843336.88
05/12/2022,Expense,Intuit India,,Tools & Subscription - G&A,16.17,19843353.05
05/12/2022,Expense,Perkins Coie LLP,Perkins Coie LLP -Legal fees.,Account1,399.5,19843752.55
05/12/2022,Expense,Perkins Coie LLP,Perkins Coie LLP -Legal fees.,Account1,399.5,19844152.05
05/12/2022,Expense,Perkins Coie LLP,Perkins Coie LLP,Legal & accounting services:Legal Fees,-399.5,19843752.55
05/12/2022,Expense,Intuit India,Harvey Spector,Credit Card - Ramp,16.17,19843768.72
05/12/2022,Expense,Intuit India,,Tools & Subscription - G&A,16.17,19843784.89
05/12/2022,Expense,Intuit India,Harvey Spector,Credit Card - Ramp,16.17,19843801.06
05/12/2022,Expense,Perkins Coie LLP,Perkins Coie LLP,Legal & accounting services:Legal Fees,-399.5,19843401.56
05/12/2022,Expense,Perkins Coie LLP,Perkins Coie LLP -Legal fees.,Account1,399.5,19843801.06
05/12/2022,Expense,Perkins Coie LLP,Perkins Coie LLP,Legal & accounting services:Legal Fees,-399.5,19843401.56
05/12/2022,Expense,Intuit India,,Tools & Subscription - G&A,16.17,19843417.73
05/12/2022,Expense,Intuit India,,Tools & Subscription - G&A,16.17,19843433.9
05/12/2022,Expense,Perkins Coie LLP,Perkins Coie LLP -Legal fees.,Account1,399.5,19843833.4
05/12/2022,Expense,Perkins Coie LLP,Perkins Coie LLP,Legal & accounting services:Legal Fees,-399.5,19843433.9
05/12/2022,Expense,Intuit India,Harvey Spector,Credit Card - Ramp,16.17,19843450.07
05/13/2022,Expense,Frog Hollow Tavern,Mike ross,Credit Card - Ramp,58.26,19843508.33
05/13/2022,Expense,Cuckoo Callay,Mike ross,Credit Card - Ramp,49.07,19843557.4
05/13/2022,Expense,Cuckoo Callay,Mike ross,Credit Card - Ramp,49.07,19843606.47
05/13/2022,Expense,Frog Hollow Tavern,Mike ross,Credit Card - Ramp,58.26,19843664.73
05/13/2022,Expense,Cuckoo Callay,Mike ross,Credit Card - Ramp,49.07,19843713.8
05/13/2022,Expense,Frog Hollow Tavern,Mike ross,Credit Card - Ramp,58.26,19843772.06
05/13/2022,Expense,Qantas,,Travel:Airfare,974.41,19844746.47
05/13/2022,Expense,Figma,,Tools & Subscription - G&A,165,19844911.47
05/13/2022,Expense,Trip.com,Mike ross,Credit Card - Ramp,444.07,19845355.54
05/13/2022,Expense,Trip.com,,Travelling Expenses,444.07,19845799.61
05/13/2022,Expense,Frog Hollow Tavern,Mike ross,Meals & Entertainment,58.26,19845857.87
05/13/2022,Expense,Qantas,,Travel:Airfare,974.41,19846832.28
05/13/2022,Expense,Cuckoo Callay,Mike ross,Credit Card - Ramp,49.07,19846881.35
05/13/2022,Expense,Frog Hollow Tavern,Mike ross,Credit Card - Ramp,58.26,19846939.61
05/13/2022,Expense,Cuckoo Callay,Mike ross,Meals & Entertainment,49.07,19846988.68
05/13/2022,Expense,Qantas,,Travel:Airfare,974.41,19847963.09
05/13/2022,Expense,Qantas,Mike ross,Credit Card - Ramp,974.41,19848937.5
05/13/2022,Expense,Cuckoo Callay,Mike ross,Meals & Entertainment,49.07,19848986.57
05/13/2022,Expense,Cuckoo Callay,Mike ross,Meals & Entertainment,49.07,19849035.64
05/13/2022,Expense,Cuckoo Callay,Mike ross,Meals & Entertainment,49.07,19849084.71
05/13/2022,Expense,Trip.com,,Travelling Expenses,444.07,19849528.78
05/13/2022,Expense,Trip.com,Mike ross,Credit Card - Ramp,444.07,19849972.85
05/13/2022,Expense,Qantas,Mike ross,Credit Card - Ramp,974.41,19850947.26
05/13/2022,Expense,Figma,,Tools & Subscription - G&A,165,19851112.26
05/13/2022,Expense,Trip.com,,Travelling Expenses,444.07,19851556.33
05/13/2022,Expense,Figma,,Tools & Subscription - G&A,165,19851721.33
05/13/2022,Expense,Frog Hollow Tavern,Mike ross,Meals & Entertainment,58.26,19851779.59
05/13/2022,Expense,Qantas,,Travel:Airfare,974.41,19852754
05/13/2022,Expense,Frog Hollow Tavern,Mike ross,Meals & Entertainment,58.26,19852812.26
05/13/2022,Expense,Trip.com,Mike ross,Credit Card - Ramp,444.07,19853256.33
05/13/2022,Expense,Figma,,Tools & Subscription - G&A,165,19853421.33
05/13/2022,Expense,Figma,Mike ross,Credit Card - Ramp,165,19853586.33
05/13/2022,Expense,Qantas,Mike ross,Credit Card - Ramp,974.41,19854560.74
05/13/2022,Expense,Figma,Mike ross,Credit Card - Ramp,165,19854725.74
05/13/2022,Expense,Figma,Mike ross,Credit Card - Ramp,165,19854890.74
05/13/2022,Expense,Frog Hollow Tavern,Mike ross,Meals & Entertainment,58.26,19854949
05/13/2022,Expense,Trip.com,,Travelling Expenses,444.07,19855393.07
05/14/2022,Expense,Intuit,,Tools & Subscription - G&A,50,19855443.07
05/14/2022,Expense,Intuit,,Tools & Subscription - G&A,50,19855493.07
05/14/2022,Expense,LinkedIn,,Tools & Subscription - G&A,93.22,19855586.29
05/14/2022,Expense,Intuit,Harvey Spector,Credit Card - Ramp,50,19855636.29
05/14/2022,Expense,LinkedIn,,Tools & Subscription - G&A,93.22,19855729.51
05/14/2022,Expense,Intuit,,Tools & Subscription - G&A,50,19855779.51
05/14/2022,Expense,LinkedIn,,Tools & Subscription - G&A,93.22,19855872.73
05/14/2022,Expense,Intuit,Harvey Spector,Credit Card - Ramp,50,19855922.73
05/14/2022,Expense,Intuit,,Tools & Subscription - G&A,50,19855972.73
05/14/2022,Expense,LinkedIn,Harvey Spector,Credit Card - Ramp,93.22,19856065.95
05/14/2022,Expense,LinkedIn,Harvey Spector,Credit Card - Ramp,93.22,19856159.17
05/14/2022,Expense,Intuit,Harvey Spector,Credit Card - Ramp,50,19856209.17
05/14/2022,Expense,LinkedIn,Harvey Spector,Credit Card - Ramp,93.22,19856302.39
05/14/2022,Expense,LinkedIn,,Tools & Subscription - G&A,93.22,19856395.61
05/15/2022,Expense,The New York Times,,General business expenses:Memberships & subscriptions,1.39,19856397
05/15/2022,Expense,The New York Times,,General business expenses:Memberships & subscriptions,1.39,19856398.39
05/15/2022,Expense,The New York Times,Mike ross,Credit Card - Ramp,1.39,19856399.78
05/15/2022,Expense,The New York Times,,General business expenses:Memberships & subscriptions,1.39,19856401.17
05/15/2022,Expense,The New York Times,,General business expenses:Memberships & subscriptions,1.39,19856402.56
05/15/2022,Expense,The New York Times,Mike ross,Credit Card - Ramp,1.39,19856403.95
05/15/2022,Expense,The New York Times,Mike ross,Credit Card - Ramp,1.39,19856405.34
05/15/2022,Expense,The New York Times,Mike ross,Credit Card - Ramp,1.39,19856406.73
05/16/2022,Expense,Zapier,,Tools & Subscription - G&A,29.99,19856436.72
05/16/2022,Expense,Zapier,Harvey Spector,Credit Card - Ramp,29.99,19856466.71
05/16/2022,Expense,Zapier,,Tools & Subscription - G&A,29.99,19856496.7
05/16/2022,Expense,Zapier,Harvey Spector,Credit Card - Ramp,29.99,19856526.69
05/16/2022,Expense,Zapier,Harvey Spector,Credit Card - Ramp,29.99,19856556.68
05/16/2022,Expense,Zapier,,Tools & Subscription - G&A,29.99,19856586.67
05/16/2022,Expense,Zapier,,Tools & Subscription - G&A,29.99,19856616.66
05/18/2022,Expense,Superhuman,Harvey Spector,Credit Card - Ramp,30,19856646.66
05/18/2022,Expense,Superhuman,,Professional Service Charges,30,19856676.66
05/18/2022,Expense,LinkedIn,,Tools & Subscription - G&A,25.82,19856702.48
05/18/2022,Expense,Superhuman,Harvey Spector,Credit Card - Ramp,30,19856732.48
05/18/2022,Expense,LinkedIn,,Tools & Subscription - G&A,159.18,19856891.66
05/18/2022,Expense,LinkedIn,,Tools & Subscription - G&A,159.18,19857050.84
05/18/2022,Expense,LinkedIn,Mike ross,Credit Card - Ramp,159.18,19857210.02
05/18/2022,Expense,LinkedIn,Harvey Spector,Credit Card - Ramp,25.82,19857235.84
05/18/2022,Expense,Superhuman,,Professional Service Charges,30,19857265.84
05/18/2022,Expense,Superhuman,,Professional Service Charges,30,19857295.84
05/18/2022,Expense,LinkedIn,,Tools & Subscription - G&A,159.18,19857455.02
05/18/2022,Expense,LinkedIn,,Tools & Subscription - G&A,25.82,19857480.84
05/18/2022,Expense,LinkedIn,,Tools & Subscription - G&A,25.82,19857506.66
05/18/2022,Expense,LinkedIn,Mike ross,Credit Card - Ramp,159.18,19857665.84
05/18/2022,Expense,LinkedIn,Harvey Spector,Credit Card - Ramp,25.82,19857691.66
05/18/2022,Expense,Superhuman,Harvey Spector,Credit Card - Ramp,30,19857721.66
05/18/2022,Expense,Superhuman,,Professional Service Charges,30,19857751.66
05/18/2022,Expense,LinkedIn,,Tools & Subscription - G&A,25.82,19857777.48
05/18/2022,Expense,LinkedIn,,Tools & Subscription - G&A,159.18,19857936.66
05/18/2022,Expense,LinkedIn,Harvey Spector,Credit Card - Ramp,25.82,19857962.48
05/18/2022,Expense,LinkedIn,Mike ross,Credit Card - Ramp,159.18,19858121.66
05/18/2022,Expense,Superhuman,Harvey Spector,Credit Card - Ramp,30,19858151.66
05/19/2022,Expense,Lenny Rachitsky,Mike ross,Credit Card - Ramp,150,19858301.66
05/19/2022,Expense,Lenny Rachitsky,Mike ross,Credit Card - Ramp,150,19858451.66
05/19/2022,Expense,Lenny Rachitsky,,General business expenses:Memberships & subscriptions,150,19858601.66
05/19/2022,Expense,Lenny Rachitsky,,General business expenses:Memberships & subscriptions,150,19858751.66
05/19/2022,Expense,Lenny Rachitsky,,General business expenses:Memberships & subscriptions,150,19858901.66
05/19/2022,Expense,Lenny Rachitsky,,General business expenses:Memberships & subscriptions,150,19859051.66
05/19/2022,Expense,Lenny Rachitsky,Mike ross,Credit Card - Ramp,150,19859201.66
05/19/2022,Expense,Lenny Rachitsky,Mike ross,Credit Card - Ramp,150,19859351.66
05/20/2022,Credit Card Payment,,RAMP BUSINESS CO,Account1,-2636.19,19856715.47
05/20/2022,Credit Card Payment,,RAMP BUSINESS CO,Credit Card - Ramp,-2636.19,19854079.28
05/20/2022,Credit Card Payment,,RAMP BUSINESS CO,Account1,-2636.19,19851443.09
05/20/2022,Credit Card Payment,,RAMP BUSINESS CO,Credit Card - Ramp,-2636.19,19848806.9
05/20/2022,Credit Card Payment,,RAMP BUSINESS CO,Account1,-2636.19,19846170.71
05/20/2022,Credit Card Payment,,RAMP BUSINESS CO,Credit Card - Ramp,-2636.19,19843534.52
05/20/2022,Credit Card Payment,,RAMP BUSINESS CO,Account1,-2636.19,19840898.33
05/20/2022,Credit Card Payment,,RAMP BUSINESS CO,Credit Card - Ramp,-2636.19,19838262.14
05/22/2022,Expense,Automate,Balapavan Tirumani,Credit Card - Ramp,29,19838291.14
05/22/2022,Expense,Automate,,Tools & Subscription - G&A,29,19838320.14
05/22/2022,Expense,Dovetail,,Tools & Subscription - G&A,36,19838356.14
05/22/2022,Expense,Dovetail,Harvey Spector,Credit Card - Ramp,36,19838392.14
05/22/2022,Expense,Automate,,Tools & Subscription - G&A,29,19838421.14
05/22/2022,Expense,Automate,,Tools & Subscription - G&A,29,19838450.14
05/22/2022,Expense,Dovetail,,Tools & Subscription - G&A,36,19838486.14
05/22/2022,Expense,Dovetail,Harvey Spector,Credit Card - Ramp,36,19838522.14
05/22/2022,Expense,Dovetail,,Tools & Subscription - G&A,36,19838558.14
05/22/2022,Expense,Automate,,Tools & Subscription - G&A,29,19838587.14
05/22/2022,Expense,Automate,Balapavan Tirumani,Credit Card - Ramp,29,19838616.14
05/22/2022,Expense,Dovetail,Harvey Spector,Credit Card - Ramp,36,19838652.14
05/22/2022,Expense,Dovetail,,Tools & Subscription - G&A,36,19838688.14
05/22/2022,Expense,Automate,Balapavan Tirumani,Credit Card - Ramp,29,19838717.14
05/23/2022,Expense,Superhuman,Mike ross,Credit Card - Ramp,30,19838747.14
05/23/2022,Transfer,,PaymentServiceB Checking **7257,Account1,-150000,19688747.14
05/23/2022,Expense,Super,Harvey Spector,Credit Card - Ramp,12,19688759.14
05/23/2022,Transfer,,PaymentServiceB Checking **7257,Savings (6977),150000,19838759.14
05/23/2022,Transfer,,PaymentServiceB Checking **7257,Account1,-150000,19688759.14
05/23/2022,Expense,Superhuman,Mike ross,Credit Card - Ramp,30,19688789.14
05/23/2022,Expense,Super,,Tools & Subscription - G&A,12,19688801.14
05/23/2022,Expense,Super,Harvey Spector,Credit Card - Ramp,12,19688813.14
05/23/2022,Transfer,,PaymentServiceB Checking **7257,Account1,-150000,19538813.14
05/23/2022,Expense,Superhuman,,Professional Service Charges,30,19538843.14
05/23/2022,Expense,Super,Harvey Spector,Credit Card - Ramp,12,19538855.14
05/23/2022,Expense,Super,,Tools & Subscription - G&A,12,19538867.14
05/23/2022,Expense,Super,,Tools & Subscription - G&A,12,19538879.14
05/23/2022,Transfer,,PaymentServiceB Checking **7257,Savings (6977),150000,19688879.14
05/23/2022,Expense,Superhuman,Mike ross,Credit Card - Ramp,30,19688909.14
05/23/2022,Transfer,,PaymentServiceB Checking **7257,Account1,-150000,19538909.14
05/23/2022,Expense,Superhuman,,Professional Service Charges,30,19538939.14
05/23/2022,Expense,Superhuman,,Professional Service Charges,30,19538969.14
05/23/2022,Expense,Super,,Tools & Subscription - G&A,12,19538981.14
05/23/2022,Expense,Superhuman,,Professional Service Charges,30,19539011.14
05/23/2022,Transfer,,PaymentServiceB Checking **7257,Savings (6977),150000,19689011.14
05/23/2022,Expense,Superhuman,Mike ross,Credit Card - Ramp,30,19689041.14
05/23/2022,Transfer,,PaymentServiceB Checking **7257,Savings (6977),150000,19839041.14
05/24/2022,Expense,Swipe Files,,Tools & Subscription - G&A,249.5,19839290.64
05/24/2022,Expense,Swipe Files,Harvey Spector,Credit Card - Ramp,249.5,19839540.14
05/24/2022,Expense,Swipe Files,Harvey Spector,Credit Card - Ramp,249.5,19839789.64
05/24/2022,Expense,Swipe Files,,Tools & Subscription - G&A,249.5,19840039.14
05/24/2022,Expense,Swipe Files,,Tools & Subscription - G&A,249.5,19840288.64
05/24/2022,Expense,Swipe Files,,Tools & Subscription - G&A,249.5,19840538.14
05/24/2022,Expense,Swipe Files,Harvey Spector,Credit Card - Ramp,249.5,19840787.64
05/25/2022,Expense,Miro,,Tools & Subscription - G&A,90,19840877.64
05/25/2022,Expense,Miro,,Tools & Subscription - G&A,90,19840967.64
05/25/2022,Expense,Miro,,Tools & Subscription - G&A,90,19841057.64
05/25/2022,Expense,Miro,Mike ross,Credit Card - Ramp,90,19841147.64
05/25/2022,Expense,Miro,Mike ross,Credit Card - Ramp,90,19841237.64
05/25/2022,Expense,Miro,Mike ross,Credit Card - Ramp,90,19841327.64
05/25/2022,Expense,Miro,,Tools & Subscription - G&A,90,19841417.64
05/26/2022,Expense,Surry Hills,Mike ross,Meals & Entertainment,47.71,19841465.35
05/26/2022,Expense,Principle,,Tools & Subscription - G&A,99,19841564.35
05/26/2022,Expense,Surry Hills,Mike ross,Credit Card - Ramp,47.71,19841612.06
05/26/2022,Expense,Surry Hills,Mike ross,Meals & Entertainment,47.71,19841659.77
05/26/2022,Expense,Principle,,Tools & Subscription - G&A,99,19841758.77
05/26/2022,Expense,Big Company ,Big Company ,Accounts Payable (A/P),-150000,19691758.77
05/26/2022,Expense,Big Company ,Big Company ,Account1,-150000,19541758.77
05/26/2022,Expense,Principle,,Tools & Subscription - G&A,99,19541857.77
05/26/2022,Expense,Surry Hills,Mike ross,Meals & Entertainment,47.71,19541905.48
05/26/2022,Expense,Principle,Chris George,Credit Card - Ramp,99,19542004.48
05/26/2022,Expense,Principle,,Tools & Subscription - G&A,99,19542103.48
05/26/2022,Expense,Big Company ,Big Company ,Account1,-150000,19392103.48
05/26/2022,Expense,Big Company ,Big Company ,Account1,-150000,19242103.48
05/26/2022,Expense,Big Company ,Big Company ,Accounts Payable (A/P),-150000,19092103.48
05/26/2022,Expense,Principle,Chris George,Credit Card - Ramp,99,19092202.48
05/26/2022,Expense,Big Company ,Big Company ,Accounts Payable (A/P),-150000,18942202.48
05/26/2022,Expense,Surry Hills,Mike ross,Credit Card - Ramp,47.71,18942250.19
05/26/2022,Expense,Principle,Chris George,Credit Card - Ramp,99,18942349.19
05/26/2022,Expense,Big Company ,Big Company ,Accounts Payable (A/P),-150000,18792349.19
05/26/2022,Expense,Surry Hills,Mike ross,Meals & Entertainment,47.71,18792396.9
05/26/2022,Expense,Surry Hills,Mike ross,Credit Card - Ramp,47.71,18792444.61
05/26/2022,Expense,Big Company ,Big Company ,Account1,-150000,18642444.61
05/26/2022,Expense,Surry Hills,Mike ross,Credit Card - Ramp,47.71,18642492.32
05/27/2022,Expense,Splitbee,Harris Jose,Credit Card - Ramp,16.52,18642508.84
05/27/2022,Expense,Splitbee,,Tools & Subscription - G&A,16.52,18642525.36
05/27/2022,Expense,Splitbee,,Tools & Subscription - G&A,16.52,18642541.88
05/27/2022,Expense,Splitbee,,Tools & Subscription - G&A,16.52,18642558.4
05/27/2022,Expense,Sendinblue,,Tools & Subscription - G&A,50.26,18642608.66
05/27/2022,Expense,Sendinblue,Balapavan Tirumani,Credit Card - Ramp,50.26,18642658.92
05/27/2022,Expense,Sendinblue,,Tools & Subscription - G&A,50.26,18642709.18
05/27/2022,Expense,Sendinblue,Balapavan Tirumani,Credit Card - Ramp,50.26,18642759.44
05/27/2022,Expense,Sendinblue,,Tools & Subscription - G&A,50.26,18642809.7
05/27/2022,Expense,Splitbee,Harris Jose,Credit Card - Ramp,16.52,18642826.22
05/27/2022,Expense,Sendinblue,,Tools & Subscription - G&A,50.26,18642876.48
05/27/2022,Expense,Sendinblue,Balapavan Tirumani,Credit Card - Ramp,50.26,18642926.74
05/27/2022,Expense,Splitbee,Harris Jose,Credit Card - Ramp,16.52,18642943.26
05/27/2022,Expense,Splitbee,,Tools & Subscription - G&A,16.52,18642959.78
05/28/2022,Expense,Qatar Airways,Chad Blumenthal,Credit Card - Ramp,1109,18644068.78
05/28/2022,Expense,Budgetair.Com,,Travelling Expenses,85.9,18644154.68
05/28/2022,Expense,Qatar Airways,,Travel:Airfare,1109,18645263.68
05/28/2022,Expense,United Airlines,Chad Blumenthal,Credit Card - Ramp,390.5,18645654.18
05/28/2022,Expense,United Airlines,,Travel:Airfare,390.5,18646044.68
05/28/2022,Expense,Qatar Airways,Chad Blumenthal,Credit Card - Ramp,1109,18647153.68
05/28/2022,Expense,United Airlines,Chad Blumenthal,Credit Card - Ramp,390.5,18647544.18
05/28/2022,Expense,United Airlines,,Travel:Airfare,390.5,18647934.68
05/28/2022,Expense,Budgetair.Com,Chad Blumenthal,Credit Card - Ramp,85.9,18648020.58
05/28/2022,Expense,Qatar Airways,,Travel:Airfare,1109,18649129.58
05/28/2022,Expense,Budgetair.Com,Chad Blumenthal,Credit Card - Ramp,85.9,18649215.48
05/28/2022,Expense,Budgetair.Com,,Travelling Expenses,85.9,18649301.38
05/28/2022,Expense,United Airlines,,Travel:Airfare,390.5,18649691.88
05/28/2022,Expense,Qatar Airways,,Travel:Airfare,1109,18650800.88
05/28/2022,Expense,Budgetair.Com,,Travelling Expenses,85.9,18650886.78
05/28/2022,Expense,Budgetair.Com,Chad Blumenthal,Credit Card - Ramp,85.9,18650972.68
05/28/2022,Expense,Budgetair.Com,,Travelling Expenses,85.9,18651058.58
05/28/2022,Expense,Qatar Airways,Chad Blumenthal,Credit Card - Ramp,1109,18652167.58
05/28/2022,Expense,United Airlines,Chad Blumenthal,Credit Card - Ramp,390.5,18652558.08
05/28/2022,Expense,Qatar Airways,,Travel:Airfare,1109,18653667.08
05/28/2022,Expense,United Airlines,,Travel:Airfare,390.5,18654057.58
05/29/2022,Expense,Netlify,Balapavan Tirumani,Credit Card - Ramp,7,18654064.58
05/29/2022,Expense,Netlify,,Tools & Subscription - G&A,7,18654071.58
05/29/2022,Expense,Netlify,Balapavan Tirumani,Credit Card - Ramp,7,18654078.58
05/29/2022,Expense,Netlify,,Tools & Subscription - G&A,7,18654085.58
05/29/2022,Expense,Netlify,,Tools & Subscription - G&A,7,18654092.58
05/29/2022,Expense,Netlify,Balapavan Tirumani,Credit Card - Ramp,7,18654099.58
05/29/2022,Expense,Netlify,,Tools & Subscription - G&A,7,18654106.58
05/30/2022,Expense,Virgin Au,,Travel:Airfare,196.82,18654303.4
05/30/2022,Expense,Conde Nast,,General business expenses:Memberships & subscriptions,20,18654323.4
05/30/2022,Expense,Medium,Mike ross,Credit Card - Ramp,50,18654373.4
05/30/2022,Expense,Conde Nast,Mike ross,Credit Card - Ramp,20,18654393.4
05/30/2022,Expense,Virgin Au,,Travel:Airfare,196.82,18654590.22
05/30/2022,Expense,Conde Nast,Mike ross,Credit Card - Ramp,20,18654610.22
05/30/2022,Expense,Virgin Au,Chad Blumenthal,Credit Card - Ramp,196.82,18654807.04
05/30/2022,Expense,Conde Nast,,General business expenses:Memberships & subscriptions,20,18654827.04
05/30/2022,Expense,Medium,,General business expenses:Memberships & subscriptions,50,18654877.04
05/30/2022,Expense,Medium,Mike ross,Credit Card - Ramp,50,18654927.04
05/30/2022,Expense,Conde Nast,Mike ross,Credit Card - Ramp,20,18654947.04
05/30/2022,Expense,Medium,,General business expenses:Memberships & subscriptions,50,18654997.04
05/30/2022,Expense,Virgin Au,,Travel:Airfare,196.82,18655193.86
05/30/2022,Expense,Medium,Mike ross,Credit Card - Ramp,50,18655243.86
05/30/2022,Expense,Medium,,General business expenses:Memberships & subscriptions,50,18655293.86
05/30/2022,Expense,Virgin Au,,Travel:Airfare,196.82,18655490.68
05/30/2022,Expense,Conde Nast,,General business expenses:Memberships & subscriptions,20,18655510.68
05/30/2022,Expense,Conde Nast,,General business expenses:Memberships & subscriptions,20,18655530.68
05/30/2022,Expense,Virgin Au,Chad Blumenthal,Credit Card - Ramp,196.82,18655727.5
05/30/2022,Expense,Virgin Au,Chad Blumenthal,Credit Card - Ramp,196.82,18655924.32
05/30/2022,Expense,Medium,Mike ross,Credit Card - Ramp,50,18655974.32
05/30/2022,Expense,Medium,,General business expenses:Memberships & subscriptions,50,18656024.32
05/30/2022,Expense,Conde Nast,Mike ross,Credit Card - Ramp,20,18656044.32
05/31/2022,Expense,Adobe,Mike ross,Credit Card - Ramp,15.91,18656060.23
05/31/2022,Expense,Lenny Rachitsky,Harvey Spector,Credit Card - Ramp,75,18656135.23
05/31/2022,Expense,Adobe,,Tools & Subscription - S&M,15.91,18656151.14
05/31/2022,Expense,Airtable,,Tools & Subscription - G&A,12,18656163.14
05/31/2022,Expense,Lenny Rachitsky,,General business expenses:Memberships & subscriptions,75,18656238.14
05/31/2022,Expense,Lenny Rachitsky,Harvey Spector,Credit Card - Ramp,75,18656313.14
05/31/2022,Bill,Big Company ,"Service Expenses for the month of May 2022 
INR 3583258 @ 77.66",Accounts Payable (A/P),46140.33,18702453.47
05/31/2022,Bill,Big Company ,"Service Expenses for the month of May 2022 
INR 3583258 @ 77.66",Accounts Payable (A/P),46140.33,18748593.8
05/31/2022,Expense,Adobe,Mike ross,Credit Card - Ramp,15.91,18748609.71
05/31/2022,Bill,Big Company ,,Outsources Services - India,46140.33,18794750.04
05/31/2022,Bill,Big Company ,,Outsources Services - India,46140.33,18840890.37
05/31/2022,Expense,Lenny Rachitsky,,General business expenses:Memberships & subscriptions,75,18840965.37
05/31/2022,Expense,Airtable,Harvey Spector,Credit Card - Ramp,12,18840977.37
05/31/2022,Expense,Lenny Rachitsky,Harvey Spector,Credit Card - Ramp,75,18841052.37
05/31/2022,Expense,Airtable,Harvey Spector,Credit Card - Ramp,12,18841064.37
05/31/2022,Expense,Airtable,Harvey Spector,Credit Card - Ramp,12,18841076.37
05/31/2022,Expense,Airtable,,Tools & Subscription - G&A,12,18841088.37
05/31/2022,Expense,Adobe,Mike ross,Credit Card - Ramp,15.91,18841104.28
05/31/2022,Bill,Big Company ,,Outsources Services - India,46140.33,18887244.61
05/31/2022,Bill,Big Company ,"Service Expenses for the month of May 2022 
INR 3583258 @ 77.66",Accounts Payable (A/P),46140.33,18933384.94
05/31/2022,Expense,Lenny Rachitsky,,General business expenses:Memberships & subscriptions,75,18933459.94
05/31/2022,Expense,Airtable,,Tools & Subscription - G&A,12,18933471.94
05/31/2022,Bill,Big Company ,"Service Expenses for the month of May 2022 
INR 3583258 @ 77.66",Accounts Payable (A/P),46140.33,18979612.27
05/31/2022,Expense,Adobe,,Tools & Subscription - S&M,15.91,18979628.18
05/31/2022,Expense,Airtable,,Tools & Subscription - G&A,12,18979640.18
05/31/2022,Expense,Lenny Rachitsky,Harvey Spector,Credit Card - Ramp,75,18979715.18
05/31/2022,Expense,Adobe,,Tools & Subscription - S&M,15.91,18979731.09
05/31/2022,Bill,Big Company ,,Outsources Services - India,46140.33,19025871.42
05/31/2022,Expense,Adobe,,Tools & Subscription - S&M,15.91,19025887.33
05/31/2022,Expense,Lenny Rachitsky,,General business expenses:Memberships & subscriptions,75,19025962.33
06/01/2022,Expense,Slack,,Tools & Subscription - G&A,34.42,19025996.75
06/01/2022,Expense,Google G Suite,,Tools & Subscription - G&A,89.98,19026086.73
06/01/2022,Expense,Slack,,Tools & Subscription - G&A,34.42,19026121.15
06/01/2022,Expense,Reuben Hills,Mike ross,Meals & Entertainment,29.89,19026151.04
06/01/2022,Expense,Slack,Mike ross,Credit Card - Ramp,34.42,19026185.46
06/01/2022,Expense,Google G Suite,Mike ross,Credit Card - Ramp,89.98,19026275.44
06/01/2022,Expense,Google G Suite,Mike ross,Credit Card - Ramp,89.98,19026365.42
06/01/2022,Expense,Reuben Hills,Mike ross,Credit Card - Ramp,29.89,19026395.31
06/01/2022,Expense,Slack,Mike ross,Credit Card - Ramp,34.42,19026429.73
06/01/2022,Expense,Google G Suite,Mike ross,Credit Card - Ramp,89.98,19026519.71
06/01/2022,Expense,Reuben Hills,Mike ross,Credit Card - Ramp,29.89,19026549.6
06/01/2022,Expense,Slack,,Tools & Subscription - G&A,34.42,19026584.02
06/01/2022,Expense,Slack,,Tools & Subscription - G&A,34.42,19026618.44
06/01/2022,Expense,Google G Suite,,Tools & Subscription - G&A,89.98,19026708.42
06/01/2022,Expense,Reuben Hills,Mike ross,Meals & Entertainment,29.89,19026738.31
06/01/2022,Expense,Slack,Mike ross,Credit Card - Ramp,34.42,19026772.73
06/01/2022,Expense,Google G Suite,,Tools & Subscription - G&A,89.98,19026862.71
06/01/2022,Expense,Reuben Hills,Mike ross,Credit Card - Ramp,29.89,19026892.6
06/01/2022,Expense,Reuben Hills,Mike ross,Meals & Entertainment,29.89,19026922.49
06/01/2022,Expense,Google G Suite,,Tools & Subscription - G&A,89.98,19027012.47
06/01/2022,Expense,Reuben Hills,Mike ross,Meals & Entertainment,29.89,19027042.36
06/01/2022,Expense,Reuben Hills,Mike ross,Credit Card - Ramp,29.89,19027072.25
06/03/2022,Expense,Mazurek Co,Harvey Spector,Credit Card - Ramp,29.95,19027102.2
06/03/2022,Expense,Cuckoo Callay,Mike ross,Credit Card - Ramp,47.98,19027150.18
06/03/2022,Expense,Cuckoo Callay,Mike ross,Credit Card - Ramp,47.98,19027198.16
06/03/2022,Expense,Mazurek Co,,Tools & Subscription - G&A,29.95,19027228.11
06/03/2022,Expense,Cuckoo Callay,Mike ross,Credit Card - Ramp,47.98,19027276.09
06/03/2022,Expense,Cuckoo Callay,Mike ross,Meals & Entertainment,47.98,19027324.07
06/03/2022,Expense,Cuckoo Callay,Mike ross,Credit Card - Ramp,47.98,19027372.05
06/03/2022,Expense,Mazurek Co,,Tools & Subscription - G&A,29.95,19027402
06/03/2022,Expense,Mazurek Co,Harvey Spector,Credit Card - Ramp,29.95,19027431.95
06/03/2022,Expense,Cuckoo Callay,Mike ross,Meals & Entertainment,47.98,19027479.93
06/03/2022,Expense,Mazurek Co,,Tools & Subscription - G&A,29.95,19027509.88
06/03/2022,Expense,Cuckoo Callay,Mike ross,Meals & Entertainment,47.98,19027557.86
06/03/2022,Expense,Mazurek Co,,Tools & Subscription - G&A,29.95,19027587.81
06/03/2022,Expense,Cuckoo Callay,Mike ross,Meals & Entertainment,47.98,19027635.79
06/03/2022,Expense,Mazurek Co,Harvey Spector,Credit Card - Ramp,29.95,19027665.74
06/07/2022,Expense,Mailchimp,,Tools & Subscription - G&A,23.37,19027689.11
06/07/2022,Expense,Mailchimp,Mike ross,Credit Card - Ramp,23.37,19027712.48
06/07/2022,Expense,Mailchimp,Mike ross,Credit Card - Ramp,23.37,19027735.85
06/07/2022,Expense,Mailchimp,,Tools & Subscription - G&A,23.37,19027759.22
06/07/2022,Expense,Mailchimp,Mike ross,Credit Card - Ramp,23.37,19027782.59
06/07/2022,Expense,Mailchimp,,Tools & Subscription - G&A,23.37,19027805.96
06/07/2022,Expense,Mailchimp,,Tools & Subscription - G&A,23.37,19027829.33
06/08/2022,Expense,Calendly,,Tools & Subscription - G&A,40,19027869.33
06/08/2022,Expense,Calendly,Harvey Spector,Credit Card - Ramp,40,19027909.33
06/08/2022,Expense,Calendly,Harvey Spector,Credit Card - Ramp,40,19027949.33
06/08/2022,Expense,Calendly,,Tools & Subscription - G&A,40,19027989.33
06/08/2022,Expense,Calendly,Harvey Spector,Credit Card - Ramp,40,19028029.33
06/08/2022,Expense,Calendly,,Tools & Subscription - G&A,40,19028069.33
06/08/2022,Expense,Calendly,,Tools & Subscription - G&A,40,19028109.33
06/09/2022,Expense,Pragmaticengineer.Com,,Tools & Subscription - G&A,15,19028124.33
06/09/2022,Expense,Pragmaticengineer.Com,,Tools & Subscription - G&A,15,19028139.33
06/09/2022,Expense,Usersnap,,Tools & Subscription - G&A,19,19028158.33
06/09/2022,Expense,Usersnap,Harris Jose,Credit Card - Ramp,19,19028177.33
06/09/2022,Expense,Pragmaticengineer.Com,Harvey Spector,Credit Card - Ramp,15,19028192.33
06/09/2022,Expense,Pragmaticengineer.Com,,Tools & Subscription - G&A,15,19028207.33
06/09/2022,Expense,Pragmaticengineer.Com,Harvey Spector,Credit Card - Ramp,15,19028222.33
06/09/2022,Expense,Heroku,Balapavan Tirumani,Credit Card - Ramp,30,19028252.33
06/09/2022,Expense,Heroku,Balapavan Tirumani,Tools & Subscription - S&M,30,19028282.33
06/09/2022,Expense,Heroku,Balapavan Tirumani,Tools & Subscription - S&M,30,19028312.33
06/09/2022,Expense,Usersnap,Harris Jose,Credit Card - Ramp,19,19028331.33
06/09/2022,Expense,Heroku,Balapavan Tirumani,Tools & Subscription - S&M,30,19028361.33
06/09/2022,Expense,Usersnap,Harris Jose,Credit Card - Ramp,19,19028380.33
06/09/2022,Expense,Usersnap,,Tools & Subscription - G&A,19,19028399.33
06/09/2022,Expense,Heroku,Balapavan Tirumani,Credit Card - Ramp,30,19028429.33
06/09/2022,Expense,Pragmaticengineer.Com,Harvey Spector,Credit Card - Ramp,15,19028444.33
06/09/2022,Expense,Usersnap,,Tools & Subscription - G&A,19,19028463.33
06/09/2022,Expense,Pragmaticengineer.Com,,Tools & Subscription - G&A,15,19028478.33
06/09/2022,Expense,Heroku,Balapavan Tirumani,Credit Card - Ramp,30,19028508.33
06/09/2022,Expense,Heroku,Balapavan Tirumani,Tools & Subscription - S&M,30,19028538.33
06/09/2022,Expense,Usersnap,,Tools & Subscription - G&A,19,19028557.33
06/10/2022,Expense,Pause Cafe,Harvey Spector,Meals & Entertainment,7,19028564.33
06/10/2022,Expense,Pause Cafe,Harvey Spector,Credit Card - Ramp,7,19028571.33
06/10/2022,Expense,Pause Cafe,Harvey Spector,Credit Card - Ramp,7,19028578.33
06/10/2022,Expense,Pause Cafe,Harvey Spector,Meals & Entertainment,7,19028585.33
06/10/2022,Expense,Pause Cafe,Harvey Spector,Meals & Entertainment,7,19028592.33
06/10/2022,Expense,Pause Cafe,Harvey Spector,Credit Card - Ramp,7,19028599.33
06/10/2022,Expense,Pause Cafe,Harvey Spector,Credit Card - Ramp,7,19028606.33
06/10/2022,Expense,Pause Cafe,Harvey Spector,Meals & Entertainment,7,19028613.33
06/12/2022,Expense,Intuit India,,Tools & Subscription - G&A,16.07,19028629.4
06/12/2022,Expense,Intuit India,Harvey Spector,Credit Card - Ramp,16.07,19028645.47
06/12/2022,Expense,Intuit India,Harvey Spector,Credit Card - Ramp,16.07,19028661.54
06/12/2022,Expense,The New York Times,,General business expenses:Memberships & subscriptions,1.43,19028662.97
06/12/2022,Expense,Intuit India,,Tools & Subscription - G&A,16.07,19028679.04
06/12/2022,Expense,Intuit India,,Tools & Subscription - G&A,16.07,19028695.11
06/12/2022,Expense,Intuit India,Harvey Spector,Credit Card - Ramp,16.07,19028711.18
06/12/2022,Expense,Intuit India,,Tools & Subscription - G&A,16.07,19028727.25
06/12/2022,Expense,The New York Times,Mike ross,Credit Card - Ramp,1.43,19028728.68
06/12/2022,Expense,The New York Times,,General business expenses:Memberships & subscriptions,1.43,19028730.11
06/12/2022,Expense,The New York Times,,General business expenses:Memberships & subscriptions,1.43,19028731.54
06/12/2022,Expense,The New York Times,,General business expenses:Memberships & subscriptions,1.43,19028732.97
06/12/2022,Expense,The New York Times,Mike ross,Credit Card - Ramp,1.43,19028734.4
06/12/2022,Expense,The New York Times,Mike ross,Credit Card - Ramp,1.43,19028735.83
06/12/2022,Expense,The New York Times,Mike ross,Credit Card - Ramp,1.43,19028737.26
06/13/2022,Expense,Figma,Mike ross,Credit Card - Ramp,235,19028972.26
06/13/2022,Expense,Figma,,Tools & Subscription - G&A,235,19029207.26
06/13/2022,Expense,Figma,Mike ross,Credit Card - Ramp,235,19029442.26
06/13/2022,Expense,Figma,Mike ross,Credit Card - Ramp,235,19029677.26
06/13/2022,Expense,Figma,,Tools & Subscription - G&A,235,19029912.26
06/13/2022,Expense,Figma,,Tools & Subscription - G&A,235,19030147.26
06/13/2022,Expense,Figma,,Tools & Subscription - G&A,235,19030382.26
06/14/2022,Deposit,,Interest Accrual,Interest Received,15.98,19030398.24
06/14/2022,Expense,LinkedIn,,Tools & Subscription - G&A,92.36,19030490.6
06/14/2022,Expense,Intuit,,Tools & Subscription - G&A,50,19030540.6
06/14/2022,Expense,LinkedIn,,Tools & Subscription - G&A,92.36,19030632.96
06/14/2022,Expense,LinkedIn,Harvey Spector,Credit Card - Ramp,92.36,19030725.32
06/14/2022,Deposit,,Interest Accrual,Interest Received,15.98,19030741.3
06/14/2022,Expense,Intuit,Harvey Spector,Credit Card - Ramp,50,19030791.3
06/14/2022,Expense,Intuit,Harvey Spector,Credit Card - Ramp,50,19030841.3
06/14/2022,Expense,LinkedIn,Harvey Spector,Credit Card - Ramp,92.36,19030933.66
06/14/2022,Deposit,,Interest Accrual,Savings (6977),15.98,19030949.64
06/14/2022,Expense,LinkedIn,Harvey Spector,Credit Card - Ramp,92.36,19031042
06/14/2022,Deposit,,Interest Accrual,Savings (6977),15.98,19031057.98
06/14/2022,Deposit,,Interest Accrual,Savings (6977),15.98,19031073.96
06/14/2022,Expense,LinkedIn,,Tools & Subscription - G&A,92.36,19031166.32
06/14/2022,Expense,LinkedIn,,Tools & Subscription - G&A,92.36,19031258.68
06/14/2022,Deposit,,Interest Accrual,Interest Received,15.98,19031274.66
06/14/2022,Deposit,,Interest Accrual,Interest Received,15.98,19031290.64
06/14/2022,Expense,Intuit,,Tools & Subscription - G&A,50,19031340.64
06/14/2022,Expense,Intuit,,Tools & Subscription - G&A,50,19031390.64
06/14/2022,Expense,Intuit,Harvey Spector,Credit Card - Ramp,50,19031440.64
06/14/2022,Expense,Intuit,,Tools & Subscription - G&A,50,19031490.64
06/16/2022,Expense,Zapier,,Tools & Subscription - G&A,29.99,19031520.63
06/16/2022,Expense,Zapier,Harvey Spector,Credit Card - Ramp,29.99,19031550.62
06/16/2022,Expense,Zapier,Harvey Spector,Credit Card - Ramp,29.99,19031580.61
06/16/2022,Expense,Zapier,Harvey Spector,Credit Card - Ramp,29.99,19031610.6
06/16/2022,Expense,Zapier,,Tools & Subscription - G&A,29.99,19031640.59
06/16/2022,Expense,Zapier,,Tools & Subscription - G&A,29.99,19031670.58
06/16/2022,Expense,Zapier,,Tools & Subscription - G&A,29.99,19031700.57
06/18/2022,Expense,LinkedIn,Mike ross,Credit Card - Ramp,158.75,19031859.32
06/18/2022,Expense,Superhuman,,Professional Service Charges,30,19031889.32
06/18/2022,Expense,Superhuman,,Professional Service Charges,30,19031919.32
06/18/2022,Expense,LinkedIn,,Tools & Subscription - G&A,158.75,19032078.07
06/18/2022,Expense,Superhuman,Harvey Spector,Credit Card - Ramp,30,19032108.07
06/18/2022,Expense,Superhuman,Harvey Spector,Credit Card - Ramp,30,19032138.07
06/18/2022,Expense,LinkedIn,,Tools & Subscription - G&A,158.75,19032296.82
06/18/2022,Expense,Superhuman,Harvey Spector,Credit Card - Ramp,30,19032326.82
06/18/2022,Expense,LinkedIn,,Tools & Subscription - G&A,158.75,19032485.57
06/18/2022,Expense,Superhuman,,Professional Service Charges,30,19032515.57
06/18/2022,Expense,Superhuman,Harvey Spector,Credit Card - Ramp,30,19032545.57
06/18/2022,Expense,LinkedIn,,Tools & Subscription - G&A,158.75,19032704.32
06/18/2022,Expense,LinkedIn,Mike ross,Credit Card - Ramp,158.75,19032863.07
06/18/2022,Expense,LinkedIn,Mike ross,Credit Card - Ramp,158.75,19033021.82
06/18/2022,Expense,Superhuman,,Professional Service Charges,30,19033051.82
06/21/2022,Expense,Sendinblue,,Tools & Subscription - G&A,1.69,19033053.51
06/21/2022,Expense,Sendinblue,,Tools & Subscription - G&A,1.69,19033055.2
06/21/2022,Credit Card Payment,,RAMP BUSINESS CO,Account1,-4676.78,19028378.42
06/21/2022,Credit Card Payment,,RAMP BUSINESS CO,Credit Card - Ramp,-4676.78,19023701.64
06/21/2022,Credit Card Payment,,RAMP BUSINESS CO,Account1,-4676.78,19019024.86
06/21/2022,Credit Card Payment,,RAMP BUSINESS CO,Credit Card - Ramp,-4676.78,19014348.08
06/21/2022,Credit Card Payment,,RAMP BUSINESS CO,Account1,-4676.78,19009671.3
06/21/2022,Expense,Sendinblue,Balapavan Tirumani,Credit Card - Ramp,1.69,19009672.99
06/21/2022,Expense,Sendinblue,,Tools & Subscription - G&A,1.69,19009674.68
06/21/2022,Expense,Sendinblue,Balapavan Tirumani,Credit Card - Ramp,1.69,19009676.37
06/21/2022,Credit Card Payment,,RAMP BUSINESS CO,Credit Card - Ramp,-4676.78,19004999.59
06/21/2022,Expense,Sendinblue,Balapavan Tirumani,Credit Card - Ramp,1.69,19005001.28
06/21/2022,Credit Card Payment,,RAMP BUSINESS CO,Account1,-4676.78,19000324.5
06/21/2022,Credit Card Payment,,RAMP BUSINESS CO,Credit Card - Ramp,-4676.78,18995647.72
06/21/2022,Expense,Sendinblue,,Tools & Subscription - G&A,1.69,18995649.41
06/22/2022,Expense,Automate,,Tools & Subscription - G&A,29,18995678.41
06/22/2022,Expense,Automate,Balapavan Tirumani,Credit Card - Ramp,29,18995707.41
06/22/2022,Expense,Dovetail,Harvey Spector,Credit Card - Ramp,36,18995743.41
06/22/2022,Expense,Automate,,Tools & Subscription - G&A,29,18995772.41
06/22/2022,Expense,Dovetail,,Tools & Subscription - G&A,36,18995808.41
06/22/2022,Expense,Dovetail,,Tools & Subscription - G&A,36,18995844.41
06/22/2022,Expense,Automate,Balapavan Tirumani,Credit Card - Ramp,29,18995873.41
06/22/2022,Expense,Dovetail,Harvey Spector,Credit Card - Ramp,36,18995909.41
06/22/2022,Expense,Automate,,Tools & Subscription - G&A,29,18995938.41
06/22/2022,Expense,Dovetail,Harvey Spector,Credit Card - Ramp,36,18995974.41
06/22/2022,Expense,Automate,Balapavan Tirumani,Credit Card - Ramp,29,18996003.41
06/22/2022,Expense,Dovetail,,Tools & Subscription - G&A,36,18996039.41
06/22/2022,Expense,Automate,,Tools & Subscription - G&A,29,18996068.41
06/22/2022,Expense,Dovetail,,Tools & Subscription - G&A,36,18996104.41
06/23/2022,Expense,Super,,Tools & Subscription - G&A,12,18996116.41
06/23/2022,Expense,Superhuman,,Professional Service Charges,30,18996146.41
06/23/2022,Expense,Superhuman,,Professional Service Charges,30,18996176.41
06/23/2022,Expense,Superhuman,Mike ross,Credit Card - Ramp,30,18996206.41
06/23/2022,Expense,Super,,Tools & Subscription - G&A,12,18996218.41
06/23/2022,Expense,Super,Harvey Spector,Credit Card - Ramp,12,18996230.41
06/23/2022,Expense,Superhuman,,Professional Service Charges,30,18996260.41
06/23/2022,Expense,Superhuman,Mike ross,Credit Card - Ramp,30,18996290.41
06/23/2022,Expense,Super,Harvey Spector,Credit Card - Ramp,12,18996302.41
06/23/2022,Expense,Superhuman,Mike ross,Credit Card - Ramp,30,18996332.41
06/23/2022,Expense,Superhuman,Mike ross,Credit Card - Ramp,30,18996362.41
06/23/2022,Expense,Superhuman,,Professional Service Charges,30,18996392.41
06/23/2022,Expense,Super,Harvey Spector,Credit Card - Ramp,12,18996404.41
06/23/2022,Expense,Super,,Tools & Subscription - G&A,12,18996416.41
06/23/2022,Expense,Super,,Tools & Subscription - G&A,12,18996428.41
06/24/2022,Expense,Paypal,Mike ross,Travelling Expenses,58.91,18996487.32
06/24/2022,Expense,Paypal,Mike ross,Credit Card - Ramp,58.91,18996546.23
06/24/2022,Expense,Paypal,Mike ross,Travelling Expenses,58.91,18996605.14
06/24/2022,Expense,Paypal,Mike ross,Travelling Expenses,58.91,18996664.05
06/24/2022,Expense,Paypal,Mike ross,Credit Card - Ramp,58.91,18996722.96
06/24/2022,Expense,Paypal,Mike ross,Credit Card - Ramp,58.91,18996781.87
06/24/2022,Expense,Paypal,Mike ross,Travelling Expenses,58.91,18996840.78
06/25/2022,Expense,Miro,Mike ross,Credit Card - Ramp,90,18996930.78
06/25/2022,Expense,Miro,Mike ross,Credit Card - Ramp,90,18997020.78
06/25/2022,Expense,Miro,,Tools & Subscription - G&A,90,18997110.78
06/25/2022,Expense,Miro,,Tools & Subscription - G&A,90,18997200.78
06/25/2022,Expense,Miro,Mike ross,Credit Card - Ramp,90,18997290.78
06/25/2022,Expense,Miro,,Tools & Subscription - G&A,90,18997380.78
06/25/2022,Expense,Miro,,Tools & Subscription - G&A,90,18997470.78
06/27/2022,Expense,Splitbee,,Tools & Subscription - G&A,16.52,18997487.3
06/27/2022,Expense,Splitbee,,Tools & Subscription - G&A,16.52,18997503.82
06/27/2022,Expense,Sentry,,Tools & Subscription - G&A,29,18997532.82
06/27/2022,Expense,Sendinblue,,Tools & Subscription - G&A,58.98,18997591.8
06/27/2022,Expense,Sendinblue,,Tools & Subscription - G&A,58.98,18997650.78
06/27/2022,Expense,Splitbee,,Tools & Subscription - G&A,16.52,18997667.3
06/27/2022,Expense,Sentry,Balapavan Tirumani,Credit Card - Ramp,29,18997696.3
06/27/2022,Expense,Splitbee,,Tools & Subscription - G&A,16.52,18997712.82
06/27/2022,Expense,Splitbee,Harris Jose,Credit Card - Ramp,16.52,18997729.34
06/27/2022,Expense,Splitbee,Harris Jose,Credit Card - Ramp,16.52,18997745.86
06/27/2022,Expense,Sendinblue,,Tools & Subscription - G&A,58.98,18997804.84
06/27/2022,Expense,Sentry,,Tools & Subscription - G&A,29,18997833.84
06/27/2022,Expense,Sentry,Balapavan Tirumani,Credit Card - Ramp,29,18997862.84
06/27/2022,Expense,Sentry,,Tools & Subscription - G&A,29,18997891.84
06/27/2022,Expense,Splitbee,Harris Jose,Credit Card - Ramp,16.52,18997908.36
06/27/2022,Expense,Sendinblue,Balapavan Tirumani,Credit Card - Ramp,58.98,18997967.34
06/27/2022,Expense,Sendinblue,Balapavan Tirumani,Credit Card - Ramp,58.98,18998026.32
06/27/2022,Expense,Sentry,,Tools & Subscription - G&A,29,18998055.32
06/27/2022,Expense,Sendinblue,Balapavan Tirumani,Credit Card - Ramp,58.98,18998114.3
06/27/2022,Expense,Sentry,Balapavan Tirumani,Credit Card - Ramp,29,18998143.3
06/27/2022,Expense,Sendinblue,,Tools & Subscription - G&A,58.98,18998202.28
06/29/2022,Expense,Calendly,Harvey Spector,Credit Card - Ramp,12.26,18998214.54
06/29/2022,Expense,Netlify,Balapavan Tirumani,Credit Card - Ramp,7,18998221.54
06/29/2022,Expense,Calendly,,Tools & Subscription - G&A,12.26,18998233.8
06/29/2022,Expense,Netlify,,Tools & Subscription - G&A,7,18998240.8
06/29/2022,Expense,Calendly,Harvey Spector,Credit Card - Ramp,12.26,18998253.06
06/29/2022,Expense,Calendly,Harvey Spector,Credit Card - Ramp,12.26,18998265.32
06/29/2022,Expense,Calendly,,Tools & Subscription - G&A,12.26,18998277.58
06/29/2022,Expense,Calendly,,Tools & Subscription - G&A,12.26,18998289.84
06/29/2022,Expense,Netlify,,Tools & Subscription - G&A,7,18998296.84
06/29/2022,Expense,Calendly,,Tools & Subscription - G&A,12.26,18998309.1
06/29/2022,Expense,Netlify,,Tools & Subscription - G&A,7,18998316.1
06/29/2022,Expense,Netlify,,Tools & Subscription - G&A,7,18998323.1
06/29/2022,Expense,Netlify,Balapavan Tirumani,Credit Card - Ramp,7,18998330.1
06/29/2022,Expense,Netlify,Balapavan Tirumani,Credit Card - Ramp,7,18998337.1
06/30/2022,Bill,Big Company ,,Outsources Services - India,27432.95,19025770.05
06/30/2022,Expense,Adobe,Mike ross,Credit Card - Ramp,15.19,19025785.24
06/30/2022,Bill,EntityA,,outsources Services - Australia,231011.05,19256796.29
06/30/2022,Bill,EntityA,FY 2022 expenses incurred plus 10% mark up per the MSA,Account2,915.77,19257712.06
06/30/2022,Expense,Meggykenny Pty Ltd,Mike ross,Credit Card - Ramp,77.54,19257789.6
06/30/2022,Bill,Big Company ,"Service Expenses for the month of June 2022 
INR 2165557 @ 78.94",Accounts Payable (A/P),27432.95,19285222.55
06/30/2022,Expense,Meggykenny Pty Ltd,Mike ross,Meals & Entertainment,77.54,19285300.09
06/30/2022,Expense,Meggykenny Pty Ltd,Mike ross,Meals & Entertainment,77.54,19285377.63
06/30/2022,Bill,EntityA,FY 2022 expenses incurred Plus 10% mark up per the MSA,Account2,231011.05,19516388.68
06/30/2022,Expense,Zapier,,Tools & Subscription - G&A,29.99,19516418.67
06/30/2022,Bill,EntityA,,outsources Services - Australia,915.77,19517334.44
06/30/2022,Expense,Adobe,Mike ross,Credit Card - Ramp,15.19,19517349.63
06/30/2022,Expense,Zapier,,Tools & Subscription - G&A,29.99,19517379.62
06/30/2022,Expense,Zapier,Chad Blumenthal,Credit Card - Ramp,29.99,19517409.61
06/30/2022,Expense,Meggykenny Pty Ltd,Mike ross,Meals & Entertainment,77.54,19517487.15
06/30/2022,Bill,EntityA,,outsources Services - Australia,915.77,19518402.92
06/30/2022,Bill,Big Company ,"Service Expenses for the month of June 2022 
INR 2165557 @ 78.94",Accounts Payable (A/P),27432.95,19545835.87
06/30/2022,Bill,EntityA,,outsources Services - Australia,231011.05,19776846.92
06/30/2022,Expense,Zapier,Chad Blumenthal,Credit Card - Ramp,29.99,19776876.91
06/30/2022,Bill,Big Company ,"Service Expenses for the month of June 2022 
INR 2165557 @ 78.94",Accounts Payable (A/P),27432.95,19804309.86
06/30/2022,Expense,Adobe,,Tools & Subscription - S&M,15.19,19804325.05
06/30/2022,Bill,EntityA,,outsources Services - Australia,915.77,19805240.82
06/30/2022,Expense,Adobe,,Tools & Subscription - S&M,15.19,19805256.01
06/30/2022,Expense,Meggykenny Pty Ltd,Mike ross,Credit Card - Ramp,77.54,19805333.55
06/30/2022,Expense,Zapier,Chad Blumenthal,Credit Card - Ramp,29.99,19805363.54
06/30/2022,Bill,Big Company ,"Service Expenses for the month of June 2022 
INR 2165557 @ 78.94",Accounts Payable (A/P),27432.95,19832796.49
06/30/2022,Bill,EntityA,FY 2022 expenses incurred plus 10% mark up per the MSA,Account2,915.77,19833712.26
06/30/2022,Bill,EntityA,FY 2022 expenses incurred Plus 10% mark up per the MSA,Account2,231011.05,20064723.31
06/30/2022,Bill,EntityA,FY 2022 expenses incurred plus 10% mark up per the MSA,Account2,915.77,20065639.08
06/30/2022,Bill,EntityA,FY 2022 expenses incurred Plus 10% mark up per the MSA,Account2,231011.05,20296650.13
06/30/2022,Bill,Big Company ,,Outsources Services - India,27432.95,20324083.08
06/30/2022,Expense,Meggykenny Pty Ltd,Mike ross,Meals & Entertainment,77.54,20324160.62
06/30/2022,Expense,Zapier,,Tools & Subscription - G&A,29.99,20324190.61
06/30/2022,Expense,Adobe,Mike ross,Credit Card - Ramp,15.19,20324205.8
06/30/2022,Expense,Zapier,,Tools & Subscription - G&A,29.99,20324235.79
06/30/2022,Expense,Meggykenny Pty Ltd,Mike ross,Credit Card - Ramp,77.54,20324313.33
06/30/2022,Expense,Adobe,,Tools & Subscription - S&M,15.19,20324328.52
06/30/2022,Bill,EntityA,FY 2022 expenses incurred plus 10% mark up per the MSA,Account2,915.77,20325244.29
06/30/2022,Bill,Big Company ,,Outsources Services - India,27432.95,20352677.24
06/30/2022,Expense,Adobe,,Tools & Subscription - S&M,15.19,20352692.43
06/30/2022,Expense,Meggykenny Pty Ltd,Mike ross,Credit Card - Ramp,77.54,20352769.97
06/30/2022,Bill,EntityA,,outsources Services - Australia,231011.05,20583781.02
06/30/2022,Bill,Big Company ,,Outsources Services - India,27432.95,20611213.97
06/30/2022,Bill,EntityA,,outsources Services - Australia,915.77,20612129.74
06/30/2022,Bill,EntityA,FY 2022 expenses incurred Plus 10% mark up per the MSA,Account2,231011.05,20843140.79
06/30/2022,Bill,EntityA,,outsources Services - Australia,231011.05,21074151.84
07/01/2022,Expense,Gusto,GUSTO,Account1,-0.11,21074151.73
07/01/2022,Expense,Google G Suite,Mike ross,Credit Card - Ramp,98.5,21074250.23
07/01/2022,Expense,Income Capitals ,Income Capitals ,Account1,8264,21082514.23
07/01/2022,Deposit,Gusto,GUSTO,Accounts Payable (A/P),0.15,21082514.38
07/01/2022,Deposit,,SQUARE PEG 2022 PTY LTD ATF SQUARE,Account1,3550000,24632514.38
07/01/2022,Expense,Slack,Mike ross,Credit Card - Ramp,18.63,24632533.01
07/01/2022,Expense,Gusto,GUSTO,Accounts Payable (A/P),-0.11,24632532.9
07/01/2022,Deposit,,SQUARE PEG 2022 PTY LTD ATF SQUARE,Series Seed Preferred Share:Square Peg - Investment,3550000,28182532.9
07/01/2022,Expense,Google G Suite,Mike ross,Credit Card - Ramp,98.5,28182631.4
07/01/2022,Deposit,Gusto,GUSTO,Accounts Payable (A/P),0.11,28182631.51
07/01/2022,Deposit,Gusto,GUSTO,Accounts Payable (A/P),0.15,28182631.66
07/01/2022,Expense,Slack,,Tools & Subscription - G&A,18.63,28182650.29
07/01/2022,Expense,Google G Suite,,Tools & Subscription - G&A,98.5,28182748.79
07/01/2022,Deposit,Gusto,GUSTO,Account1,0.11,28182748.9
07/01/2022,Expense,Income Capitals ,Income Capitals ,Account1,8264,28191012.9
07/01/2022,Expense,Gusto,GUSTO,Account1,-0.11,28191012.79
07/01/2022,Deposit,Gusto,GUSTO,Account1,0.15,28191012.94
07/01/2022,Deposit,Gusto,GUSTO,Account1,0.11,28191013.05
07/01/2022,Expense,Income Capitals ,Income Capitals ,Contract labor,-8264,28182749.05
07/01/2022,Deposit,Gusto,GUSTO,Account1,0.15,28182749.2
07/01/2022,Expense,Slack,,Tools & Subscription - G&A,18.63,28182767.83
07/01/2022,Deposit,Gusto,GUSTO,Account1,0.11,28182767.94
07/01/2022,Expense,Google G Suite,,Tools & Subscription - G&A,98.5,28182866.44
07/01/2022,Deposit,Gusto,GUSTO,Account1,0.15,28182866.59
07/01/2022,Deposit,,SQUARE PEG 2022 PTY LTD ATF SQUARE,Account1,3550000,31732866.59
07/01/2022,Expense,Slack,,Tools & Subscription - G&A,18.63,31732885.22
07/01/2022,Expense,Google G Suite,,Tools & Subscription - G&A,98.5,31732983.72
07/01/2022,Expense,Google G Suite,Mike ross,Credit Card - Ramp,98.5,31733082.22
07/01/2022,Expense,Slack,,Tools & Subscription - G&A,18.63,31733100.85
07/01/2022,Deposit,Gusto,GUSTO,Accounts Payable (A/P),0.11,31733100.96
07/01/2022,Deposit,Gusto,GUSTO,Accounts Payable (A/P),0.15,31733101.11
07/01/2022,Expense,Slack,Mike ross,Credit Card - Ramp,18.63,31733119.74
07/01/2022,Deposit,,SQUARE PEG 2022 PTY LTD ATF SQUARE,Series Seed Preferred Share:Square Peg - Investment,3550000,35283119.74
07/01/2022,Deposit,Gusto,GUSTO,Account1,0.15,35283119.89
07/01/2022,Expense,Gusto,GUSTO,Account1,-0.11,35283119.78
07/01/2022,Expense,Google G Suite,,Tools & Subscription - G&A,98.5,35283218.28
07/01/2022,Deposit,,SQUARE PEG 2022 PTY LTD ATF SQUARE,Account1,3550000,38833218.28
07/01/2022,Expense,Income Capitals ,Income Capitals ,Account1,8264,38841482.28
07/01/2022,Deposit,,SQUARE PEG 2022 PTY LTD ATF SQUARE,Series Seed Preferred Share:Square Peg - Investment,3550000,42391482.28
07/01/2022,Expense,Gusto,GUSTO,Accounts Payable (A/P),-0.11,42391482.17
07/01/2022,Expense,Gusto,GUSTO,Accounts Payable (A/P),-0.11,42391482.06
07/01/2022,Deposit,Gusto,GUSTO,Accounts Payable (A/P),0.15,42391482.21
07/01/2022,Expense,Gusto,GUSTO,Account1,-0.11,42391482.1
07/01/2022,Expense,Slack,Mike ross,Credit Card - Ramp,18.63,42391500.73
07/01/2022,Expense,Income Capitals ,Income Capitals ,Contract labor,-8264,42383236.73
07/01/2022,Expense,Gusto,GUSTO,Accounts Payable (A/P),-0.11,42383236.62
07/01/2022,Deposit,Gusto,GUSTO,Accounts Payable (A/P),0.11,42383236.73
07/01/2022,Expense,Income Capitals ,Income Capitals ,Contract labor,-8264,42374972.73
07/01/2022,Deposit,,SQUARE PEG 2022 PTY LTD ATF SQUARE,Series Seed Preferred Share:Square Peg - Investment,3550000,45924972.73
07/01/2022,Deposit,Gusto,GUSTO,Account1,0.11,45924972.84
07/01/2022,Deposit,,SQUARE PEG 2022 PTY LTD ATF SQUARE,Account1,3550000,49474972.84
07/01/2022,Expense,Income Capitals ,Income Capitals ,Account1,8264,49483236.84
07/01/2022,Deposit,Gusto,GUSTO,Accounts Payable (A/P),0.11,49483236.95
07/01/2022,Expense,Income Capitals ,Income Capitals ,Contract labor,-8264,49474972.95
07/02/2022,Expense,Render,,Tools & Subscription - G&A,3.82,49474976.77
07/02/2022,Expense,Render,Balapavan Tirumani,Credit Card - Ramp,3.82,49474980.59
07/02/2022,Expense,Render,Balapavan Tirumani,Credit Card - Ramp,3.82,49474984.41
07/02/2022,Expense,Emirates,Mike ross,Credit Card - Ramp,1301.84,49476286.25
07/02/2022,Expense,Emirates,Mike ross,Credit Card - Ramp,1301.84,49477588.09
07/02/2022,Expense,Render,,Tools & Subscription - G&A,3.82,49477591.91
07/02/2022,Expense,Emirates,,Travel:Airfare,1301.84,49478893.75
07/02/2022,Expense,Render,,Tools & Subscription - G&A,3.82,49478897.57
07/02/2022,Expense,Emirates,,Travel:Airfare,1301.84,49480199.41
07/02/2022,Expense,Emirates,,Travel:Airfare,1301.84,49481501.25
07/02/2022,Expense,Emirates,Mike ross,Credit Card - Ramp,1301.84,49482803.09
07/02/2022,Expense,Render,,Tools & Subscription - G&A,3.82,49482806.91
07/02/2022,Expense,Emirates,,Travel:Airfare,1301.84,49484108.75
07/02/2022,Expense,Render,Balapavan Tirumani,Credit Card - Ramp,3.82,49484112.57
07/03/2022,Expense,Mazurek Co,Harvey Spector,Credit Card - Ramp,29.95,49484142.52
07/03/2022,Expense,Mazurek Co,,Tools & Subscription - G&A,29.95,49484172.47
07/03/2022,Expense,Mazurek Co,,Tools & Subscription - G&A,29.95,49484202.42
07/03/2022,Expense,Mazurek Co,,Tools & Subscription - G&A,29.95,49484232.37
07/03/2022,Expense,Mazurek Co,Harvey Spector,Credit Card - Ramp,29.95,49484262.32
07/03/2022,Expense,Mazurek Co,,Tools & Subscription - G&A,29.95,49484292.27
07/03/2022,Expense,Mazurek Co,Harvey Spector,Credit Card - Ramp,29.95,49484322.22
07/04/2022,Expense,HCC Medical Insurance Services,Harvey Spector,Credit Card - Ramp,48,49484370.22
07/04/2022,Deposit,,Interest Accrual,Savings (6977),9.11,49484379.33
07/04/2022,Deposit,,Interest Accrual,Interest Received,9.11,49484388.44
07/04/2022,Expense,HCC Medical Insurance Services,,Insurance,48,49484436.44
07/04/2022,Deposit,,Interest Accrual,Interest Received,9.11,49484445.55
07/04/2022,Deposit,,Interest Accrual,Savings (6977),9.11,49484454.66
07/04/2022,Deposit,,Interest Accrual,Savings (6977),9.11,49484463.77
07/04/2022,Expense,HCC Medical Insurance Services,Harvey Spector,Credit Card - Ramp,48,49484511.77
07/04/2022,Expense,HCC Medical Insurance Services,,Insurance,48,49484559.77
07/04/2022,Expense,HCC Medical Insurance Services,Harvey Spector,Credit Card - Ramp,48,49484607.77
07/04/2022,Deposit,,Interest Accrual,Interest Received,9.11,49484616.88
07/04/2022,Expense,HCC Medical Insurance Services,,Insurance,48,49484664.88
07/04/2022,Expense,HCC Medical Insurance Services,Harvey Spector,Credit Card - Ramp,48,49484712.88
07/04/2022,Deposit,,Interest Accrual,Interest Received,9.11,49484721.99
07/04/2022,Expense,HCC Medical Insurance Services,,Insurance,48,49484769.99
07/05/2022,Transfer,,PaymentServiceB Savings **6977,Savings (6977),-3500000,45984769.99
07/05/2022,Expense,Gusto,GUSTO,Accounts Payable (A/P),-0.15,45984769.84
07/05/2022,Transfer,,PaymentServiceB Savings **6977,Savings (6977),-3500000,42484769.84
07/05/2022,Expense,Gusto,GUSTO,Accounts Payable (A/P),-0.15,42484769.69
07/05/2022,Expense,Gusto,GUSTO,Account1,-0.15,42484769.54
07/05/2022,Transfer,,PaymentServiceB Savings **6977,Savings (6977),-3500000,38984769.54
07/05/2022,Transfer,,PaymentServiceB Savings **6977,Account1,3500000,42484769.54
07/05/2022,Expense,Gusto,GUSTO,Account1,-0.15,42484769.39
07/05/2022,Transfer,,PaymentServiceB Savings **6977,Savings (6977),-3500000,38984769.39
07/05/2022,Expense,Gusto,GUSTO,Account1,-0.15,38984769.24
07/05/2022,Transfer,,PaymentServiceB Savings **6977,Account1,3500000,42484769.24
07/05/2022,Expense,Gusto,GUSTO,Accounts Payable (A/P),-0.15,42484769.09
07/05/2022,Transfer,,PaymentServiceB Savings **6977,Account1,3500000,45984769.09
07/05/2022,Expense,Gusto,GUSTO,Account1,-0.15,45984768.94
07/05/2022,Transfer,,PaymentServiceB Savings **6977,Account1,3500000,49484768.94
07/05/2022,Expense,Gusto,GUSTO,Accounts Payable (A/P),-0.15,49484768.79
07/06/2022,Expense,Reuben Hills,Mike ross,Meals & Entertainment,52,49484820.79
07/06/2022,Expense,Jane Surry Hills Restaurant,Mike ross,Credit Card - Ramp,276.31,49485097.1
07/06/2022,Expense,Reuben Hills,Mike ross,Credit Card - Ramp,52,49485149.1
07/06/2022,Expense,Jane Surry Hills Restaurant,,Meals & Entertainment,276.31,49485425.41
07/06/2022,Expense,Jane Surry Hills Restaurant,,Meals & Entertainment,276.31,49485701.72
07/06/2022,Expense,Reuben Hills,Mike ross,Meals & Entertainment,52,49485753.72
07/06/2022,Expense,Jane Surry Hills Restaurant,,Meals & Entertainment,276.31,49486030.03
07/06/2022,Expense,Reuben Hills,Mike ross,Meals & Entertainment,52,49486082.03
07/06/2022,Expense,Jane Surry Hills Restaurant,Mike ross,Credit Card - Ramp,276.31,49486358.34
07/06/2022,Deposit,BIG VC Investors,BIG VC Investors.,Series Seed Preferred Share:Accel -Investment,1050000,50536358.34
07/06/2022,Expense,Reuben Hills,Mike ross,Credit Card - Ramp,52,50536410.34
07/06/2022,Deposit,BIG VC Investors,BIG VC Investors.,Account1,1050000,51586410.34
07/06/2022,Expense,Jane Surry Hills Restaurant,Mike ross,Credit Card - Ramp,276.31,51586686.65
07/06/2022,Deposit,BIG VC Investors,BIG VC Investors.,Series Seed Preferred Share:Accel -Investment,1050000,52636686.65
07/06/2022,Deposit,BIG VC Investors,BIG VC Investors.,Account1,1050000,53686686.65
07/06/2022,Deposit,BIG VC Investors,BIG VC Investors.,Series Seed Preferred Share:Accel -Investment,1050000,54736686.65
07/06/2022,Deposit,BIG VC Investors,BIG VC Investors.,Account1,1050000,55786686.65
07/06/2022,Expense,Jane Surry Hills Restaurant,,Meals & Entertainment,276.31,55786962.96
07/06/2022,Deposit,BIG VC Investors,BIG VC Investors.,Account1,1050000,56836962.96
07/06/2022,Expense,Reuben Hills,Mike ross,Credit Card - Ramp,52,56837014.96
07/06/2022,Expense,Jane Surry Hills Restaurant,Mike ross,Credit Card - Ramp,276.31,56837291.27
07/06/2022,Deposit,BIG VC Investors,BIG VC Investors.,Series Seed Preferred Share:Accel -Investment,1050000,57887291.27
07/06/2022,Expense,Reuben Hills,Mike ross,Meals & Entertainment,52,57887343.27
07/06/2022,Expense,Reuben Hills,Mike ross,Credit Card - Ramp,52,57887395.27
07/07/2022,Expense,Mailchimp,Mike ross,Credit Card - Ramp,22.93,57887418.2
07/07/2022,Expense,Mailchimp,,Tools & Subscription - G&A,22.93,57887441.13
07/07/2022,Expense,Mailchimp,,Tools & Subscription - G&A,22.93,57887464.06
07/07/2022,Expense,Mailchimp,Mike ross,Credit Card - Ramp,22.93,57887486.99
07/07/2022,Expense,Mailchimp,Mike ross,Credit Card - Ramp,22.93,57887509.92
07/07/2022,Expense,Mailchimp,,Tools & Subscription - G&A,22.93,57887532.85
07/07/2022,Expense,Mailchimp,,Tools & Subscription - G&A,22.93,57887555.78
07/08/2022,Expense,Calendly,,Tools & Subscription - G&A,80,57887635.78
07/08/2022,Expense,Calendly,Harvey Spector,Credit Card - Ramp,80,57887715.78
07/08/2022,Expense,Calendly,,Tools & Subscription - G&A,80,57887795.78
07/08/2022,Expense,The Crabbe Hole,,Meals & Entertainment,17.13,57887812.91
07/08/2022,Expense,The Crabbe Hole,Mike ross,Credit Card - Ramp,17.13,57887830.04
07/08/2022,Expense,Calendly,,Tools & Subscription - G&A,80,57887910.04
07/08/2022,Expense,The Crabbe Hole,Mike ross,Credit Card - Ramp,17.13,57887927.17
07/08/2022,Expense,The Crabbe Hole,,Meals & Entertainment,17.13,57887944.3
07/08/2022,Expense,The Crabbe Hole,,Meals & Entertainment,17.13,57887961.43
07/08/2022,Expense,Calendly,Harvey Spector,Credit Card - Ramp,80,57888041.43
07/08/2022,Expense,The Crabbe Hole,Mike ross,Credit Card - Ramp,17.13,57888058.56
07/08/2022,Expense,The Crabbe Hole,Mike ross,Credit Card - Ramp,17.13,57888075.69
07/08/2022,Expense,Calendly,Harvey Spector,Credit Card - Ramp,80,57888155.69
07/08/2022,Expense,Calendly,,Tools & Subscription - G&A,80,57888235.69
07/08/2022,Expense,The Crabbe Hole,,Meals & Entertainment,17.13,57888252.82
07/09/2022,Expense,Usersnap,Harris Jose,Credit Card - Ramp,19,57888271.82
07/09/2022,Expense,Usersnap,Harris Jose,Credit Card - Ramp,19,57888290.82
07/09/2022,Expense,Pragmaticengineer.Com,,Tools & Subscription - G&A,15,57888305.82
07/09/2022,Expense,Usersnap,,Tools & Subscription - G&A,19,57888324.82
07/09/2022,Expense,Usersnap,Harris Jose,Credit Card - Ramp,19,57888343.82
07/09/2022,Expense,Pragmaticengineer.Com,Harvey Spector,Credit Card - Ramp,15,57888358.82
07/09/2022,Expense,Usersnap,,Tools & Subscription - G&A,19,57888377.82
07/09/2022,Expense,Pragmaticengineer.Com,Harvey Spector,Credit Card - Ramp,15,57888392.82
07/09/2022,Expense,Pragmaticengineer.Com,,Tools & Subscription - G&A,15,57888407.82
07/09/2022,Expense,Pragmaticengineer.Com,,Tools & Subscription - G&A,15,57888422.82
07/09/2022,Expense,Usersnap,,Tools & Subscription - G&A,19,57888441.82
07/09/2022,Expense,Pragmaticengineer.Com,,Tools & Subscription - G&A,15,57888456.82
07/09/2022,Expense,Usersnap,,Tools & Subscription - G&A,19,57888475.82
07/09/2022,Expense,Pragmaticengineer.Com,Harvey Spector,Credit Card - Ramp,15,57888490.82
07/10/2022,Expense,The New York Times,,General business expenses:Memberships & subscriptions,1.38,57888492.2
07/10/2022,Expense,The New York Times,Mike ross,Credit Card - Ramp,1.38,57888493.58
07/10/2022,Expense,The New York Times,Mike ross,Credit Card - Ramp,1.38,57888494.96
07/10/2022,Expense,The New York Times,Mike ross,Credit Card - Ramp,1.38,57888496.34
07/10/2022,Expense,Pause Cafe,Harvey Spector,Credit Card - Ramp,7,57888503.34
07/10/2022,Expense,Pause Cafe,Harvey Spector,Meals & Entertainment,7,57888510.34
07/10/2022,Expense,Pause Cafe,Harvey Spector,Credit Card - Ramp,7,57888517.34
07/10/2022,Expense,Pause Cafe,Harvey Spector,Meals & Entertainment,7,57888524.34
07/10/2022,Expense,Pause Cafe,Harvey Spector,Meals & Entertainment,7,57888531.34
07/10/2022,Expense,The New York Times,,General business expenses:Memberships & subscriptions,1.38,57888532.72
07/10/2022,Expense,Pause Cafe,Harvey Spector,Credit Card - Ramp,7,57888539.72
07/10/2022,Expense,The New York Times,Mike ross,Credit Card - Ramp,1.38,57888541.1
07/10/2022,Expense,The New York Times,,General business expenses:Memberships & subscriptions,1.38,57888542.48
07/10/2022,Expense,The New York Times,,General business expenses:Memberships & subscriptions,1.38,57888543.86
07/10/2022,Expense,Pause Cafe,Harvey Spector,Meals & Entertainment,7,57888550.86
07/10/2022,Expense,Pause Cafe,Harvey Spector,Credit Card - Ramp,7,57888557.86
07/12/2022,Transfer,,PaymentServiceB Savings **6977,Account1,800000,58688557.86
07/12/2022,Expense,Heroku,Balapavan Tirumani,Credit Card - Ramp,30,58688587.86
07/12/2022,Transfer,,PaymentServiceB Savings **6977,Savings (6977),-800000,57888587.86
07/12/2022,Expense,Heroku,Balapavan Tirumani,Tools & Subscription - S&M,30,57888617.86
07/12/2022,Transfer,,PaymentServiceB Savings **6977,Savings (6977),-800000,57088617.86
07/12/2022,Transfer,,PaymentServiceB Savings **6977,Account1,800000,57888617.86
07/12/2022,Expense,Heroku,Balapavan Tirumani,Tools & Subscription - S&M,30,57888647.86
07/12/2022,Expense,Heroku,Balapavan Tirumani,Tools & Subscription - S&M,30,57888677.86
07/12/2022,Transfer,,PaymentServiceB Savings **6977,Account1,800000,58688677.86
07/12/2022,Transfer,,PaymentServiceB Savings **6977,Savings (6977),-800000,57888677.86
07/12/2022,Expense,Heroku,Balapavan Tirumani,Credit Card - Ramp,30,57888707.86
07/12/2022,Transfer,,PaymentServiceB Savings **6977,Savings (6977),-800000,57088707.86
07/12/2022,Expense,Heroku,Balapavan Tirumani,Tools & Subscription - S&M,30,57088737.86
07/12/2022,Expense,Heroku,Balapavan Tirumani,Credit Card - Ramp,30,57088767.86
07/12/2022,Transfer,,PaymentServiceB Savings **6977,Account1,800000,57888767.86
07/13/2022,Expense,Figma,Mike ross,Credit Card - Ramp,270,57889037.86
07/13/2022,Expense,Big Company ,Big Company ,Accounts Payable (A/P),-100000,57789037.86
07/13/2022,Expense,Intercom,,Tools & Subscription - G&A,138,57789175.86
07/13/2022,Expense,Figma,,Tools & Subscription - G&A,1008,57790183.86
07/13/2022,Expense,Big Company ,Big Company ,Account1,-100000,57690183.86
07/13/2022,Expense,Big Company ,Big Company ,Accounts Payable (A/P),-100000,57590183.86
07/13/2022,Expense,Intercom,,Tools & Subscription - G&A,138,57590321.86
07/13/2022,Expense,Figma,,Tools & Subscription - G&A,1008,57591329.86
07/13/2022,Expense,Figma,,Tools & Subscription - G&A,270,57591599.86
07/13/2022,Expense,Big Company ,Big Company ,Account1,-100000,57491599.86
07/13/2022,Expense,Figma,,Tools & Subscription - G&A,270,57491869.86
07/13/2022,Expense,Intercom,,Tools & Subscription - G&A,138,57492007.86
07/13/2022,Expense,Figma,,Tools & Subscription - G&A,270,57492277.86
07/13/2022,Expense,Figma,,Tools & Subscription - G&A,1008,57493285.86
07/13/2022,Expense,Figma,,Tools & Subscription - G&A,270,57493555.86
07/13/2022,Expense,Big Company ,Big Company ,Accounts Payable (A/P),-100000,57393555.86
07/13/2022,Expense,Big Company ,Big Company ,Account1,-100000,57293555.86
07/13/2022,Expense,Big Company ,Big Company ,Accounts Payable (A/P),-100000,57193555.86
07/13/2022,Expense,Figma,,Tools & Subscription - G&A,1008,57194563.86
07/13/2022,Expense,Figma,Mike ross,Credit Card - Ramp,270,57194833.86
07/13/2022,Expense,Big Company ,Big Company ,Account1,-100000,57094833.86
07/13/2022,Expense,Intercom,Balapavan Tirumani,Credit Card - Ramp,138,57094971.86
07/13/2022,Expense,Figma,Mike ross,Credit Card - Ramp,1008,57095979.86
07/13/2022,Expense,Figma,Mike ross,Credit Card - Ramp,1008,57096987.86
07/13/2022,Expense,Intercom,Balapavan Tirumani,Credit Card - Ramp,138,57097125.86
07/13/2022,Expense,Figma,Mike ross,Credit Card - Ramp,1008,57098133.86
07/13/2022,Expense,Figma,Mike ross,Credit Card - Ramp,270,57098403.86
07/13/2022,Expense,Intercom,,Tools & Subscription - G&A,138,57098541.86
07/13/2022,Expense,Intercom,Balapavan Tirumani,Credit Card - Ramp,138,57098679.86
07/14/2022,Expense,LinkedIn,,Tools & Subscription - G&A,90.35,57098770.21
07/14/2022,Expense,Intuit,,Tools & Subscription - G&A,55,57098825.21
07/14/2022,Expense,LinkedIn,,Tools & Subscription - G&A,90.35,57098915.56
07/14/2022,Expense,Intuit,,Tools & Subscription - G&A,55,57098970.56
07/14/2022,Expense,Intuit,,Tools & Subscription - G&A,55,57099025.56
07/14/2022,Expense,LinkedIn,,Tools & Subscription - G&A,90.35,57099115.91
07/14/2022,Expense,Intuit,Harvey Spector,Credit Card - Ramp,55,57099170.91
07/14/2022,Expense,LinkedIn,Harvey Spector,Credit Card - Ramp,90.35,57099261.26
07/14/2022,Expense,Intuit,Harvey Spector,Credit Card - Ramp,55,57099316.26
07/14/2022,Expense,Intuit,,Tools & Subscription - G&A,55,57099371.26
07/14/2022,Expense,LinkedIn,Harvey Spector,Credit Card - Ramp,90.35,57099461.61
07/14/2022,Expense,LinkedIn,,Tools & Subscription - G&A,90.35,57099551.96
07/14/2022,Expense,Intuit,Harvey Spector,Credit Card - Ramp,55,57099606.96
07/14/2022,Expense,LinkedIn,Harvey Spector,Credit Card - Ramp,90.35,57099697.31
07/16/2022,Expense,Zapier,,Tools & Subscription - G&A,29.99,57099727.3
07/16/2022,Expense,Intuit India,,Tools & Subscription - G&A,15.68,57099742.98
07/16/2022,Expense,Zapier,Harvey Spector,Credit Card - Ramp,29.99,57099772.97
07/16/2022,Expense,Zapier,Harvey Spector,Credit Card - Ramp,29.99,57099802.96
07/16/2022,Expense,Intuit India,Harvey Spector,Credit Card - Ramp,15.68,57099818.64
07/16/2022,Expense,Zapier,,Tools & Subscription - G&A,29.99,57099848.63
07/16/2022,Expense,Zapier,,Tools & Subscription - G&A,29.99,57099878.62
07/16/2022,Expense,Intuit India,Harvey Spector,Credit Card - Ramp,15.68,57099894.3
07/16/2022,Expense,Zapier,Harvey Spector,Credit Card - Ramp,29.99,57099924.29
07/16/2022,Expense,Intuit India,Harvey Spector,Credit Card - Ramp,15.68,57099939.97
07/16/2022,Expense,Intuit India,,Tools & Subscription - G&A,15.68,57099955.65
07/16/2022,Expense,Zapier,,Tools & Subscription - G&A,29.99,57099985.64
07/16/2022,Expense,Intuit India,,Tools & Subscription - G&A,15.68,57100001.32
07/16/2022,Expense,Intuit India,,Tools & Subscription - G&A,15.68,57100017
07/18/2022,Expense,Superhuman,Harvey Spector,Credit Card - Ramp,30,57100047
07/18/2022,Expense,Superhuman,,Professional Service Charges,30,57100077
07/18/2022,Expense,LinkedIn,,Tools & Subscription - G&A,155.58,57100232.58
07/18/2022,Expense,Superhuman,,Professional Service Charges,30,57100262.58
07/18/2022,Expense,LinkedIn,Mike ross,Credit Card - Ramp,155.58,57100418.16
07/18/2022,Expense,LinkedIn,,Tools & Subscription - G&A,155.58,57100573.74
07/18/2022,Expense,LinkedIn,,Tools & Subscription - G&A,155.58,57100729.32
07/18/2022,Expense,Superhuman,Harvey Spector,Credit Card - Ramp,30,57100759.32
07/18/2022,Expense,Superhuman,Harvey Spector,Credit Card - Ramp,30,57100789.32
07/18/2022,Expense,Superhuman,,Professional Service Charges,30,57100819.32
07/18/2022,Expense,LinkedIn,,Tools & Subscription - G&A,155.58,57100974.9
07/18/2022,Expense,Superhuman,,Professional Service Charges,30,57101004.9
07/18/2022,Expense,Superhuman,Harvey Spector,Credit Card - Ramp,30,57101034.9
07/18/2022,Expense,LinkedIn,Mike ross,Credit Card - Ramp,155.58,57101190.48
07/18/2022,Expense,LinkedIn,Mike ross,Credit Card - Ramp,155.58,57101346.06
07/20/2022,Deposit,,"APPLE R238 SYDNEY, Returned a phone and bought a case since my phone was damaged",Account1,-1180.45,57100165.61
07/20/2022,Credit Card Payment,,RAMP BUSINESS CO,Credit Card - Ramp,-4323.35,57095842.26
07/20/2022,Expense,,K&L Gates,Account1,16500,57112342.26
07/20/2022,Expense,,K&L Gates,Professional Service Charges,-16500,57095842.26
07/20/2022,Deposit,,"APPLE R238 SYDNEY, Returned a phone and bought a case since my phone was damaged",Account1,-1180.45,57094661.81
07/20/2022,Expense,,Apple,Account1,1180.45,57095842.26
07/20/2022,Deposit,,APPLE R238 SYDNEY,IPhone,1180.45,57097022.71
07/20/2022,Expense,,Apple,-Split-,-1338.3,57095684.41
07/20/2022,Expense,Netlify,,Tools & Subscription - G&A,6.33,57095690.74
07/20/2022,Credit Card Payment,,RAMP BUSINESS CO,Account1,-4323.35,57091367.39
07/20/2022,Expense,Netlify,Balapavan Tirumani,Credit Card - Ramp,6.33,57091373.72
07/20/2022,Credit Card Payment,,RAMP BUSINESS CO,Account1,-4323.35,57087050.37
07/20/2022,Expense,,K&L Gates,Professional Service Charges,-16500,57070550.37
07/20/2022,Expense,Netlify,,Tools & Subscription - G&A,6.33,57070556.7
07/20/2022,Expense,Netlify,Balapavan Tirumani,Credit Card - Ramp,6.33,57070563.03
07/20/2022,Expense,Netlify,Balapavan Tirumani,Credit Card - Ramp,6.33,57070569.36
07/20/2022,Expense,,Apple,Account1,1180.45,57071749.81
07/20/2022,Expense,,Mobile Case,Account1,157.85,57071907.66
07/20/2022,Credit Card Payment,,RAMP BUSINESS CO,Credit Card - Ramp,-4323.35,57067584.31
07/20/2022,Expense,Netlify,,Tools & Subscription - G&A,6.33,57067590.64
07/20/2022,Credit Card Payment,,RAMP BUSINESS CO,Credit Card - Ramp,-4323.35,57063267.29
07/20/2022,Expense,,Apple,-Split-,-1338.3,57061928.99
07/20/2022,Deposit,,APPLE R238 SYDNEY,IPhone,1180.45,57063109.44
07/20/2022,Credit Card Payment,,RAMP BUSINESS CO,Account1,-4323.35,57058786.09
07/20/2022,Expense,,Apple,Account1,1180.45,57059966.54
07/20/2022,Expense,,Mobile Case,Account1,157.85,57060124.39
07/20/2022,Expense,,K&L Gates,Account1,16500,57076624.39
07/20/2022,Expense,,Mobile Case,Account1,157.85,57076782.24
07/20/2022,Deposit,,APPLE R238 SYDNEY,IPhone,1180.45,57077962.69
07/20/2022,Deposit,,APPLE R238 SYDNEY,IPhone,1180.45,57079143.14
07/20/2022,Expense,,Apple,-Split-,-1338.3,57077804.84
07/20/2022,Expense,Netlify,,Tools & Subscription - G&A,6.33,57077811.17
07/20/2022,Credit Card Payment,,RAMP BUSINESS CO,Account1,-4323.35,57073487.82
07/20/2022,Expense,,Apple,-Split-,-1338.3,57072149.52
07/20/2022,Expense,,K&L Gates,Professional Service Charges,-16500,57055649.52
07/20/2022,Expense,,K&L Gates,Account1,16500,57072149.52
07/20/2022,Credit Card Payment,,RAMP BUSINESS CO,Credit Card - Ramp,-4323.35,57067826.17
07/20/2022,Deposit,,"APPLE R238 SYDNEY, Returned a phone and bought a case since my phone was damaged",Account1,-1180.45,57066645.72
07/20/2022,Expense,,K&L Gates,Professional Service Charges,-16500,57050145.72
07/20/2022,Expense,,Mobile Case,Account1,157.85,57050303.57
07/20/2022,Expense,,Apple,Account1,1180.45,57051484.02
07/20/2022,Expense,,K&L Gates,Account1,16500,57067984.02
07/20/2022,Deposit,,"APPLE R238 SYDNEY, Returned a phone and bought a case since my phone was damaged",Account1,-1180.45,57066803.57
07/21/2022,Expense,Slack,,Tools & Subscription - G&A,883.29,57067686.86
07/21/2022,Expense,Slack,Mike ross,Credit Card - Ramp,883.29,57068570.15
07/21/2022,Expense,Slack,,Tools & Subscription - G&A,883.29,57069453.44
07/21/2022,Expense,Slack,Mike ross,Credit Card - Ramp,883.29,57070336.73
07/21/2022,Expense,Slack,,Tools & Subscription - G&A,883.29,57071220.02
07/21/2022,Expense,Slack,,Tools & Subscription - G&A,883.29,57072103.31
07/21/2022,Expense,Slack,Mike ross,Credit Card - Ramp,883.29,57072986.6
07/22/2022,Expense,Dovetail,Harvey Spector,Credit Card - Ramp,36,57073022.6
07/22/2022,Expense,Automate,Balapavan Tirumani,Credit Card - Ramp,29,57073051.6
07/22/2022,Expense,Dovetail,Harvey Spector,Credit Card - Ramp,36,57073087.6
07/22/2022,Expense,Vimcal,Balapavan Tirumani,Credit Card - Ramp,150,57073237.6
07/22/2022,Expense,Dovetail,,Tools & Subscription - G&A,36,57073273.6
07/22/2022,Expense,Dovetail,Harvey Spector,Credit Card - Ramp,36,57073309.6
07/22/2022,Expense,Dovetail,,Tools & Subscription - G&A,36,57073345.6
07/22/2022,Expense,Vimcal,,Tools & Subscription - G&A,150,57073495.6
07/22/2022,Expense,Vimcal,Balapavan Tirumani,Credit Card - Ramp,150,57073645.6
07/22/2022,Expense,Automate,,Tools & Subscription - G&A,29,57073674.6
07/22/2022,Expense,Vimcal,Balapavan Tirumani,Credit Card - Ramp,150,57073824.6
07/22/2022,Expense,Dovetail,,Tools & Subscription - G&A,36,57073860.6
07/22/2022,Expense,Automate,,Tools & Subscription - G&A,29,57073889.6
07/22/2022,Expense,Automate,Balapavan Tirumani,Credit Card - Ramp,29,57073918.6
07/22/2022,Expense,Automate,Balapavan Tirumani,Credit Card - Ramp,29,57073947.6
07/22/2022,Expense,Automate,,Tools & Subscription - G&A,29,57073976.6
07/22/2022,Expense,Vimcal,,Tools & Subscription - G&A,150,57074126.6
07/22/2022,Expense,Dovetail,,Tools & Subscription - G&A,36,57074162.6
07/22/2022,Expense,Vimcal,,Tools & Subscription - G&A,150,57074312.6
07/22/2022,Expense,Automate,,Tools & Subscription - G&A,29,57074341.6
07/22/2022,Expense,Vimcal,,Tools & Subscription - G&A,150,57074491.6
07/23/2022,Expense,Super,Harvey Spector,Credit Card - Ramp,12,57074503.6
07/23/2022,Expense,NordVPN,Harvey Spector,Credit Card - Ramp,78.96,57074582.56
07/23/2022,Expense,Superhuman,Mike ross,Credit Card - Ramp,30,57074612.56
07/23/2022,Expense,Super,Harvey Spector,Credit Card - Ramp,12,57074624.56
07/23/2022,Expense,NordVPN,Harvey Spector,Credit Card - Ramp,78.96,57074703.52
07/23/2022,Expense,Vimcal,Harvey Spector,Credit Card - Ramp,15,57074718.52
07/23/2022,Expense,Super,,Tools & Subscription - G&A,12,57074730.52
07/23/2022,Expense,Superhuman,,Professional Service Charges,30,57074760.52
07/23/2022,Expense,Vimcal,,Tools & Subscription - G&A,15,57074775.52
07/23/2022,Expense,Superhuman,Mike ross,Credit Card - Ramp,30,57074805.52
07/23/2022,Expense,Superhuman,Mike ross,Credit Card - Ramp,30,57074835.52
07/23/2022,Expense,Vimcal,Harvey Spector,Credit Card - Ramp,15,57074850.52
07/23/2022,Expense,NordVPN,,Tools & Subscription - G&A,78.96,57074929.48
07/23/2022,Expense,Vimcal,Harvey Spector,Credit Card - Ramp,15,57074944.48
07/23/2022,Expense,NordVPN,,Tools & Subscription - G&A,78.96,57075023.44
07/23/2022,Expense,Vimcal,,Tools & Subscription - G&A,15,57075038.44
07/23/2022,Expense,Vimcal,,Tools & Subscription - G&A,15,57075053.44
07/23/2022,Expense,Super,Harvey Spector,Credit Card - Ramp,12,57075065.44
07/23/2022,Expense,Super,,Tools & Subscription - G&A,12,57075077.44
07/23/2022,Expense,NordVPN,,Tools & Subscription - G&A,78.96,57075156.4
07/23/2022,Expense,Super,,Tools & Subscription - G&A,12,57075168.4
07/23/2022,Expense,Superhuman,Mike ross,Credit Card - Ramp,30,57075198.4
07/23/2022,Expense,NordVPN,Harvey Spector,Credit Card - Ramp,78.96,57075277.36
07/23/2022,Expense,Superhuman,,Professional Service Charges,30,57075307.36
07/23/2022,Expense,Vimcal,,Tools & Subscription - G&A,15,57075322.36
07/23/2022,Expense,Super,,Tools & Subscription - G&A,12,57075334.36
07/23/2022,Expense,Superhuman,,Professional Service Charges,30,57075364.36
07/23/2022,Expense,Superhuman,,Professional Service Charges,30,57075394.36
07/23/2022,Expense,NordVPN,,Tools & Subscription - G&A,78.96,57075473.32
07/25/2022,Expense,Miro,Mike ross,Credit Card - Ramp,90,57075563.32
07/25/2022,Expense,Miro,,Tools & Subscription - G&A,90,57075653.32
07/25/2022,Expense,Miro,Mike ross,Credit Card - Ramp,90,57075743.32
07/25/2022,Expense,Miro,Mike ross,Credit Card - Ramp,90,57075833.32
07/25/2022,Expense,Miro,,Tools & Subscription - G&A,90,57075923.32
07/25/2022,Expense,Miro,,Tools & Subscription - G&A,90,57076013.32
07/25/2022,Expense,Miro,,Tools & Subscription - G&A,90,57076103.32
07/26/2022,Expense,,Design Studio,Professional Service Charges,-5359.88,57070743.44
07/26/2022,Expense,Income Capitals ,Income Capitals ,Contract labor,-9505,57061238.44
07/26/2022,Expense,,Design Studio,Account1,53.6,57061292.04
07/26/2022,Expense,Zoom,Chad Blumenthal,Credit Card - Ramp,14.99,57061307.03
07/26/2022,Expense,Namecheap,,Tools & Subscription - G&A,9.34,57061316.37
07/26/2022,Expense,Zoom,,Tools & Subscription - G&A,14.99,57061331.36
07/26/2022,Expense,Zoom,,Tools & Subscription - G&A,14.99,57061346.35
07/26/2022,Expense,Namecheap,Harvey Spector,Credit Card - Ramp,9.34,57061355.69
07/26/2022,Expense,,Design Studio,General business expenses:Bank fees & service charges,-53.6,57061302.09
07/26/2022,Expense,Income Capitals ,Income Capitals ,Contract labor,-9505,57051797.09
07/26/2022,Expense,,Design Studio - Branding studio fees.,Account1,5359.88,57057156.97
07/26/2022,Expense,,Design Studio,General business expenses:Bank fees & service charges,-53.6,57057103.37
07/26/2022,Expense,,Design Studio,Account1,53.6,57057156.97
07/26/2022,Expense,,Design Studio - Branding studio fees.,Account1,5359.88,57062516.85
07/26/2022,Expense,Income Capitals ,Income Capitals ,Account1,9505,57072021.85
07/26/2022,Expense,,Design Studio,Professional Service Charges,-5359.88,57066661.97
07/26/2022,Expense,Zoom,Chad Blumenthal,Credit Card - Ramp,14.99,57066676.96
07/26/2022,Expense,,Design Studio,Professional Service Charges,-5359.88,57061317.08
07/26/2022,Expense,Namecheap,,Tools & Subscription - G&A,9.34,57061326.42
07/26/2022,Expense,Namecheap,,Tools & Subscription - G&A,9.34,57061335.76
07/26/2022,Expense,,Design Studio,General business expenses:Bank fees & service charges,-53.6,57061282.16
07/26/2022,Expense,Zoom,,Tools & Subscription - G&A,14.99,57061297.15
07/26/2022,Expense,Income Capitals ,Income Capitals ,Contract labor,-9505,57051792.15
07/26/2022,Expense,Namecheap,Harvey Spector,Credit Card - Ramp,9.34,57051801.49
07/26/2022,Expense,,Design Studio - Branding studio fees.,Account1,5359.88,57057161.37
07/26/2022,Expense,,Design Studio,Account1,53.6,57057214.97
07/26/2022,Expense,,Design Studio - Branding studio fees.,Account1,5359.88,57062574.85
07/26/2022,Expense,Income Capitals ,Income Capitals ,Account1,9505,57072079.85
07/26/2022,Expense,,Design Studio,Account1,53.6,57072133.45
07/26/2022,Expense,Income Capitals ,Income Capitals ,Account1,9505,57081638.45
07/26/2022,Expense,Zoom,Chad Blumenthal,Credit Card - Ramp,14.99,57081653.44
07/26/2022,Expense,Namecheap,Harvey Spector,Credit Card - Ramp,9.34,57081662.78
07/26/2022,Expense,,Design Studio,General business expenses:Bank fees & service charges,-53.6,57081609.18
07/26/2022,Expense,Income Capitals ,Income Capitals ,Contract labor,-9505,57072104.18
07/26/2022,Expense,Zoom,,Tools & Subscription - G&A,14.99,57072119.17
07/26/2022,Expense,,Design Studio,Professional Service Charges,-5359.88,57066759.29
07/26/2022,Expense,Namecheap,,Tools & Subscription - G&A,9.34,57066768.63
07/26/2022,Expense,Income Capitals ,Income Capitals ,Account1,9505,57076273.63
07/27/2022,Expense,Sentry,,Tools & Subscription - G&A,29,57076302.63
07/27/2022,Expense,Sentry,Balapavan Tirumani,Credit Card - Ramp,29,57076331.63
07/27/2022,Expense,Splitbee,Harris Jose,Credit Card - Ramp,16.52,57076348.15
07/27/2022,Expense,Splitbee,,Tools & Subscription - G&A,16.52,57076364.67
07/27/2022,Expense,Sentry,,Tools & Subscription - G&A,29,57076393.67
07/27/2022,Expense,Sentry,,Tools & Subscription - G&A,29,57076422.67
07/27/2022,Expense,Sendinblue,,Tools & Subscription - G&A,57.8,57076480.47
07/27/2022,Expense,Sendinblue,,Tools & Subscription - G&A,57.8,57076538.27
07/27/2022,Expense,Sendinblue,,Tools & Subscription - G&A,57.8,57076596.07
07/27/2022,Expense,Splitbee,Harris Jose,Credit Card - Ramp,16.52,57076612.59
07/27/2022,Expense,Sendinblue,Balapavan Tirumani,Credit Card - Ramp,57.8,57076670.39
07/27/2022,Expense,Splitbee,,Tools & Subscription - G&A,16.52,57076686.91
07/27/2022,Expense,Splitbee,Harris Jose,Credit Card - Ramp,16.52,57076703.43
07/27/2022,Expense,Sentry,,Tools & Subscription - G&A,29,57076732.43
07/27/2022,Expense,Splitbee,,Tools & Subscription - G&A,16.52,57076748.95
07/27/2022,Expense,Sendinblue,Balapavan Tirumani,Credit Card - Ramp,57.8,57076806.75
07/27/2022,Expense,Sentry,Balapavan Tirumani,Credit Card - Ramp,29,57076835.75
07/27/2022,Expense,Sendinblue,Balapavan Tirumani,Credit Card - Ramp,57.8,57076893.55
07/27/2022,Expense,Splitbee,,Tools & Subscription - G&A,16.52,57076910.07
07/27/2022,Expense,Sentry,Balapavan Tirumani,Credit Card - Ramp,29,57076939.07
07/27/2022,Expense,Sendinblue,,Tools & Subscription - G&A,57.8,57076996.87
07/28/2022,Expense,,GERTRUDE AND ALICE C,Meals & Entertainment,-55.95,57076940.92
07/28/2022,Expense,,GERTRUDE AND ALICE C,Meals & Entertainment,-55.95,57076884.97
07/28/2022,Expense,,GERTRUDE AND ALICE C,Account1,55.95,57076940.92
07/28/2022,Expense,,GERTRUDE AND ALICE C,Meals & Entertainment,-55.95,57076884.97
07/28/2022,Expense,Speedos Cafe,Mike ross,Credit Card - Ramp,14.1,57076899.07
07/28/2022,Expense,Speedos Cafe,Mike ross,Credit Card - Ramp,14.1,57076913.17
07/28/2022,Expense,Speedos Cafe,Mike ross,Meals & Entertainment,14.1,57076927.27
07/28/2022,Expense,Speedos Cafe,Mike ross,Meals & Entertainment,14.1,57076941.37
07/28/2022,Expense,,GERTRUDE AND ALICE C,Account1,55.95,57076997.32
07/28/2022,Expense,Speedos Cafe,Mike ross,Meals & Entertainment,14.1,57077011.42
07/28/2022,Expense,Speedos Cafe,Mike ross,Credit Card - Ramp,14.1,57077025.52
07/28/2022,Expense,,GERTRUDE AND ALICE C,Account1,55.95,57077081.47
07/28/2022,Expense,,GERTRUDE AND ALICE C,Meals & Entertainment,-55.95,57077025.52
07/28/2022,Expense,Speedos Cafe,Mike ross,Meals & Entertainment,14.1,57077039.62
07/28/2022,Expense,,GERTRUDE AND ALICE C,Account1,55.95,57077095.57
07/28/2022,Expense,Speedos Cafe,Mike ross,Credit Card - Ramp,14.1,57077109.67
07/29/2022,Expense,Netlify,Balapavan Tirumani,Credit Card - Ramp,159,57077268.67
07/29/2022,Expense,Netlify,,Tools & Subscription - G&A,159,57077427.67
07/29/2022,Expense,Netlify,,Tools & Subscription - G&A,159,57077586.67
07/29/2022,Expense,Netlify,Balapavan Tirumani,Credit Card - Ramp,159,57077745.67
07/29/2022,Expense,Netlify,Balapavan Tirumani,Credit Card - Ramp,159,57077904.67
07/29/2022,Expense,Netlify,,Tools & Subscription - G&A,159,57078063.67
07/29/2022,Expense,Netlify,,Tools & Subscription - G&A,159,57078222.67
07/30/2022,Expense,Zapier,,Tools & Subscription - G&A,29.99,57078252.66
07/30/2022,Expense,Zapier,,Tools & Subscription - G&A,29.99,57078282.65
07/30/2022,Expense,Zapier,Chad Blumenthal,Credit Card - Ramp,29.99,57078312.64
07/30/2022,Expense,Zapier,,Tools & Subscription - G&A,29.99,57078342.63
07/30/2022,Expense,Zapier,Chad Blumenthal,Credit Card - Ramp,29.99,57078372.62
07/30/2022,Expense,Zapier,Chad Blumenthal,Credit Card - Ramp,29.99,57078402.61
07/30/2022,Expense,Zapier,,Tools & Subscription - G&A,29.99,57078432.6
07/31/2022,Bill,Big Company ,"Service Expenses for the month of July 2022 
INR 2632119 @ 79.42",Accounts Payable (A/P),33141.76,57111574.36
07/31/2022,Expense,Adobe,,Tools & Subscription - S&M,15.5,57111589.86
07/31/2022,Bill,Big Company ,,Outsources Services - India,33141.76,57144731.62
07/31/2022,Expense,Adobe,Mike ross,Credit Card - Ramp,15.5,57144747.12
07/31/2022,Bill,Big Company ,,Outsources Services - India,33141.76,57177888.88
07/31/2022,Bill,Big Company ,"Service Expenses for the month of July 2022 
INR 2632119 @ 79.42",Accounts Payable (A/P),33141.76,57211030.64
07/31/2022,Bill,Big Company ,"Service Expenses for the month of July 2022 
INR 2632119 @ 79.42",Accounts Payable (A/P),33141.76,57244172.4
07/31/2022,Expense,Adobe,Mike ross,Credit Card - Ramp,15.5,57244187.9
07/31/2022,Bill,Big Company ,,Outsources Services - India,33141.76,57277329.66
07/31/2022,Expense,Adobe,,Tools & Subscription - S&M,15.5,57277345.16
07/31/2022,Expense,Adobe,,Tools & Subscription - S&M,15.5,57277360.66
07/31/2022,Bill,Big Company ,"Service Expenses for the month of July 2022 
INR 2632119 @ 79.42",Accounts Payable (A/P),33141.76,57310502.42
07/31/2022,Expense,Adobe,,Tools & Subscription - S&M,15.5,57310517.92
07/31/2022,Expense,Adobe,Mike ross,Credit Card - Ramp,15.5,57310533.42
07/31/2022,Bill,Big Company ,,Outsources Services - India,33141.76,57343675.18
08/01/2022,Expense,Fast Cover Travel Insurance,,Insurance,136.06,57343811.24
08/01/2022,Expense,Google G Suite,,Tools & Subscription - G&A,106.31,57343917.55
08/01/2022,Expense,Fast Cover Travel Insurance,,Insurance,136.06,57344053.61
08/01/2022,Expense,Air France,,Travel:Airfare,318.53,57344372.14
08/01/2022,Expense,Slack,,Tools & Subscription - G&A,78.91,57344451.05
08/01/2022,Expense,Copyright Osp,Chad Blumenthal,Tools & Subscription - G&A,6,57344457.05
08/01/2022,Expense,Google G Suite,,Tools & Subscription - G&A,106.31,57344563.36
08/01/2022,Expense,Fast Cover Travel Insurance,,Insurance,136.06,57344699.42
08/01/2022,Expense,Fast Cover Travel Insurance,Mike ross,Credit Card - Ramp,136.06,57344835.48
08/01/2022,Expense,Slack,,Tools & Subscription - G&A,78.91,57344914.39
08/01/2022,Expense,Google G Suite,,Tools & Subscription - G&A,106.31,57345020.7
08/01/2022,Expense,Slack,,Tools & Subscription - G&A,78.91,57345099.61
08/01/2022,Expense,Copyright Osp,Chad Blumenthal,Tools & Subscription - G&A,6,57345105.61
08/01/2022,Expense,Air France,,Travel:Airfare,318.53,57345424.14
08/01/2022,Expense,Fast Cover Travel Insurance,Mike ross,Credit Card - Ramp,136.06,57345560.2
08/01/2022,Expense,Copyright Osp,Chad Blumenthal,Credit Card - Ramp,6,57345566.2
08/01/2022,Expense,Google G Suite,,Tools & Subscription - G&A,106.31,57345672.51
08/01/2022,Expense,Slack,Mike ross,Credit Card - Ramp,78.91,57345751.42
08/01/2022,Expense,Air France,Mike ross,Credit Card - Ramp,318.53,57346069.95
08/01/2022,Expense,Air France,Mike ross,Credit Card - Ramp,318.53,57346388.48
08/01/2022,Expense,Google G Suite,Mike ross,Credit Card - Ramp,106.31,57346494.79
08/01/2022,Expense,Fast Cover Travel Insurance,Mike ross,Credit Card - Ramp,136.06,57346630.85
08/01/2022,Expense,Copyright Osp,Chad Blumenthal,Credit Card - Ramp,6,57346636.85
08/01/2022,Expense,Google G Suite,Mike ross,Credit Card - Ramp,106.31,57346743.16
08/01/2022,Expense,Air France,Mike ross,Credit Card - Ramp,318.53,57347061.69
08/01/2022,Expense,Copyright Osp,Chad Blumenthal,Credit Card - Ramp,6,57347067.69
08/01/2022,Expense,Slack,Mike ross,Credit Card - Ramp,78.91,57347146.6
08/01/2022,Expense,Slack,Mike ross,Credit Card - Ramp,78.91,57347225.51
08/01/2022,Expense,Fast Cover Travel Insurance,Mike ross,Credit Card - Ramp,136.06,57347361.57
08/01/2022,Expense,Air France,,Travel:Airfare,318.53,57347680.1
08/01/2022,Expense,Copyright Osp,Chad Blumenthal,Tools & Subscription - G&A,6,57347686.1
08/01/2022,Expense,Fast Cover Travel Insurance,,Insurance,136.06,57347822.16
08/01/2022,Expense,Copyright Osp,Chad Blumenthal,Tools & Subscription - G&A,6,57347828.16
08/01/2022,Expense,Slack,,Tools & Subscription - G&A,78.91,57347907.07
08/01/2022,Expense,Air France,,Travel:Airfare,318.53,57348225.6
08/01/2022,Expense,Google G Suite,Mike ross,Credit Card - Ramp,106.31,57348331.91
08/02/2022,Expense,Officeworks,,Office expenses,5.82,57348337.73
08/02/2022,Expense,Photo Direct,Mike ross,Tools & Subscription - G&A,19.74,57348357.47
08/02/2022,Expense,Photo Direct,Mike ross,Tools & Subscription - G&A,19.74,57348377.21
08/02/2022,Expense,Render,,Tools & Subscription - G&A,14,57348391.21
08/02/2022,Expense,Render,,Tools & Subscription - G&A,14,57348405.21
08/02/2022,Expense,Render,Balapavan Tirumani,Credit Card - Ramp,14,57348419.21
08/02/2022,Expense,Photo Direct,Mike ross,Tools & Subscription - G&A,19.74,57348438.95
08/02/2022,Expense,Render,,Tools & Subscription - G&A,14,57348452.95
08/02/2022,Expense,Photo Direct,Mike ross,Tools & Subscription - G&A,19.74,57348472.69
08/02/2022,Deposit,,Interest Accrual,Savings (6977),44.66,57348517.35
08/02/2022,Expense,Render,,Tools & Subscription - G&A,14,57348531.35
08/02/2022,Expense,Officeworks,Mike ross,Credit Card - Ramp,5.82,57348537.17
08/02/2022,Expense,Photo Direct,Mike ross,Credit Card - Ramp,19.74,57348556.91
08/02/2022,Expense,Photo Direct,Mike ross,Credit Card - Ramp,19.74,57348576.65
08/02/2022,Expense,Officeworks,,Office expenses,5.82,57348582.47
08/02/2022,Expense,Render,Balapavan Tirumani,Credit Card - Ramp,14,57348596.47
08/02/2022,Deposit,,Interest Accrual,Savings (6977),44.66,57348641.13
08/02/2022,Deposit,,Interest Accrual,Interest Received,44.66,57348685.79
08/02/2022,Deposit,,Interest Accrual,Savings (6977),44.66,57348730.45
08/02/2022,Deposit,,Interest Accrual,Interest Received,44.66,57348775.11
08/02/2022,Expense,Officeworks,,Office expenses,5.82,57348780.93
08/02/2022,Expense,Officeworks,,Office expenses,5.82,57348786.75
08/02/2022,Expense,Officeworks,Mike ross,Credit Card - Ramp,5.82,57348792.57
08/02/2022,Deposit,,Interest Accrual,Interest Received,44.66,57348837.23
08/02/2022,Expense,Officeworks,Mike ross,Credit Card - Ramp,5.82,57348843.05
08/02/2022,Expense,Render,Balapavan Tirumani,Credit Card - Ramp,14,57348857.05
08/02/2022,Expense,Officeworks,Mike ross,Credit Card - Ramp,5.82,57348862.87
08/02/2022,Expense,Photo Direct,Mike ross,Credit Card - Ramp,19.74,57348882.61
08/02/2022,Deposit,,Interest Accrual,Interest Received,44.66,57348927.27
08/03/2022,Expense,Mazurek Co,Harvey Spector,Credit Card - Ramp,29.95,57348957.22
08/03/2022,Expense,Mazurek Co,,Tools & Subscription - G&A,29.95,57348987.17
08/03/2022,Expense,GiftRocket,Chad Blumenthal,Tools & Subscription - G&A,1.03,57348988.2
08/03/2022,Expense,GiftRocket,Chad Blumenthal,Credit Card - Ramp,1.03,57348989.23
08/03/2022,Deposit,,Interest Accrual,Interest Received,1.64,57348990.87
08/03/2022,Deposit,,Interest Accrual,Interest Received,1.64,57348992.51
08/03/2022,Deposit,,Interest Accrual,Interest Received,1.64,57348994.15
08/03/2022,Expense,GiftRocket,Chad Blumenthal,Tools & Subscription - G&A,77.25,57349071.4
08/03/2022,Expense,GiftRocket,Chad Blumenthal,Credit Card - Ramp,77.25,57349148.65
08/03/2022,Deposit,,Interest Accrual,Interest Received,1.64,57349150.29
08/03/2022,Expense,GiftRocket,Chad Blumenthal,Credit Card - Ramp,1.03,57349151.32
08/03/2022,Deposit,,Interest Accrual,Savings (6977),1.64,57349152.96
08/03/2022,Expense,GiftRocket,Chad Blumenthal,Credit Card - Ramp,77.25,57349230.21
08/03/2022,Expense,Mazurek Co,Harvey Spector,Credit Card - Ramp,29.95,57349260.16
08/03/2022,Expense,GiftRocket,Chad Blumenthal,Tools & Subscription - G&A,77.25,57349337.41
08/03/2022,Expense,GiftRocket,Chad Blumenthal,Tools & Subscription - G&A,77.25,57349414.66
08/03/2022,Expense,GiftRocket,Chad Blumenthal,Tools & Subscription - G&A,1.03,57349415.69
08/03/2022,Expense,Mazurek Co,,Tools & Subscription - G&A,29.95,57349445.64
08/03/2022,Expense,GiftRocket,Chad Blumenthal,Tools & Subscription - G&A,77.25,57349522.89
08/03/2022,Deposit,,Interest Accrual,Savings (6977),1.64,57349524.53
08/03/2022,Expense,Mazurek Co,,Tools & Subscription - G&A,29.95,57349554.48
08/03/2022,Expense,GiftRocket,Chad Blumenthal,Credit Card - Ramp,77.25,57349631.73
08/03/2022,Expense,GiftRocket,Chad Blumenthal,Tools & Subscription - G&A,1.03,57349632.76
08/03/2022,Expense,Mazurek Co,,Tools & Subscription - G&A,29.95,57349662.71
08/03/2022,Expense,GiftRocket,Chad Blumenthal,Tools & Subscription - G&A,1.03,57349663.74
08/03/2022,Deposit,,Interest Accrual,Savings (6977),1.64,57349665.38
08/03/2022,Expense,Mazurek Co,Harvey Spector,Credit Card - Ramp,29.95,57349695.33
08/03/2022,Expense,GiftRocket,Chad Blumenthal,Credit Card - Ramp,1.03,57349696.36
08/04/2022,Deposit,,Interest Accrual,Interest Received,1.63,57349697.99
08/04/2022,Deposit,,Interest Accrual,Interest Received,1.63,57349699.62
08/04/2022,Deposit,,Interest Accrual,Savings (6977),1.63,57349701.25
08/04/2022,Deposit,,Interest Accrual,Interest Received,1.63,57349702.88
08/04/2022,Deposit,,Interest Accrual,Interest Received,1.63,57349704.51
08/04/2022,Deposit,,Interest Accrual,Savings (6977),1.63,57349706.14
08/04/2022,Deposit,,Interest Accrual,Savings (6977),1.63,57349707.77
08/05/2022,Deposit,,Interest Accrual,Interest Received,1.63,57349709.4
08/05/2022,Deposit,,Interest Accrual,Savings (6977),1.63,57349711.03
08/05/2022,Deposit,,Interest Accrual,Interest Received,1.63,57349712.66
08/05/2022,Deposit,,Interest Accrual,Savings (6977),1.63,57349714.29
08/05/2022,Deposit,,Interest Accrual,Interest Received,1.63,57349715.92
08/05/2022,Deposit,,Interest Accrual,Interest Received,1.63,57349717.55
08/05/2022,Deposit,,Interest Accrual,Savings (6977),1.63,57349719.18
08/07/2022,Expense,Mailchimp,Mike ross,Credit Card - Ramp,22.88,57349742.06
08/07/2022,Expense,The New York Times,Mike ross,Credit Card - Ramp,1.4,57349743.46
08/07/2022,Expense,The New York Times,,General business expenses:Memberships & subscriptions,1.4,57349744.86
08/07/2022,Expense,Mailchimp,,Tools & Subscription - G&A,22.88,57349767.74
08/07/2022,Expense,The New York Times,Mike ross,Credit Card - Ramp,1.4,57349769.14
08/07/2022,Expense,Mailchimp,,Tools & Subscription - G&A,22.88,57349792.02
08/07/2022,Expense,The New York Times,,General business expenses:Memberships & subscriptions,1.4,57349793.42
08/07/2022,Expense,The New York Times,Mike ross,Credit Card - Ramp,1.4,57349794.82
08/07/2022,Expense,Mailchimp,Mike ross,Credit Card - Ramp,22.88,57349817.7
08/07/2022,Expense,Mailchimp,Mike ross,Credit Card - Ramp,22.88,57349840.58
08/07/2022,Expense,The New York Times,,General business expenses:Memberships & subscriptions,1.4,57349841.98
08/07/2022,Expense,Mailchimp,,Tools & Subscription - G&A,22.88,57349864.86
08/07/2022,Expense,The New York Times,,General business expenses:Memberships & subscriptions,1.4,57349866.26
08/07/2022,Expense,The New York Times,Mike ross,Credit Card - Ramp,1.4,57349867.66
08/07/2022,Expense,Mailchimp,,Tools & Subscription - G&A,22.88,57349890.54
08/08/2022,Expense,Calendly,Harvey Spector,Credit Card - Ramp,80,57349970.54
08/08/2022,Expense,Millpoint Caffe Bookshop,Mike ross,Meals & Entertainment,17.73,57349988.27
08/08/2022,Expense,Calendly,,Tools & Subscription - G&A,80,57350068.27
08/08/2022,Expense,Calendly,Harvey Spector,Credit Card - Ramp,80,57350148.27
08/08/2022,Expense,Millpoint Caffe Bookshop,Mike ross,Meals & Entertainment,17.73,57350166
08/08/2022,Expense,Millpoint Caffe Bookshop,Mike ross,Credit Card - Ramp,17.73,57350183.73
08/08/2022,Expense,Millpoint Caffe Bookshop,Mike ross,Credit Card - Ramp,17.73,57350201.46
08/08/2022,Expense,Millpoint Caffe Bookshop,Mike ross,Meals & Entertainment,17.73,57350219.19
08/08/2022,Expense,Millpoint Caffe Bookshop,Mike ross,Credit Card - Ramp,17.73,57350236.92
08/08/2022,Expense,Calendly,,Tools & Subscription - G&A,80,57350316.92
08/08/2022,Expense,Millpoint Caffe Bookshop,Mike ross,Credit Card - Ramp,17.73,57350334.65
08/08/2022,Expense,Millpoint Caffe Bookshop,Mike ross,Meals & Entertainment,17.73,57350352.38
08/08/2022,Expense,Calendly,,Tools & Subscription - G&A,80,57350432.38
08/08/2022,Expense,Calendly,,Tools & Subscription - G&A,80,57350512.38
08/08/2022,Expense,Calendly,Harvey Spector,Credit Card - Ramp,80,57350592.38
08/09/2022,Expense,Heroku,Balapavan Tirumani,Credit Card - Ramp,79.72,57350672.1
08/09/2022,Expense,Halo Espresso,Mike ross,Credit Card - Ramp,33.66,57350705.76
08/09/2022,Expense,Uber Eats,Mike ross,Credit Card - Ramp,31.83,57350737.59
08/09/2022,Expense,Uber Eats,Mike ross,Credit Card - Ramp,31.83,57350769.42
08/09/2022,Expense,Halo Espresso,Mike ross,Credit Card - Ramp,33.66,57350803.08
08/09/2022,Expense,Pragmaticengineer.Com,,Tools & Subscription - G&A,15,57350818.08
08/09/2022,Expense,Uber Eats,Mike ross,Meals & Entertainment,31.83,57350849.91
08/09/2022,Expense,Pragmaticengineer.Com,,Tools & Subscription - G&A,15,57350864.91
08/09/2022,Expense,Heroku,Balapavan Tirumani,Tools & Subscription - S&M,79.72,57350944.63
08/09/2022,Expense,Usersnap,,Tools & Subscription - G&A,19,57350963.63
08/09/2022,Expense,Uber Eats,Mike ross,Credit Card - Ramp,31.83,57350995.46
08/09/2022,Expense,Halo Espresso,Mike ross,Meals & Entertainment,33.66,57351029.12
08/09/2022,Expense,Usersnap,Harris Jose,Credit Card - Ramp,19,57351048.12
08/09/2022,Expense,Pragmaticengineer.Com,Harvey Spector,Credit Card - Ramp,15,57351063.12
08/09/2022,Expense,Halo Espresso,Mike ross,Meals & Entertainment,33.66,57351096.78
08/09/2022,Expense,Usersnap,Harris Jose,Credit Card - Ramp,19,57351115.78
08/09/2022,Expense,Uber Eats,Mike ross,Meals & Entertainment,31.83,57351147.61
08/09/2022,Expense,Halo Espresso,Mike ross,Credit Card - Ramp,33.66,57351181.27
08/09/2022,Expense,Pragmaticengineer.Com,Harvey Spector,Credit Card - Ramp,15,57351196.27
08/09/2022,Expense,Usersnap,,Tools & Subscription - G&A,19,57351215.27
08/09/2022,Expense,Heroku,Balapavan Tirumani,Tools & Subscription - S&M,79.72,57351294.99
08/09/2022,Expense,Heroku,Balapavan Tirumani,Credit Card - Ramp,79.72,57351374.71
08/09/2022,Expense,Heroku,Balapavan Tirumani,Tools & Subscription - S&M,79.72,57351454.43
08/09/2022,Expense,Halo Espresso,Mike ross,Meals & Entertainment,33.66,57351488.09
08/09/2022,Expense,Usersnap,Harris Jose,Credit Card - Ramp,19,57351507.09
08/09/2022,Expense,Pragmaticengineer.Com,Harvey Spector,Credit Card - Ramp,15,57351522.09
08/09/2022,Expense,Usersnap,,Tools & Subscription - G&A,19,57351541.09
08/09/2022,Expense,Halo Espresso,Mike ross,Credit Card - Ramp,33.66,57351574.75
08/09/2022,Expense,Uber Eats,Mike ross,Credit Card - Ramp,31.83,57351606.58
08/09/2022,Expense,Heroku,Balapavan Tirumani,Credit Card - Ramp,79.72,57351686.3
08/09/2022,Expense,Uber Eats,Mike ross,Meals & Entertainment,31.83,57351718.13
08/09/2022,Expense,Pragmaticengineer.Com,,Tools & Subscription - G&A,15,57351733.13
08/09/2022,Expense,Halo Espresso,Mike ross,Meals & Entertainment,33.66,57351766.79
08/09/2022,Expense,Heroku,Balapavan Tirumani,Tools & Subscription - S&M,79.72,57351846.51
08/09/2022,Expense,Usersnap,,Tools & Subscription - G&A,19,57351865.51
08/09/2022,Expense,Uber Eats,Mike ross,Meals & Entertainment,31.83,57351897.34
08/09/2022,Expense,Pragmaticengineer.Com,,Tools & Subscription - G&A,15,57351912.34
08/10/2022,Expense,Pause Cafe,Harvey Spector,Credit Card - Ramp,7,57351919.34
08/10/2022,Expense,Pause Cafe,Harvey Spector,Meals & Entertainment,7,57351926.34
08/10/2022,Expense,Uber Eats,Mike ross,Meals & Entertainment,25.83,57351952.17
08/10/2022,Expense,Telegram,Mike ross,Credit Card - Ramp,3.15,57351955.32
08/10/2022,Expense,The Partisan,Mike ross,Credit Card - Ramp,45.26,57352000.58
08/10/2022,Expense,Uber Eats,Mike ross,Credit Card - Ramp,25.83,57352026.41
08/10/2022,Expense,Uber Eats,Mike ross,Credit Card - Ramp,25.83,57352052.24
08/10/2022,Expense,Telegram,,Meals & Entertainment,3.15,57352055.39
08/10/2022,Expense,Uber Eats,Mike ross,Meals & Entertainment,25.83,57352081.22
08/10/2022,Expense,COMO The Treasury,,Travel:Hotels,13.3,57352094.52
08/10/2022,Expense,COMO The Treasury,Mike ross,Credit Card - Ramp,13.3,57352107.82
08/10/2022,Expense,COMO The Treasury,Mike ross,Credit Card - Ramp,13.3,57352121.12
08/10/2022,Expense,Telegram,Mike ross,Credit Card - Ramp,3.15,57352124.27
08/10/2022,Expense,Pause Cafe,Harvey Spector,Meals & Entertainment,7,57352131.27
08/10/2022,Expense,The Partisan,Mike ross,Credit Card - Ramp,45.26,57352176.53
08/10/2022,Expense,The Partisan,Mike ross,Meals & Entertainment,45.26,57352221.79
08/10/2022,Expense,COMO The Treasury,,Travel:Hotels,13.3,57352235.09
08/10/2022,Expense,Pause Cafe,Harvey Spector,Meals & Entertainment,7,57352242.09
08/10/2022,Expense,The Partisan,Mike ross,Meals & Entertainment,45.26,57352287.35
08/10/2022,Expense,The Partisan,Mike ross,Credit Card - Ramp,45.26,57352332.61
08/10/2022,Expense,Pause Cafe,Harvey Spector,Credit Card - Ramp,7,57352339.61
08/10/2022,Expense,Telegram,Mike ross,Credit Card - Ramp,3.15,57352342.76
08/10/2022,Expense,COMO The Treasury,Mike ross,Credit Card - Ramp,13.3,57352356.06
08/10/2022,Expense,Telegram,Mike ross,Credit Card - Ramp,3.15,57352359.21
08/10/2022,Expense,Pause Cafe,Harvey Spector,Credit Card - Ramp,7,57352366.21
08/10/2022,Expense,Telegram,,Meals & Entertainment,3.15,57352369.36
08/10/2022,Expense,Uber Eats,Mike ross,Meals & Entertainment,25.83,57352395.19
08/10/2022,Expense,Telegram,,Meals & Entertainment,3.15,57352398.34
08/10/2022,Expense,The Partisan,Mike ross,Meals & Entertainment,45.26,57352443.6
08/10/2022,Expense,The Partisan,Mike ross,Credit Card - Ramp,45.26,57352488.86
08/10/2022,Expense,The Partisan,Mike ross,Meals & Entertainment,45.26,57352534.12
08/10/2022,Expense,COMO The Treasury,,Travel:Hotels,13.3,57352547.42
08/10/2022,Expense,Pause Cafe,Harvey Spector,Meals & Entertainment,7,57352554.42
08/10/2022,Expense,Uber Eats,Mike ross,Meals & Entertainment,25.83,57352580.25
08/10/2022,Expense,COMO The Treasury,,Travel:Hotels,13.3,57352593.55
08/10/2022,Expense,Uber Eats,Mike ross,Credit Card - Ramp,25.83,57352619.38
08/10/2022,Expense,Uber Eats,Mike ross,Credit Card - Ramp,25.83,57352645.21
08/10/2022,Expense,Pause Cafe,Harvey Spector,Credit Card - Ramp,7,57352652.21
08/10/2022,Expense,Telegram,,Meals & Entertainment,3.15,57352655.36
08/11/2022,Expense,Kinky Lizard Espresso Bar,Mike ross,Credit Card - Ramp,15.29,57352670.65
08/11/2022,Expense,Kinky Lizard Espresso Bar,Mike ross,Credit Card - Ramp,14.94,57352685.59
08/11/2022,Expense,Kinky Lizard Espresso Bar,Mike ross,Credit Card - Ramp,15.29,57352700.88
08/11/2022,Expense,Kinky Lizard Espresso Bar,Mike ross,Credit Card - Ramp,15.29,57352716.17
08/11/2022,Expense,Kinky Lizard Espresso Bar,Mike ross,Meals & Entertainment,14.94,57352731.11
08/11/2022,Expense,Kinky Lizard Espresso Bar,Mike ross,Credit Card - Ramp,14.94,57352746.05
08/11/2022,Expense,Kinky Lizard Espresso Bar,Mike ross,Credit Card - Ramp,14.94,57352760.99
08/11/2022,Expense,Kinky Lizard Espresso Bar,Mike ross,Meals & Entertainment,15.29,57352776.28
08/11/2022,Expense,Kinky Lizard Espresso Bar,Mike ross,Credit Card - Ramp,15.29,57352791.57
08/11/2022,Expense,Kinky Lizard Espresso Bar,Mike ross,Meals & Entertainment,15.29,57352806.86
08/11/2022,Expense,Kinky Lizard Espresso Bar,Mike ross,Meals & Entertainment,15.29,57352822.15
08/11/2022,Expense,Kinky Lizard Espresso Bar,Mike ross,Meals & Entertainment,14.94,57352837.09
08/11/2022,Expense,Kinky Lizard Espresso Bar,Mike ross,Credit Card - Ramp,14.94,57352852.03
08/11/2022,Expense,Kinky Lizard Espresso Bar,Mike ross,Meals & Entertainment,14.94,57352866.97
08/11/2022,Expense,Kinky Lizard Espresso Bar,Mike ross,Meals & Entertainment,15.29,57352882.26
08/11/2022,Expense,Kinky Lizard Espresso Bar,Mike ross,Meals & Entertainment,14.94,57352897.2
08/12/2022,Expense,Northbridge,,Meals & Entertainment,8.92,57352906.12
08/12/2022,Expense,Arrival Hall,,Meals & Entertainment,26.42,57352932.54
08/12/2022,Expense,Arrival Hall,Mike ross,Credit Card - Ramp,26.42,57352958.96
08/12/2022,Expense,Northbridge,Mike ross,Credit Card - Ramp,8.92,57352967.88
08/12/2022,Expense,Arrival Hall,Mike ross,Credit Card - Ramp,26.42,57352994.3
08/12/2022,Expense,Arrival Hall,,Meals & Entertainment,26.42,57353020.72
08/12/2022,Expense,Northbridge,Mike ross,Credit Card - Ramp,8.92,57353029.64
08/12/2022,Expense,Northbridge,,Meals & Entertainment,8.92,57353038.56
08/12/2022,Expense,Northbridge,Mike ross,Credit Card - Ramp,8.92,57353047.48
08/12/2022,Expense,Northbridge,,Meals & Entertainment,8.92,57353056.4
08/12/2022,Expense,Arrival Hall,Mike ross,Credit Card - Ramp,26.42,57353082.82
08/12/2022,Expense,Arrival Hall,Mike ross,Credit Card - Ramp,26.42,57353109.24
08/12/2022,Expense,Northbridge,Mike ross,Credit Card - Ramp,8.92,57353118.16
08/12/2022,Expense,Northbridge,,Meals & Entertainment,8.92,57353127.08
08/12/2022,Expense,Arrival Hall,,Meals & Entertainment,26.42,57353153.5
08/12/2022,Expense,Arrival Hall,,Meals & Entertainment,26.42,57353179.92
08/13/2022,Expense,Airbnb,,Travel:Hotels,972.27,57354152.19
08/13/2022,Expense,Intercom,,Tools & Subscription - G&A,176,57354328.19
08/13/2022,Expense,Figma,,Tools & Subscription - G&A,320,57354648.19
08/13/2022,Expense,Intercom,,Tools & Subscription - G&A,176,57354824.19
08/13/2022,Expense,Intercom,Balapavan Tirumani,Credit Card - Ramp,176,57355000.19
08/13/2022,Expense,Figma,,Tools & Subscription - G&A,320,57355320.19
08/13/2022,Expense,Airbnb,Mike ross,Credit Card - Ramp,972.27,57356292.46
08/13/2022,Expense,Qantas,Mike ross,Credit Card - Ramp,407.82,57356700.28
08/13/2022,Expense,Qantas,Mike ross,Credit Card - Ramp,407.82,57357108.1
08/13/2022,Expense,Figma,,Tools & Subscription - G&A,320,57357428.1
08/13/2022,Expense,Qantas,,Travel:Airfare,407.82,57357835.92
08/13/2022,Expense,Figma,Mike ross,Credit Card - Ramp,320,57358155.92
08/13/2022,Expense,Qantas,Mike ross,Credit Card - Ramp,407.82,57358563.74
08/13/2022,Expense,Qantas,,Travel:Airfare,407.82,57358971.56
08/13/2022,Expense,Figma,Mike ross,Credit Card - Ramp,320,57359291.56
08/13/2022,Expense,Figma,,Tools & Subscription - G&A,320,57359611.56
08/13/2022,Expense,Airbnb,,Travel:Hotels,972.27,57360583.83
08/13/2022,Expense,Intercom,,Tools & Subscription - G&A,176,57360759.83
08/13/2022,Expense,Qantas,,Travel:Airfare,407.82,57361167.65
08/13/2022,Expense,Airbnb,Mike ross,Credit Card - Ramp,972.27,57362139.92
08/13/2022,Expense,Figma,Mike ross,Credit Card - Ramp,320,57362459.92
08/13/2022,Expense,Intercom,Balapavan Tirumani,Credit Card - Ramp,176,57362635.92
08/13/2022,Expense,Airbnb,,Travel:Hotels,972.27,57363608.19
08/13/2022,Expense,Intercom,,Tools & Subscription - G&A,176,57363784.19
08/13/2022,Expense,Airbnb,Mike ross,Credit Card - Ramp,972.27,57364756.46
08/13/2022,Expense,Airbnb,,Travel:Hotels,972.27,57365728.73
08/13/2022,Expense,Qantas,,Travel:Airfare,407.82,57366136.55
08/13/2022,Expense,Intercom,Balapavan Tirumani,Credit Card - Ramp,176,57366312.55
08/14/2022,Expense,Intuit,Harvey Spector,Credit Card - Ramp,55,57366367.55
08/14/2022,Expense,Intuit,,Tools & Subscription - G&A,55,57366422.55
08/14/2022,Expense,LinkedIn,Harvey Spector,Credit Card - Ramp,90.63,57366513.18
08/14/2022,Expense,Intuit,Harvey Spector,Credit Card - Ramp,55,57366568.18
08/14/2022,Expense,LinkedIn,,Tools & Subscription - G&A,90.63,57366658.81
08/14/2022,Expense,LinkedIn,,Tools & Subscription - G&A,90.63,57366749.44
08/14/2022,Expense,Intuit,Harvey Spector,Credit Card - Ramp,55,57366804.44
08/14/2022,Expense,LinkedIn,Harvey Spector,Credit Card - Ramp,90.63,57366895.07
08/14/2022,Expense,LinkedIn,Harvey Spector,Credit Card - Ramp,90.63,57366985.7
08/14/2022,Expense,LinkedIn,,Tools & Subscription - G&A,90.63,57367076.33
08/14/2022,Expense,Intuit,,Tools & Subscription - G&A,55,57367131.33
08/14/2022,Expense,Intuit,,Tools & Subscription - G&A,55,57367186.33
08/14/2022,Expense,LinkedIn,,Tools & Subscription - G&A,90.63,57367276.96
08/14/2022,Expense,Intuit,,Tools & Subscription - G&A,55,57367331.96
08/15/2022,Expense,Uber Eats,Mike ross,Credit Card - Ramp,20.77,57367352.73
08/15/2022,Expense,Uber Eats,Mike ross,Credit Card - Ramp,20.77,57367373.5
08/15/2022,Expense,Uber Eats,Mike ross,Meals & Entertainment,20.77,57367394.27
08/15/2022,Expense,Uber Eats,Mike ross,Credit Card - Ramp,20.77,57367415.04
08/15/2022,Expense,Uber Eats,Mike ross,Meals & Entertainment,20.77,57367435.81
08/15/2022,Expense,Uber Eats,Mike ross,Credit Card - Ramp,20.77,57367456.58
08/15/2022,Expense,Uber Eats,Mike ross,Meals & Entertainment,20.77,57367477.35
08/15/2022,Expense,Uber Eats,Mike ross,Meals & Entertainment,20.77,57367498.12
08/16/2022,Expense,Linear,,Tools & Subscription - G&A,150,57367648.12
08/16/2022,Expense,Zapier,Harvey Spector,Credit Card - Ramp,29.99,57367678.11
08/16/2022,Expense,Zapier,Harvey Spector,Credit Card - Ramp,29.99,57367708.1
08/16/2022,Expense,Zapier,,Tools & Subscription - G&A,29.99,57367738.09
08/16/2022,Expense,Linear,Chad Blumenthal,Credit Card - Ramp,150,57367888.09
08/16/2022,Expense,Cuckoo Callay,Mike ross,Meals & Entertainment,12.31,57367900.4
08/16/2022,Expense,Linear,,Tools & Subscription - G&A,150,57368050.4
08/16/2022,Expense,bills,Mike ross,Credit Card - Ramp,33.87,57368084.27
08/16/2022,Expense,bills,Mike ross,Meals & Entertainment,33.87,57368118.14
08/16/2022,Expense,Cuckoo Callay,Mike ross,Credit Card - Ramp,12.31,57368130.45
08/16/2022,Expense,Linear,Chad Blumenthal,Credit Card - Ramp,150,57368280.45
08/16/2022,Expense,bills,Mike ross,Meals & Entertainment,33.87,57368314.32
08/16/2022,Expense,Cuckoo Callay,Mike ross,Meals & Entertainment,12.31,57368326.63
08/16/2022,Expense,Zapier,,Tools & Subscription - G&A,29.99,57368356.62
08/16/2022,Expense,Cuckoo Callay,Mike ross,Meals & Entertainment,12.31,57368368.93
08/16/2022,Expense,Cuckoo Callay,Mike ross,Meals & Entertainment,12.31,57368381.24
08/16/2022,Expense,bills,Mike ross,Credit Card - Ramp,33.87,57368415.11
08/16/2022,Expense,Linear,,Tools & Subscription - G&A,150,57368565.11
08/16/2022,Expense,bills,Mike ross,Meals & Entertainment,33.87,57368598.98
08/16/2022,Expense,bills,Mike ross,Meals & Entertainment,33.87,57368632.85
08/16/2022,Expense,Zapier,,Tools & Subscription - G&A,29.99,57368662.84
08/16/2022,Expense,Cuckoo Callay,Mike ross,Credit Card - Ramp,12.31,57368675.15
08/16/2022,Expense,bills,Mike ross,Credit Card - Ramp,33.87,57368709.02
08/16/2022,Expense,Zapier,Harvey Spector,Credit Card - Ramp,29.99,57368739.01
08/16/2022,Expense,Cuckoo Callay,Mike ross,Credit Card - Ramp,12.31,57368751.32
08/16/2022,Expense,Cuckoo Callay,Mike ross,Credit Card - Ramp,12.31,57368763.63
08/16/2022,Expense,bills,Mike ross,Credit Card - Ramp,33.87,57368797.5
08/16/2022,Expense,Zapier,,Tools & Subscription - G&A,29.99,57368827.49
08/16/2022,Expense,Linear,Chad Blumenthal,Credit Card - Ramp,150,57368977.49
08/16/2022,Expense,Linear,,Tools & Subscription - G&A,150,57369127.49
08/17/2022,Expense,Shaffa,Mike ross,Credit Card - Ramp,169.37,57369296.86
08/17/2022,Expense,IPPUDO AUSTRALIA,Mike ross,Credit Card - Ramp,22.05,57369318.91
08/17/2022,Expense,Four Ate Five,Mike ross,Credit Card - Ramp,16.77,57369335.68
08/17/2022,Expense,Shaffa,Mike ross,Credit Card - Ramp,169.37,57369505.05
08/17/2022,Expense,IPPUDO AUSTRALIA,Mike ross,Credit Card - Ramp,22.05,57369527.1
08/17/2022,Expense,Four Ate Five,Mike ross,Credit Card - Ramp,16.77,57369543.87
08/17/2022,Expense,Shaffa,,Meals & Entertainment,169.37,57369713.24
08/17/2022,Expense,IPPUDO AUSTRALIA,Mike ross,Credit Card - Ramp,22.05,57369735.29
08/17/2022,Expense,EntityA,CompanyB,Account2,-100000,57269735.29
08/17/2022,Expense,Shaffa,Mike ross,Credit Card - Ramp,169.37,57269904.66
08/17/2022,Expense,IPPUDO AUSTRALIA,Mike ross,Meals & Entertainment,22.05,57269926.71
08/17/2022,Expense,EntityA,CompanyB,Account1,-100000,57169926.71
08/17/2022,Expense,Four Ate Five,Mike ross,Meals & Entertainment,16.77,57169943.48
08/17/2022,Expense,EntityA,CompanyB,Account2,-100000,57069943.48
08/17/2022,Expense,Four Ate Five,Mike ross,Meals & Entertainment,16.77,57069960.25
08/17/2022,Expense,Shaffa,,Meals & Entertainment,169.37,57070129.62
08/17/2022,Expense,Four Ate Five,Mike ross,Credit Card - Ramp,16.77,57070146.39
08/17/2022,Expense,IPPUDO AUSTRALIA,Mike ross,Meals & Entertainment,22.05,57070168.44
08/17/2022,Expense,EntityA,CompanyB,Account1,-100000,56970168.44
08/17/2022,Expense,Shaffa,,Meals & Entertainment,169.37,56970337.81
08/17/2022,Expense,Four Ate Five,Mike ross,Meals & Entertainment,16.77,56970354.58
08/17/2022,Expense,Shaffa,Mike ross,Credit Card - Ramp,169.37,56970523.95
08/17/2022,Expense,IPPUDO AUSTRALIA,Mike ross,Meals & Entertainment,22.05,56970546
08/17/2022,Expense,Four Ate Five,Mike ross,Meals & Entertainment,16.77,56970562.77
08/17/2022,Expense,EntityA,CompanyB,Account2,-100000,56870562.77
08/17/2022,Expense,EntityA,CompanyB,Account1,-100000,56770562.77
08/17/2022,Expense,Four Ate Five,Mike ross,Credit Card - Ramp,16.77,56770579.54
08/17/2022,Expense,IPPUDO AUSTRALIA,Mike ross,Credit Card - Ramp,22.05,56770601.59
08/17/2022,Expense,EntityA,CompanyB,Account2,-100000,56670601.59
08/17/2022,Expense,IPPUDO AUSTRALIA,Mike ross,Meals & Entertainment,22.05,56670623.64
08/17/2022,Expense,Shaffa,,Meals & Entertainment,169.37,56670793.01
08/17/2022,Expense,EntityA,CompanyB,Account1,-100000,56570793.01
08/18/2022,Expense,Superhuman,,Professional Service Charges,30,56570823.01
08/18/2022,Expense,Conde Nast,Mike ross,Credit Card - Ramp,169.99,56570993
08/18/2022,Expense,LinkedIn,,Tools & Subscription - G&A,155.96,56571148.96
08/18/2022,Expense,Superhuman,Harvey Spector,Credit Card - Ramp,30,56571178.96
08/18/2022,Expense,Cuckoo Callay,Mike ross,Credit Card - Ramp,23.19,56571202.15
08/18/2022,Expense,LinkedIn,,Tools & Subscription - G&A,155.96,56571358.11
08/18/2022,Expense,Cuckoo Callay,Mike ross,Meals & Entertainment,23.19,56571381.3
08/18/2022,Expense,Conde Nast,,General business expenses:Memberships & subscriptions,169.99,56571551.29
08/18/2022,Expense,Superhuman,,Professional Service Charges,30,56571581.29
08/18/2022,Expense,Superhuman,Harvey Spector,Credit Card - Ramp,30,56571611.29
08/18/2022,Expense,EntityA,CompanyB,Account2,-100000,56471611.29
08/18/2022,Expense,LinkedIn,Mike ross,Credit Card - Ramp,155.96,56471767.25
08/18/2022,Expense,Cuckoo Callay,Mike ross,Credit Card - Ramp,23.19,56471790.44
08/18/2022,Expense,EntityA,CompanyB,Account1,-100000,56371790.44
08/18/2022,Expense,LinkedIn,Mike ross,Credit Card - Ramp,155.96,56371946.4
08/18/2022,Expense,Conde Nast,,General business expenses:Memberships & subscriptions,169.99,56372116.39
08/18/2022,Expense,Conde Nast,Mike ross,Credit Card - Ramp,169.99,56372286.38
08/18/2022,Expense,EntityA,CompanyB,Account2,-100000,56272286.38
08/18/2022,Expense,EntityA,CompanyB,Account2,-100000,56172286.38
08/18/2022,Expense,LinkedIn,,Tools & Subscription - G&A,155.96,56172442.34
08/18/2022,Expense,Superhuman,,Professional Service Charges,30,56172472.34
08/18/2022,Expense,Cuckoo Callay,Mike ross,Meals & Entertainment,23.19,56172495.53
08/18/2022,Expense,LinkedIn,,Tools & Subscription - G&A,155.96,56172651.49
08/18/2022,Expense,LinkedIn,Mike ross,Credit Card - Ramp,155.96,56172807.45
08/18/2022,Expense,EntityA,CompanyB,Account1,-100000,56072807.45
08/18/2022,Expense,EntityA,CompanyB,Account1,-100000,55972807.45
08/18/2022,Expense,Conde Nast,Mike ross,Credit Card - Ramp,169.99,55972977.44
08/18/2022,Expense,Cuckoo Callay,Mike ross,Meals & Entertainment,23.19,55973000.63
08/18/2022,Expense,Cuckoo Callay,Mike ross,Meals & Entertainment,23.19,55973023.82
08/18/2022,Expense,Superhuman,Harvey Spector,Credit Card - Ramp,30,55973053.82
08/18/2022,Expense,Conde Nast,,General business expenses:Memberships & subscriptions,169.99,55973223.81
08/18/2022,Expense,Superhuman,Harvey Spector,Credit Card - Ramp,30,55973253.81
08/18/2022,Expense,Conde Nast,Mike ross,Credit Card - Ramp,169.99,55973423.8
08/18/2022,Expense,EntityA,CompanyB,Account2,-100000,55873423.8
08/18/2022,Expense,Cuckoo Callay,Mike ross,Credit Card - Ramp,23.19,55873446.99
08/18/2022,Expense,Cuckoo Callay,Mike ross,Credit Card - Ramp,23.19,55873470.18
08/18/2022,Expense,EntityA,CompanyB,Account1,-100000,55773470.18
08/18/2022,Expense,Conde Nast,,General business expenses:Memberships & subscriptions,169.99,55773640.17
08/18/2022,Expense,Superhuman,,Professional Service Charges,30,55773670.17
08/19/2022,Expense,Reuben Hills,Mike ross,Meals & Entertainment,7.76,55773677.93
08/19/2022,Expense,Reuben Hills,Mike ross,Meals & Entertainment,7.76,55773685.69
08/19/2022,Expense,Reuben Hills,Mike ross,Meals & Entertainment,7.76,55773693.45
08/19/2022,Expense,Reuben Hills,Mike ross,Credit Card - Ramp,7.76,55773701.21
08/19/2022,Expense,GiftRocket,Chad Blumenthal,Credit Card - Ramp,25.75,55773726.96
08/19/2022,Expense,GiftRocket,Chad Blumenthal,Office expenses:Office supplies,25.75,55773752.71
08/19/2022,Expense,Reuben Hills,Mike ross,Credit Card - Ramp,7.76,55773760.47
08/19/2022,Expense,DoorDash,Mike ross,Credit Card - Ramp,9.41,55773769.88
08/19/2022,Expense,GiftRocket,Chad Blumenthal,Credit Card - Ramp,25.75,55773795.63
08/19/2022,Expense,DoorDash,Mike ross,Meals & Entertainment,9.41,55773805.04
08/19/2022,Expense,GiftRocket,Chad Blumenthal,Office expenses:Office supplies,25.75,55773830.79
08/19/2022,Expense,GiftRocket,Chad Blumenthal,Office expenses:Office supplies,25.75,55773856.54
08/19/2022,Expense,Reuben Hills,Mike ross,Credit Card - Ramp,7.76,55773864.3
08/19/2022,Expense,DoorDash,Mike ross,Credit Card - Ramp,9.41,55773873.71
08/19/2022,Expense,GiftRocket,Chad Blumenthal,Office expenses:Office supplies,25.75,55773899.46
08/19/2022,Expense,GiftRocket,Chad Blumenthal,Credit Card - Ramp,25.75,55773925.21
08/19/2022,Expense,DoorDash,Mike ross,Meals & Entertainment,9.41,55773934.62
08/19/2022,Expense,DoorDash,Mike ross,Credit Card - Ramp,9.41,55773944.03
08/19/2022,Expense,DoorDash,Mike ross,Meals & Entertainment,9.41,55773953.44
08/19/2022,Expense,Reuben Hills,Mike ross,Credit Card - Ramp,7.76,55773961.2
08/19/2022,Expense,GiftRocket,Chad Blumenthal,Credit Card - Ramp,25.75,55773986.95
08/19/2022,Expense,DoorDash,Mike ross,Meals & Entertainment,9.41,55773996.36
08/19/2022,Expense,DoorDash,Mike ross,Credit Card - Ramp,9.41,55774005.77
08/19/2022,Expense,Reuben Hills,Mike ross,Meals & Entertainment,7.76,55774013.53
08/20/2022,Expense,LinkedIn,,Tools & Subscription - G&A,124.38,55774137.91
08/20/2022,Expense,Dead Ringer,Mike ross,Credit Card - Ramp,72.26,55774210.17
08/20/2022,Expense,Dead Ringer,Mike ross,Credit Card - Ramp,72.26,55774282.43
08/20/2022,Expense,Dead Ringer,Mike ross,Meals & Entertainment,72.26,55774354.69
08/20/2022,Expense,Dead Ringer,Mike ross,Meals & Entertainment,72.26,55774426.95
08/20/2022,Expense,Dead Ringer,Mike ross,Meals & Entertainment,72.26,55774499.21
08/20/2022,Expense,LinkedIn,,Tools & Subscription - G&A,124.38,55774623.59
08/20/2022,Expense,LinkedIn,Niteesha Ravela,Credit Card - Ramp,124.38,55774747.97
08/20/2022,Expense,LinkedIn,,Tools & Subscription - G&A,124.38,55774872.35
08/20/2022,Expense,LinkedIn,Niteesha Ravela,Credit Card - Ramp,124.38,55774996.73
08/20/2022,Expense,Dead Ringer,Mike ross,Meals & Entertainment,72.26,55775068.99
08/20/2022,Expense,LinkedIn,Niteesha Ravela,Credit Card - Ramp,124.38,55775193.37
08/20/2022,Expense,Dead Ringer,Mike ross,Credit Card - Ramp,72.26,55775265.63
08/20/2022,Expense,Dead Ringer,Mike ross,Credit Card - Ramp,72.26,55775337.89
08/20/2022,Expense,LinkedIn,,Tools & Subscription - G&A,124.38,55775462.27
08/21/2022,Expense,Australia,Mike ross,Credit Card - Ramp,172.61,55775634.88
08/21/2022,Transfer,,PaymentServiceB Checking **7257,Savings (6977),100000,55875634.88
08/21/2022,Transfer,,PaymentServiceB Checking **7257,Savings (6977),100000,55975634.88
08/21/2022,Transfer,,PaymentServiceB Checking **7257,Account1,-100000,55875634.88
08/21/2022,Transfer,,PaymentServiceB Checking **7257,Account1,-100000,55775634.88
08/21/2022,Expense,Australia,Mike ross,Office expenses:Office supplies,172.61,55775807.49
08/21/2022,Expense,Australia,Mike ross,Credit Card - Ramp,172.61,55775980.1
08/21/2022,Expense,Australia,Mike ross,Credit Card - Ramp,172.61,55776152.71
08/21/2022,Expense,Australia,Mike ross,Credit Card - Ramp,172.61,55776325.32
08/21/2022,Transfer,,PaymentServiceB Checking **7257,Savings (6977),100000,55876325.32
08/21/2022,Transfer,,PaymentServiceB Checking **7257,Account1,-100000,55776325.32
08/21/2022,Expense,Australia,Mike ross,Office expenses:Office supplies,172.61,55776497.93
08/21/2022,Transfer,,PaymentServiceB Checking **7257,Savings (6977),100000,55876497.93
08/21/2022,Expense,Australia,Mike ross,Office expenses:Office supplies,172.61,55876670.54
08/21/2022,Expense,Australia,Mike ross,Office expenses:Office supplies,172.61,55876843.15
08/21/2022,Transfer,,PaymentServiceB Checking **7257,Account1,-100000,55776843.15
08/22/2022,Expense,La Panchina,Mike ross,Meals & Entertainment,34.66,55776877.81
08/22/2022,Expense,Inventus Law,"Inventus Law, (legal fee for seed round)",Account1,22500,55799377.81
08/22/2022,Credit Card Credit,Australia,Mike ross,Credit Card - Ramp,-170.74,55799207.07
08/22/2022,Credit Card Credit,Australia,Mike ross,Office expenses:Office supplies,-170.74,55799036.33
08/22/2022,Expense,Inventus Law,"Inventus Law, (legal fee for seed round)",Legal & accounting services:Legal Fees,-22500,55776536.33
08/22/2022,Credit Card Payment,,RAMP BUSINESS CO,Credit Card - Ramp,-5685.67,55770850.66
08/22/2022,Expense,Dovetail,,Tools & Subscription - G&A,36,55770886.66
08/22/2022,Credit Card Payment,,RAMP BUSINESS CO,Credit Card - Ramp,-5685.67,55765200.99
08/22/2022,Expense,Artificer,,Meals & Entertainment,6.59,55765207.58
08/22/2022,Expense,Inventus Law,"Inventus Law, (legal fee for seed round)",Legal & accounting services:Legal Fees,-22500,55742707.58
08/22/2022,Expense,ExpressVPN,Harvey Spector,Tools & Subscription - G&A,99.95,55742807.53
08/22/2022,Credit Card Credit,Australia,Mike ross,Credit Card - Ramp,-170.74,55742636.79
08/22/2022,Credit Card Payment,,RAMP BUSINESS CO,Account1,-5685.67,55736951.12
08/22/2022,Expense,Artificer,Mike ross,Credit Card - Ramp,6.59,55736957.71
08/22/2022,Expense,La Panchina,Mike ross,Credit Card - Ramp,34.66,55736992.37
08/22/2022,Expense,La Panchina,Mike ross,Credit Card - Ramp,34.66,55737027.03
08/22/2022,Expense,Inventus Law,"Inventus Law, (legal fee for seed round)",Account1,22500,55759527.03
08/22/2022,Expense,Automate,,Tools & Subscription - G&A,29,55759556.03
08/22/2022,Expense,Inventus Law,"Inventus Law, (legal fee for seed round)",Account1,22500,55782056.03
08/22/2022,Expense,La Panchina,Mike ross,Credit Card - Ramp,34.66,55782090.69
08/22/2022,Expense,Artificer,Mike ross,Credit Card - Ramp,6.59,55782097.28
08/22/2022,Expense,ExpressVPN,Harvey Spector,Tools & Subscription - G&A,99.95,55782197.23
08/22/2022,Credit Card Payment,,RAMP BUSINESS CO,Account1,-5685.67,55776511.56
08/22/2022,Expense,Artificer,,Meals & Entertainment,6.59,55776518.15
08/22/2022,Expense,Dovetail,,Tools & Subscription - G&A,36,55776554.15
08/22/2022,Credit Card Credit,Australia,Mike ross,Office expenses:Office supplies,-170.74,55776383.41
08/22/2022,Expense,Automate,,Tools & Subscription - G&A,29,55776412.41
08/22/2022,Expense,Vimcal,,Tools & Subscription - G&A,15,55776427.41
08/22/2022,Expense,ExpressVPN,Harvey Spector,Tools & Subscription - G&A,99.95,55776527.36
08/22/2022,Credit Card Payment,,RAMP BUSINESS CO,Account1,-5685.67,55770841.69
08/22/2022,Expense,Artificer,,Meals & Entertainment,6.59,55770848.28
08/22/2022,Credit Card Credit,Australia,Mike ross,Office expenses:Office supplies,-170.74,55770677.54
08/22/2022,Expense,Artificer,Mike ross,Credit Card - Ramp,6.59,55770684.13
08/22/2022,Expense,Automate,,Tools & Subscription - G&A,29,55770713.13
08/22/2022,Expense,La Panchina,Mike ross,Meals & Entertainment,34.66,55770747.79
08/22/2022,Expense,Dovetail,Harvey Spector,Credit Card - Ramp,36,55770783.79
08/22/2022,Credit Card Payment,,RAMP BUSINESS CO,Credit Card - Ramp,-5685.67,55765098.12
08/22/2022,Expense,Inventus Law,"Inventus Law, (legal fee for seed round)",Legal & accounting services:Legal Fees,-22500,55742598.12
08/22/2022,Expense,Dovetail,Harvey Spector,Credit Card - Ramp,36,55742634.12
08/22/2022,Expense,ExpressVPN,Harvey Spector,Credit Card - Ramp,99.95,55742734.07
08/22/2022,Credit Card Payment,,RAMP BUSINESS CO,Credit Card - Ramp,-5685.67,55737048.4
08/22/2022,Expense,Dovetail,Harvey Spector,Credit Card - Ramp,36,55737084.4
08/22/2022,Expense,Inventus Law,"Inventus Law, (legal fee for seed round)",Account1,22500,55759584.4
08/22/2022,Expense,Automate,Balapavan Tirumani,Credit Card - Ramp,29,55759613.4
08/22/2022,Expense,ExpressVPN,Harvey Spector,Credit Card - Ramp,99.95,55759713.35
08/22/2022,Expense,Vimcal,,Tools & Subscription - G&A,15,55759728.35
08/22/2022,Expense,Vimcal,Harvey Spector,Credit Card - Ramp,15,55759743.35
08/22/2022,Expense,Inventus Law,"Inventus Law, (legal fee for seed round)",Legal & accounting services:Legal Fees,-22500,55737243.35
08/22/2022,Expense,La Panchina,Mike ross,Credit Card - Ramp,34.66,55737278.01
08/22/2022,Expense,Artificer,Mike ross,Credit Card - Ramp,6.59,55737284.6
08/22/2022,Expense,Vimcal,,Tools & Subscription - G&A,15,55737299.6
08/22/2022,Expense,Automate,Balapavan Tirumani,Credit Card - Ramp,29,55737328.6
08/22/2022,Expense,Dovetail,,Tools & Subscription - G&A,36,55737364.6
08/22/2022,Expense,La Panchina,Mike ross,Meals & Entertainment,34.66,55737399.26
08/22/2022,Credit Card Credit,Australia,Mike ross,Credit Card - Ramp,-170.74,55737228.52
08/22/2022,Credit Card Credit,Australia,Mike ross,Credit Card - Ramp,-170.74,55737057.78
08/22/2022,Expense,ExpressVPN,Harvey Spector,Credit Card - Ramp,99.95,55737157.73
08/22/2022,Expense,Vimcal,,Tools & Subscription - G&A,15,55737172.73
08/22/2022,Expense,La Panchina,Mike ross,Meals & Entertainment,34.66,55737207.39
08/22/2022,Expense,Dovetail,,Tools & Subscription - G&A,36,55737243.39
08/22/2022,Expense,Automate,Balapavan Tirumani,Credit Card - Ramp,29,55737272.39
08/22/2022,Credit Card Credit,Australia,Mike ross,Office expenses:Office supplies,-170.74,55737101.65
08/22/2022,Expense,Artificer,,Meals & Entertainment,6.59,55737108.24
08/22/2022,Credit Card Payment,,RAMP BUSINESS CO,Account1,-5685.67,55731422.57
08/22/2022,Expense,ExpressVPN,Harvey Spector,Tools & Subscription - G&A,99.95,55731522.52
08/22/2022,Expense,Vimcal,Harvey Spector,Credit Card - Ramp,15,55731537.52
08/22/2022,Expense,Vimcal,Harvey Spector,Credit Card - Ramp,15,55731552.52
08/22/2022,Expense,Automate,,Tools & Subscription - G&A,29,55731581.52
08/23/2022,Expense,Superhuman,,Professional Service Charges,30,55731611.52
08/23/2022,Expense,Bourke Street Bakery,Mike ross,Meals & Entertainment,12.26,55731623.78
08/23/2022,Expense,Super,,Tools & Subscription - G&A,12,55731635.78
08/23/2022,Expense,Super,Harvey Spector,Credit Card - Ramp,12,55731647.78
08/23/2022,Expense,Superhuman,Mike ross,Credit Card - Ramp,30,55731677.78
08/23/2022,Expense,Bourke Street Bakery,Mike ross,Credit Card - Ramp,12.26,55731690.04
08/23/2022,Expense,Super,Harvey Spector,Credit Card - Ramp,12,55731702.04
08/23/2022,Expense,Super,,Tools & Subscription - G&A,12,55731714.04
08/23/2022,Deposit,EntityA,[RETURN] CompanyB,Account2,100000,55831714.04
08/23/2022,Expense,Superhuman,Mike ross,Credit Card - Ramp,30,55831744.04
08/23/2022,Expense,Super,Harvey Spector,Credit Card - Ramp,12,55831756.04
08/23/2022,Expense,Bourke Street Bakery,Mike ross,Credit Card - Ramp,12.26,55831768.3
08/23/2022,Deposit,EntityA,[RETURN] CompanyB,Account1,100000,55931768.3
08/23/2022,Expense,Bourke Street Bakery,Mike ross,Meals & Entertainment,12.26,55931780.56
08/23/2022,Expense,Superhuman,,Professional Service Charges,30,55931810.56
08/23/2022,Expense,Bourke Street Bakery,Mike ross,Credit Card - Ramp,12.26,55931822.82
08/23/2022,Expense,Superhuman,,Professional Service Charges,30,55931852.82
08/23/2022,Deposit,EntityA,[RETURN] CompanyB,Account1,100000,56031852.82
08/23/2022,Deposit,EntityA,[RETURN] CompanyB,Account2,100000,56131852.82
08/23/2022,Deposit,EntityA,[RETURN] CompanyB,Account2,100000,56231852.82
08/23/2022,Expense,Bourke Street Bakery,Mike ross,Credit Card - Ramp,12.26,56231865.08
08/23/2022,Expense,Superhuman,Mike ross,Credit Card - Ramp,30,56231895.08
08/23/2022,Deposit,EntityA,[RETURN] CompanyB,Account2,100000,56331895.08
08/23/2022,Expense,Superhuman,,Professional Service Charges,30,56331925.08
08/23/2022,Expense,Super,,Tools & Subscription - G&A,12,56331937.08
08/23/2022,Expense,Super,,Tools & Subscription - G&A,12,56331949.08
08/23/2022,Expense,Bourke Street Bakery,Mike ross,Meals & Entertainment,12.26,56331961.34
08/23/2022,Deposit,EntityA,[RETURN] CompanyB,Account1,100000,56431961.34
08/23/2022,Expense,Superhuman,Mike ross,Credit Card - Ramp,30,56431991.34
08/23/2022,Deposit,EntityA,[RETURN] CompanyB,Account1,100000,56531991.34
08/23/2022,Expense,Bourke Street Bakery,Mike ross,Meals & Entertainment,12.26,56532003.6
08/24/2022,Expense,Cuckoo Callay,Mike ross,Credit Card - Ramp,16.27,56532019.87
08/24/2022,Expense,Zoom,,Tools & Subscription - G&A,14.62,56532034.49
08/24/2022,Expense,Cuckoo Callay,Mike ross,Meals & Entertainment,16.27,56532050.76
08/24/2022,Expense,VFS Global,Mike ross,Credit Card - Ramp,112.79,56532163.55
08/24/2022,Expense,Zoom,Amani Shariff,Credit Card - Ramp,14.62,56532178.17
08/24/2022,Expense,Cuckoo Callay,Mike ross,Meals & Entertainment,16.27,56532194.44
08/24/2022,Expense,Officeworks,Mike ross,Credit Card - Ramp,10.43,56532204.87
08/24/2022,Expense,Zoom,,Tools & Subscription - G&A,14.62,56532219.49
08/24/2022,Expense,VFS Global,Mike ross,Tools & Subscription - G&A,112.79,56532332.28
08/24/2022,Expense,Officeworks,Mike ross,Credit Card - Ramp,10.43,56532342.71
08/24/2022,Expense,Qantas,Mike ross,Credit Card - Ramp,2199.34,56534542.05
08/24/2022,Expense,Cuckoo Callay,Mike ross,Meals & Entertainment,16.27,56534558.32
08/24/2022,Expense,Officeworks,,Office expenses,10.43,56534568.75
08/24/2022,Expense,Cuckoo Callay,Mike ross,Credit Card - Ramp,16.27,56534585.02
08/24/2022,Expense,Qantas,,Travel:Airfare,2199.34,56536784.36
08/24/2022,Expense,Officeworks,Mike ross,Credit Card - Ramp,10.43,56536794.79
08/24/2022,Expense,Zoom,,Tools & Subscription - G&A,14.62,56536809.41
08/24/2022,Expense,Officeworks,,Office expenses,10.43,56536819.84
08/24/2022,Expense,Qantas,,Travel:Airfare,2199.34,56539019.18
08/24/2022,Expense,Qantas,Mike ross,Credit Card - Ramp,2199.34,56541218.52
08/24/2022,Expense,Zoom,Amani Shariff,Credit Card - Ramp,14.62,56541233.14
08/24/2022,Expense,Zoom,Amani Shariff,Credit Card - Ramp,14.62,56541247.76
08/24/2022,Expense,VFS Global,Mike ross,Credit Card - Ramp,112.79,56541360.55
08/24/2022,Expense,VFS Global,Mike ross,Tools & Subscription - G&A,112.79,56541473.34
08/24/2022,Expense,Qantas,,Travel:Airfare,2199.34,56543672.68
08/24/2022,Expense,Officeworks,,Office expenses,10.43,56543683.11
08/24/2022,Expense,VFS Global,Mike ross,Tools & Subscription - G&A,112.79,56543795.9
08/24/2022,Expense,VFS Global,Mike ross,Tools & Subscription - G&A,112.79,56543908.69
08/24/2022,Expense,Cuckoo Callay,Mike ross,Credit Card - Ramp,16.27,56543924.96
08/24/2022,Expense,Officeworks,Mike ross,Credit Card - Ramp,10.43,56543935.39
08/24/2022,Expense,Zoom,,Tools & Subscription - G&A,14.62,56543950.01
08/24/2022,Expense,Qantas,,Travel:Airfare,2199.34,56546149.35
08/24/2022,Expense,Officeworks,,Office expenses,10.43,56546159.78
08/24/2022,Expense,Cuckoo Callay,Mike ross,Credit Card - Ramp,16.27,56546176.05
08/24/2022,Expense,Qantas,Mike ross,Credit Card - Ramp,2199.34,56548375.39
08/24/2022,Expense,Cuckoo Callay,Mike ross,Meals & Entertainment,16.27,56548391.66
08/24/2022,Expense,VFS Global,Mike ross,Credit Card - Ramp,112.79,56548504.45
08/25/2022,Expense,Design Studio,"Design Studio, transfer fees from the bank",Account1,202.64,56548707.09
08/25/2022,Expense,Reuben Hills,Mike ross,Meals & Entertainment,12.65,56548719.74
08/25/2022,Expense,Zoom,,Tools & Subscription - G&A,14.99,56548734.73
08/25/2022,Expense,Reuben Hills,Mike ross,Meals & Entertainment,12.65,56548747.38
08/25/2022,Expense,Artificer,Mike ross,Credit Card - Ramp,3.15,56548750.53
08/25/2022,Expense,Reuben Hills,Mike ross,Meals & Entertainment,19.24,56548769.77
08/25/2022,Expense,Artificer,Mike ross,Credit Card - Ramp,6.65,56548776.42
08/25/2022,Expense,Reuben Hills,Mike ross,Credit Card - Ramp,19.24,56548795.66
08/25/2022,Expense,Design Studio,"Design Studio, transfer fees from the bank",General business expenses:Bank fees & service charges,-202.64,56548593.02
08/25/2022,Expense,Reuben Hills,Mike ross,Credit Card - Ramp,12.65,56548605.67
08/25/2022,Expense,Design Studio,Design Studio,Advertising & marketing,-20264.2,56528341.47
08/25/2022,Expense,Design Studio,"Design Studio, transfer fees from the bank",Account1,202.64,56528544.11
08/25/2022,Expense,Wings And Tins,Mike ross,Credit Card - Ramp,39.49,56528583.6
08/25/2022,Expense,Design Studio,"Design Studio, transfer fees from the bank",General business expenses:Bank fees & service charges,-202.64,56528380.96
08/25/2022,Expense,Artificer,,Meals & Entertainment,6.65,56528387.61
08/25/2022,Expense,Design Studio,Design Studio,Advertising & marketing,-20264.2,56508123.41
08/25/2022,Expense,Wings And Tins,Mike ross,Meals & Entertainment,39.49,56508162.9
08/25/2022,Expense,Miro,,Tools & Subscription - G&A,90,56508252.9
08/25/2022,Expense,Artificer,Mike ross,Credit Card - Ramp,6.65,56508259.55
08/25/2022,Expense,Artificer,,Meals & Entertainment,3.15,56508262.7
08/25/2022,Expense,Zoom,,Tools & Subscription - G&A,14.99,56508277.69
08/25/2022,Expense,Reuben Hills,Mike ross,Meals & Entertainment,19.24,56508296.93
08/25/2022,Expense,Reuben Hills,Mike ross,Credit Card - Ramp,19.24,56508316.17
08/25/2022,Expense,Artificer,Mike ross,Credit Card - Ramp,3.15,56508319.32
08/25/2022,Expense,Reuben Hills,Mike ross,Meals & Entertainment,12.65,56508331.97
08/25/2022,Expense,Reuben Hills,Mike ross,Credit Card - Ramp,12.65,56508344.62
08/25/2022,Expense,Artificer,,Meals & Entertainment,3.15,56508347.77
08/25/2022,Expense,Miro,Mike ross,Credit Card - Ramp,90,56508437.77
08/25/2022,Expense,Zoom,Chad Blumenthal,Credit Card - Ramp,14.99,56508452.76
08/25/2022,Expense,Design Studio,Design Studio,Advertising & marketing,-20264.2,56488188.56
08/25/2022,Expense,Design Studio,"Design Studio, transfer fees from the bank",General business expenses:Bank fees & service charges,-202.64,56487985.92
08/25/2022,Expense,Wings And Tins,Mike ross,Credit Card - Ramp,39.49,56488025.41
08/25/2022,Expense,Miro,,Tools & Subscription - G&A,90,56488115.41
08/25/2022,Expense,Artificer,,Meals & Entertainment,6.65,56488122.06
08/25/2022,Expense,Reuben Hills,Mike ross,Meals & Entertainment,19.24,56488141.3
08/25/2022,Expense,Artificer,Mike ross,Credit Card - Ramp,6.65,56488147.95
08/25/2022,Expense,Design Studio,Design Studio,Advertising & marketing,-20264.2,56467883.75
08/25/2022,Expense,Zoom,Chad Blumenthal,Credit Card - Ramp,14.99,56467898.74
08/25/2022,Expense,Artificer,,Meals & Entertainment,3.15,56467901.89
08/25/2022,Expense,Miro,Mike ross,Credit Card - Ramp,90,56467991.89
08/25/2022,Expense,Design Studio,"Design Studio, transfer fees from the bank",Account1,202.64,56468194.53
08/25/2022,Expense,Design Studio,Design Studio,Account1,20264.2,56488458.73
08/25/2022,Expense,Wings And Tins,Mike ross,Meals & Entertainment,39.49,56488498.22
08/25/2022,Expense,Design Studio,Design Studio,Account1,20264.2,56508762.42
08/25/2022,Expense,Zoom,Chad Blumenthal,Credit Card - Ramp,14.99,56508777.41
08/25/2022,Expense,Wings And Tins,Mike ross,Meals & Entertainment,39.49,56508816.9
08/25/2022,Expense,Reuben Hills,Mike ross,Meals & Entertainment,19.24,56508836.14
08/25/2022,Expense,Zoom,,Tools & Subscription - G&A,14.99,56508851.13
08/25/2022,Expense,Design Studio,"Design Studio, transfer fees from the bank",Account1,202.64,56509053.77
08/25/2022,Expense,Miro,,Tools & Subscription - G&A,90,56509143.77
08/25/2022,Expense,Miro,,Tools & Subscription - G&A,90,56509233.77
08/25/2022,Expense,Miro,Mike ross,Credit Card - Ramp,90,56509323.77
08/25/2022,Expense,Artificer,Mike ross,Credit Card - Ramp,3.15,56509326.92
08/25/2022,Expense,Artificer,,Meals & Entertainment,6.65,56509333.57
08/25/2022,Expense,Wings And Tins,Mike ross,Credit Card - Ramp,39.49,56509373.06
08/25/2022,Expense,Artificer,,Meals & Entertainment,6.65,56509379.71
08/25/2022,Expense,Design Studio,"Design Studio, transfer fees from the bank",General business expenses:Bank fees & service charges,-202.64,56509177.07
08/25/2022,Expense,Wings And Tins,Mike ross,Meals & Entertainment,39.49,56509216.56
08/25/2022,Expense,Design Studio,Design Studio,Account1,20264.2,56529480.76
08/25/2022,Expense,Reuben Hills,Mike ross,Credit Card - Ramp,19.24,56529500
08/25/2022,Expense,Reuben Hills,Mike ross,Credit Card - Ramp,12.65,56529512.65
08/25/2022,Expense,Design Studio,Design Studio,Account1,20264.2,56549776.85
08/25/2022,Expense,Artificer,Mike ross,Credit Card - Ramp,3.15,56549780
08/25/2022,Expense,Reuben Hills,Mike ross,Meals & Entertainment,12.65,56549792.65
08/25/2022,Expense,Reuben Hills,Mike ross,Credit Card - Ramp,19.24,56549811.89
08/25/2022,Expense,Wings And Tins,Mike ross,Credit Card - Ramp,39.49,56549851.38
08/25/2022,Expense,Zoom,,Tools & Subscription - G&A,14.99,56549866.37
08/25/2022,Expense,Artificer,Mike ross,Credit Card - Ramp,6.65,56549873.02
08/25/2022,Expense,Reuben Hills,Mike ross,Credit Card - Ramp,12.65,56549885.67
08/25/2022,Expense,Artificer,,Meals & Entertainment,3.15,56549888.82
08/26/2022,Expense,Typeform,Harvey Spector,Credit Card - Ramp,9.38,56549898.2
08/26/2022,Expense,Typeform,Harvey Spector,Credit Card - Ramp,9.38,56549907.58
08/26/2022,Expense,Typeform,,Tools & Subscription - G&A,9.38,56549916.96
08/26/2022,Expense,Bourke Street Bakery,Mike ross,Meals & Entertainment,23.49,56549940.45
08/26/2022,Expense,Typeform,,Tools & Subscription - G&A,9.38,56549949.83
08/26/2022,Expense,Bourke Street Bakery,Mike ross,Credit Card - Ramp,23.49,56549973.32
08/26/2022,Expense,Bourke Street Bakery,Mike ross,Meals & Entertainment,23.49,56549996.81
08/26/2022,Expense,Typeform,Harvey Spector,Credit Card - Ramp,9.38,56550006.19
08/26/2022,Expense,Bourke Street Bakery,Mike ross,Meals & Entertainment,23.49,56550029.68
08/26/2022,Expense,Bourke Street Bakery,Mike ross,Credit Card - Ramp,23.49,56550053.17
08/26/2022,Expense,Typeform,,Tools & Subscription - G&A,9.38,56550062.55
08/26/2022,Expense,Bourke Street Bakery,Mike ross,Meals & Entertainment,23.49,56550086.04
08/26/2022,Expense,Bourke Street Bakery,Mike ross,Credit Card - Ramp,23.49,56550109.53
08/26/2022,Expense,Bourke Street Bakery,Mike ross,Credit Card - Ramp,23.49,56550133.02
08/26/2022,Expense,Typeform,,Tools & Subscription - G&A,9.38,56550142.4
08/27/2022,Expense,Sentry,,Tools & Subscription - G&A,29,56550171.4
08/27/2022,Expense,Sendinblue,,Tools & Subscription - G&A,57.86,56550229.26
08/27/2022,Expense,Splitbee,,Tools & Subscription - G&A,16.52,56550245.78
08/27/2022,Expense,Splitbee,,Tools & Subscription - G&A,16.52,56550262.3
08/27/2022,Expense,Sentry,,Tools & Subscription - G&A,29,56550291.3
08/27/2022,Expense,Splitbee,,Tools & Subscription - G&A,16.52,56550307.82
08/27/2022,Expense,Sentry,,Tools & Subscription - G&A,29,56550336.82
08/27/2022,Expense,Sendinblue,Balapavan Tirumani,Credit Card - Ramp,57.86,56550394.68
08/27/2022,Expense,Sendinblue,,Tools & Subscription - G&A,57.86,56550452.54
08/27/2022,Expense,Sendinblue,,Tools & Subscription - G&A,57.86,56550510.4
08/27/2022,Expense,Sendinblue,Balapavan Tirumani,Credit Card - Ramp,57.86,56550568.26
08/27/2022,Expense,Splitbee,Harris Jose,Credit Card - Ramp,16.52,56550584.78
08/27/2022,Expense,Sendinblue,,Tools & Subscription - G&A,57.86,56550642.64
08/27/2022,Expense,Splitbee,Harris Jose,Credit Card - Ramp,16.52,56550659.16
08/27/2022,Expense,Sentry,,Tools & Subscription - G&A,29,56550688.16
08/27/2022,Expense,Sendinblue,Balapavan Tirumani,Credit Card - Ramp,57.86,56550746.02
08/27/2022,Expense,Splitbee,Harris Jose,Credit Card - Ramp,16.52,56550762.54
08/27/2022,Expense,Sentry,Balapavan Tirumani,Credit Card - Ramp,29,56550791.54
08/27/2022,Expense,Splitbee,,Tools & Subscription - G&A,16.52,56550808.06
08/27/2022,Expense,Sentry,Balapavan Tirumani,Credit Card - Ramp,29,56550837.06
08/27/2022,Expense,Sentry,Balapavan Tirumani,Credit Card - Ramp,29,56550866.06
08/28/2022,Expense,Vistara,Harvey Spector,Credit Card - Ramp,82.24,56550948.3
08/28/2022,Expense,Vistara,,Travel:Airfare,82.24,56551030.54
08/28/2022,Expense,Vistara,Harvey Spector,Credit Card - Ramp,82.24,56551112.78
08/28/2022,Expense,Vistara,Harvey Spector,Credit Card - Ramp,82.24,56551195.02
08/28/2022,Expense,Vistara,,Travel:Airfare,82.24,56551277.26
08/28/2022,Expense,Vistara,,Travel:Airfare,82.24,56551359.5
08/28/2022,Expense,Vistara,,Travel:Airfare,82.24,56551441.74
08/29/2022,Expense,Netlify,,Tools & Subscription - G&A,114,56551555.74
08/29/2022,Expense,Netlify,Balapavan Tirumani,Credit Card - Ramp,114,56551669.74
08/29/2022,Expense,Netlify,Balapavan Tirumani,Credit Card - Ramp,114,56551783.74
08/29/2022,Expense,Netlify,Balapavan Tirumani,Credit Card - Ramp,114,56551897.74
08/29/2022,Expense,Netlify,,Tools & Subscription - G&A,114,56552011.74
08/29/2022,Expense,Netlify,,Tools & Subscription - G&A,114,56552125.74
08/29/2022,Expense,Netlify,,Tools & Subscription - G&A,114,56552239.74
08/30/2022,Expense,Zapier,,Tools & Subscription - G&A,29.99,56552269.73
08/30/2022,Expense,El Loco at Excelsior,Mike ross,Meals & Entertainment,19.61,56552289.34
08/30/2022,Expense,Zapier,,Tools & Subscription - G&A,29.99,56552319.33
08/30/2022,Expense,El Loco at Excelsior,Mike ross,Credit Card - Ramp,19.61,56552338.94
08/30/2022,Expense,El Loco at Excelsior,Mike ross,Meals & Entertainment,19.61,56552358.55
08/30/2022,Expense,Zapier,,Tools & Subscription - G&A,29.99,56552388.54
08/30/2022,Expense,El Loco at Excelsior,Mike ross,Meals & Entertainment,19.61,56552408.15
08/30/2022,Expense,Zapier,Chad Blumenthal,Credit Card - Ramp,29.99,56552438.14
08/30/2022,Expense,El Loco at Excelsior,Mike ross,Meals & Entertainment,19.61,56552457.75
08/30/2022,Expense,Zapier,Chad Blumenthal,Credit Card - Ramp,29.99,56552487.74
08/30/2022,Expense,El Loco at Excelsior,Mike ross,Credit Card - Ramp,19.61,56552507.35
08/30/2022,Expense,El Loco at Excelsior,Mike ross,Credit Card - Ramp,19.61,56552526.96
08/30/2022,Expense,El Loco at Excelsior,Mike ross,Credit Card - Ramp,19.61,56552546.57
08/30/2022,Expense,Zapier,Chad Blumenthal,Credit Card - Ramp,29.99,56552576.56
08/30/2022,Expense,Zapier,,Tools & Subscription - G&A,29.99,56552606.55
08/31/2022,Expense,Uber,Mike ross,Credit Card - Ramp,13.37,56552619.92
08/31/2022,Expense,Income Capitals ,Income Capitals ,Account1,8853.98,56561473.9
08/31/2022,Bill,Big Company ,,Outsources Services - India,34255.29,56595729.19
08/31/2022,Expense,Income Capitals ,Income Capitals ,Account1,8853.98,56604583.17
08/31/2022,Expense,Adobe,Mike ross,Credit Card - Ramp,15.06,56604598.23
08/31/2022,Expense,Income Capitals ,Income Capitals ,Contract labor,-8853.98,56595744.25
08/31/2022,Expense,Adobe,Mike ross,Credit Card - Ramp,15.06,56595759.31
08/31/2022,Expense,Above Par,Mike ross,Credit Card - Ramp,71.68,56595830.99
08/31/2022,Bill,Big Company ,,Outsources Services - India,34255.29,56630086.28
08/31/2022,Expense,Uber,,Travelling Expenses,13.37,56630099.65
08/31/2022,Expense,Income Capitals ,Income Capitals ,Contract labor,-8853.98,56621245.67
08/31/2022,Bill,Big Company ,"Service Expenses for the month of August 2022 
INR 2730831 @ 79.72",Accounts Payable (A/P),34255.29,56655500.96
08/31/2022,Expense,Income Capitals ,Income Capitals ,Contract labor,-8853.98,56646646.98
08/31/2022,Expense,Income Capitals ,Income Capitals ,Contract labor,-8853.98,56637793
08/31/2022,Expense,Above Par,Mike ross,Meals & Entertainment,71.68,56637864.68
08/31/2022,Expense,Uber,,Travelling Expenses,13.37,56637878.05
08/31/2022,Expense,Adobe,,Tools & Subscription - S&M,15.06,56637893.11
08/31/2022,Bill,Big Company ,"Service Expenses for the month of August 2022 
INR 2730831 @ 79.72",Accounts Payable (A/P),34255.29,56672148.4
08/31/2022,Expense,Above Par,Mike ross,Meals & Entertainment,71.68,56672220.08
08/31/2022,Bill,Big Company ,,Outsources Services - India,34255.29,56706475.37
08/31/2022,Expense,Above Par,Mike ross,Credit Card - Ramp,71.68,56706547.05
08/31/2022,Bill,Big Company ,"Service Expenses for the month of August 2022 
INR 2730831 @ 79.72",Accounts Payable (A/P),34255.29,56740802.34
08/31/2022,Bill,Big Company ,,Outsources Services - India,34255.29,56775057.63
08/31/2022,Expense,Above Par,Mike ross,Meals & Entertainment,71.68,56775129.31
08/31/2022,Expense,Above Par,Mike ross,Meals & Entertainment,71.68,56775200.99
08/31/2022,Expense,Uber,Mike ross,Credit Card - Ramp,13.37,56775214.36
08/31/2022,Expense,Income Capitals ,Income Capitals ,Account1,8853.98,56784068.34
08/31/2022,Expense,Uber,Mike ross,Credit Card - Ramp,13.37,56784081.71
08/31/2022,Bill,Big Company ,"Service Expenses for the month of August 2022 
INR 2730831 @ 79.72",Accounts Payable (A/P),34255.29,56818337
08/31/2022,Expense,Adobe,,Tools & Subscription - S&M,15.06,56818352.06
08/31/2022,Expense,Adobe,,Tools & Subscription - S&M,15.06,56818367.12
08/31/2022,Expense,Adobe,Mike ross,Credit Card - Ramp,15.06,56818382.18
08/31/2022,Expense,Above Par,Mike ross,Credit Card - Ramp,71.68,56818453.86
08/31/2022,Expense,Uber,,Travelling Expenses,13.37,56818467.23
08/31/2022,Expense,Adobe,,Tools & Subscription - S&M,15.06,56818482.29
08/31/2022,Expense,Above Par,Mike ross,Credit Card - Ramp,71.68,56818553.97
08/31/2022,Expense,Income Capitals ,Income Capitals ,Account1,8853.98,56827407.95
08/31/2022,Expense,Uber,,Travelling Expenses,13.37,56827421.32
09/01/2022,Expense,Vistara,,Travel:Airfare,6.58,56827427.9
09/01/2022,Expense,Cuckoo Callay,Mike ross,Credit Card - Ramp,21.02,56827448.92
09/01/2022,Expense,Cuckoo Callay,Mike ross,Credit Card - Ramp,21.02,56827469.94
09/01/2022,Expense,Google G Suite,Mike ross,Credit Card - Ramp,108.49,56827578.43
09/01/2022,Expense,Typeform,Harvey Spector,Credit Card - Ramp,590,56828168.43
09/01/2022,Expense,Sang by Mabasa,Mike ross,Credit Card - Ramp,64.58,56828233.01
09/01/2022,Expense,Sang by Mabasa,Mike ross,Credit Card - Ramp,64.58,56828297.59
09/01/2022,Expense,Typeform,Harvey Spector,Credit Card - Ramp,590,56828887.59
09/01/2022,Expense,Sang by Mabasa,Mike ross,Meals & Entertainment,64.58,56828952.17
09/01/2022,Expense,Cuckoo Callay,Mike ross,Meals & Entertainment,21.02,56828973.19
09/01/2022,Expense,Vistara,,Travel:Airfare,6.58,56828979.77
09/01/2022,Expense,Cuckoo Callay,Mike ross,Credit Card - Ramp,21.02,56829000.79
09/01/2022,Expense,Sang by Mabasa,Mike ross,Credit Card - Ramp,64.58,56829065.37
09/01/2022,Expense,Google G Suite,,Tools & Subscription - G&A,108.49,56829173.86
09/01/2022,Expense,Typeform,,Tools & Subscription - G&A,590,56829763.86
09/01/2022,Expense,Cuckoo Callay,Mike ross,Credit Card - Ramp,21.02,56829784.88
09/01/2022,Expense,Vistara,Harvey Spector,Credit Card - Ramp,6.58,56829791.46
09/01/2022,Expense,Google G Suite,Mike ross,Credit Card - Ramp,108.49,56829899.95
09/01/2022,Expense,Typeform,Harvey Spector,Credit Card - Ramp,590,56830489.95
09/01/2022,Expense,Google G Suite,,Tools & Subscription - G&A,108.49,56830598.44
09/01/2022,Expense,Cuckoo Callay,Mike ross,Meals & Entertainment,21.02,56830619.46
09/01/2022,Expense,Sang by Mabasa,Mike ross,Meals & Entertainment,64.58,56830684.04
09/01/2022,Expense,Vistara,Harvey Spector,Credit Card - Ramp,6.58,56830690.62
09/01/2022,Expense,Vistara,,Travel:Airfare,6.58,56830697.2
09/01/2022,Expense,Google G Suite,,Tools & Subscription - G&A,108.49,56830805.69
09/01/2022,Expense,Vistara,,Travel:Airfare,6.58,56830812.27
09/01/2022,Expense,Cuckoo Callay,Mike ross,Meals & Entertainment,21.02,56830833.29
09/01/2022,Expense,Google G Suite,,Tools & Subscription - G&A,108.49,56830941.78
09/01/2022,Expense,Typeform,,Tools & Subscription - G&A,590,56831531.78
09/01/2022,Expense,Vistara,Harvey Spector,Credit Card - Ramp,6.58,56831538.36
09/01/2022,Expense,Typeform,,Tools & Subscription - G&A,590,56832128.36
09/01/2022,Expense,Google G Suite,Mike ross,Credit Card - Ramp,108.49,56832236.85
09/01/2022,Expense,Sang by Mabasa,Mike ross,Meals & Entertainment,64.58,56832301.43
09/01/2022,Expense,Typeform,,Tools & Subscription - G&A,590,56832891.43
09/01/2022,Expense,Sang by Mabasa,Mike ross,Meals & Entertainment,64.58,56832956.01
09/01/2022,Expense,Cuckoo Callay,Mike ross,Meals & Entertainment,21.02,56832977.03
09/01/2022,Expense,Sang by Mabasa,Mike ross,Credit Card - Ramp,64.58,56833041.61
09/02/2022,Expense,Dovetail,Harvey Spector,Credit Card - Ramp,21.7,56833063.31
09/02/2022,Expense,Mtw,,Tools & Subscription - G&A,19,56833082.31
09/02/2022,Expense,Render,,Tools & Subscription - G&A,14,56833096.31
09/02/2022,Expense,Render,,Tools & Subscription - G&A,14,56833110.31
09/02/2022,Expense,Mtw,,Tools & Subscription - G&A,19,56833129.31
09/02/2022,Expense,Dovetail,,Tools & Subscription - G&A,21.7,56833151.01
09/02/2022,Expense,Render,,Tools & Subscription - G&A,14,56833165.01
09/02/2022,Expense,Dovetail,,Tools & Subscription - G&A,21.7,56833186.71
09/02/2022,Expense,Mtw,Harvey Spector,Credit Card - Ramp,19,56833205.71
09/02/2022,Expense,Mtw,,Tools & Subscription - G&A,19,56833224.71
09/02/2022,Expense,Render,Balapavan Tirumani,Credit Card - Ramp,14,56833238.71
09/02/2022,Expense,Mtw,Harvey Spector,Credit Card - Ramp,19,56833257.71
09/02/2022,Expense,Dovetail,,Tools & Subscription - G&A,21.7,56833279.41
09/02/2022,Expense,Render,,Tools & Subscription - G&A,14,56833293.41
09/02/2022,Expense,Mtw,,Tools & Subscription - G&A,19,56833312.41
09/02/2022,Expense,Render,Balapavan Tirumani,Credit Card - Ramp,14,56833326.41
09/02/2022,Expense,Dovetail,Harvey Spector,Credit Card - Ramp,21.7,56833348.11
09/02/2022,Expense,Mtw,Harvey Spector,Credit Card - Ramp,19,56833367.11
09/02/2022,Expense,Render,Balapavan Tirumani,Credit Card - Ramp,14,56833381.11
09/02/2022,Expense,Dovetail,,Tools & Subscription - G&A,21.7,56833402.81
09/02/2022,Expense,Dovetail,Harvey Spector,Credit Card - Ramp,21.7,56833424.51
09/03/2022,Expense,Orbitkey,Mike ross,Credit Card - Ramp,109.66,56833534.17
09/03/2022,Expense,Mazurek Co,Harvey Spector,Credit Card - Ramp,29.95,56833564.12
09/03/2022,Expense,Tel Aviv,Harvey Spector,Credit Card - Ramp,1057.54,56834621.66
09/03/2022,Expense,Orbitkey,,Tools & Subscription - G&A,109.66,56834731.32
09/03/2022,Expense,Airbnb,,Travel:Hotels,882.31,56835613.63
09/03/2022,Expense,Mazurek Co,,Tools & Subscription - G&A,29.95,56835643.58
09/03/2022,Expense,Orbitkey,,Tools & Subscription - G&A,109.66,56835753.24
09/03/2022,Expense,Tel Aviv,Harvey Spector,Meals & Entertainment,1057.54,56836810.78
09/03/2022,Expense,Mazurek Co,Harvey Spector,Credit Card - Ramp,29.95,56836840.73
09/03/2022,Expense,Orbitkey,Mike ross,Credit Card - Ramp,109.66,56836950.39
09/03/2022,Expense,Mazurek Co,Harvey Spector,Credit Card - Ramp,29.95,56836980.34
09/03/2022,Expense,Tel Aviv,Harvey Spector,Meals & Entertainment,1057.54,56838037.88
09/03/2022,Expense,Airbnb,Harvey Spector,Credit Card - Ramp,882.31,56838920.19
09/03/2022,Expense,Orbitkey,,Tools & Subscription - G&A,109.66,56839029.85
09/03/2022,Expense,Airbnb,,Travel:Hotels,882.31,56839912.16
09/03/2022,Expense,Airbnb,,Travel:Hotels,882.31,56840794.47
09/03/2022,Expense,Tel Aviv,Harvey Spector,Meals & Entertainment,1057.54,56841852.01
09/03/2022,Expense,Mazurek Co,,Tools & Subscription - G&A,29.95,56841881.96
09/03/2022,Expense,Orbitkey,,Tools & Subscription - G&A,109.66,56841991.62
09/03/2022,Expense,Tel Aviv,Harvey Spector,Meals & Entertainment,1057.54,56843049.16
09/03/2022,Expense,Tel Aviv,Harvey Spector,Credit Card - Ramp,1057.54,56844106.7
09/03/2022,Expense,Airbnb,,Travel:Hotels,882.31,56844989.01
09/03/2022,Expense,Mazurek Co,,Tools & Subscription - G&A,29.95,56845018.96
09/03/2022,Expense,Airbnb,Harvey Spector,Credit Card - Ramp,882.31,56845901.27
09/03/2022,Expense,Mazurek Co,,Tools & Subscription - G&A,29.95,56845931.22
09/03/2022,Expense,Tel Aviv,Harvey Spector,Credit Card - Ramp,1057.54,56846988.76
09/03/2022,Expense,Airbnb,Harvey Spector,Credit Card - Ramp,882.31,56847871.07
09/03/2022,Expense,Tel Aviv,Harvey Spector,Credit Card - Ramp,1057.54,56848928.61
09/03/2022,Expense,Orbitkey,Mike ross,Credit Card - Ramp,109.66,56849038.27
09/04/2022,Expense,The New York Times,Mike ross,Credit Card - Ramp,1.37,56849039.64
09/04/2022,Deposit,,Interest Accrual,Savings (6977),21.24,56849060.88
09/04/2022,Deposit,,Interest Accrual,Interest Received,21.24,56849082.12
09/04/2022,Expense,The New York Times,,General business expenses:Memberships & subscriptions,1.37,56849083.49
09/04/2022,Expense,The New York Times,Mike ross,Credit Card - Ramp,1.37,56849084.86
09/04/2022,Deposit,,Interest Accrual,Interest Received,21.24,56849106.1
09/04/2022,Expense,The New York Times,,General business expenses:Memberships & subscriptions,1.37,56849107.47
09/04/2022,Expense,The New York Times,,General business expenses:Memberships & subscriptions,1.37,56849108.84
09/04/2022,Deposit,,Interest Accrual,Interest Received,21.24,56849130.08
09/04/2022,Deposit,,Interest Accrual,Interest Received,21.24,56849151.32
09/04/2022,Deposit,,Interest Accrual,Savings (6977),21.24,56849172.56
09/04/2022,Expense,The New York Times,,General business expenses:Memberships & subscriptions,1.37,56849173.93
09/04/2022,Expense,The New York Times,Mike ross,Credit Card - Ramp,1.37,56849175.3
09/04/2022,Expense,The New York Times,Mike ross,Credit Card - Ramp,1.37,56849176.67
09/04/2022,Deposit,,Interest Accrual,Savings (6977),21.24,56849197.91
09/05/2022,Expense,Smp 1812 Cafe Restaurant,Mike ross,Credit Card - Ramp,16.38,56849214.29
09/05/2022,Credit Card Credit,Airbnb,Harvey Spector,Credit Card - Ramp,-882.31,56848331.98
09/05/2022,Credit Card Credit,Airbnb,,Travel:Hotels,-882.31,56847449.67
09/05/2022,Expense,Smp 1812 Cafe Restaurant,Mike ross,Meals & Entertainment,16.38,56847466.05
09/05/2022,Credit Card Credit,Airbnb,Harvey Spector,Credit Card - Ramp,-882.31,56846583.74
09/05/2022,Credit Card Credit,Airbnb,Harvey Spector,Credit Card - Ramp,-882.31,56845701.43
09/05/2022,Expense,Smp 1812 Cafe Restaurant,Mike ross,Credit Card - Ramp,16.38,56845717.81
09/05/2022,Expense,Smp 1812 Cafe Restaurant,Mike ross,Meals & Entertainment,16.38,56845734.19
09/05/2022,Credit Card Credit,Airbnb,,Travel:Hotels,-882.31,56844851.88
09/05/2022,Expense,Smp 1812 Cafe Restaurant,Mike ross,Meals & Entertainment,16.38,56844868.26
09/05/2022,Credit Card Credit,Airbnb,,Travel:Hotels,-882.31,56843985.95
09/05/2022,Credit Card Credit,Airbnb,,Travel:Hotels,-882.31,56843103.64
09/05/2022,Expense,Smp 1812 Cafe Restaurant,Mike ross,Meals & Entertainment,16.38,56843120.02
09/05/2022,Expense,Smp 1812 Cafe Restaurant,Mike ross,Credit Card - Ramp,16.38,56843136.4
09/05/2022,Expense,Smp 1812 Cafe Restaurant,Mike ross,Credit Card - Ramp,16.38,56843152.78
09/06/2022,Expense,Bourke Street Bakery,Mike ross,Meals & Entertainment,9.47,56843162.25
09/06/2022,Expense,Bourke Street Bakery,Mike ross,Credit Card - Ramp,9.47,56843171.72
09/06/2022,Expense,La Panchina,Mike ross,Credit Card - Ramp,50.45,56843222.17
09/06/2022,Expense,La Panchina,Mike ross,Meals & Entertainment,50.45,56843272.62
09/06/2022,Expense,Bourke Street Bakery,Mike ross,Credit Card - Ramp,9.47,56843282.09
09/06/2022,Expense,Bourke Street Bakery,Mike ross,Meals & Entertainment,9.47,56843291.56
09/06/2022,Expense,La Panchina,Mike ross,Meals & Entertainment,50.45,56843342.01
09/06/2022,Expense,La Panchina,Mike ross,Credit Card - Ramp,50.45,56843392.46
09/06/2022,Expense,Bourke Street Bakery,Mike ross,Meals & Entertainment,9.47,56843401.93
09/06/2022,Expense,La Panchina,Mike ross,Meals & Entertainment,50.45,56843452.38
09/06/2022,Expense,La Panchina,Mike ross,Credit Card - Ramp,50.45,56843502.83
09/06/2022,Expense,La Panchina,Mike ross,Meals & Entertainment,50.45,56843553.28
09/06/2022,Expense,Bourke Street Bakery,Mike ross,Meals & Entertainment,9.47,56843562.75
09/06/2022,Expense,La Panchina,Mike ross,Credit Card - Ramp,50.45,56843613.2
09/06/2022,Expense,Bourke Street Bakery,Mike ross,Credit Card - Ramp,9.47,56843622.67
09/06/2022,Expense,Bourke Street Bakery,Mike ross,Credit Card - Ramp,9.47,56843632.14
09/07/2022,Expense,Income Capitals ,Income Capitals ,Contract labor,-9554,56834078.14
09/07/2022,Expense,Mailchimp,Mike ross,Credit Card - Ramp,22.78,56834100.92
09/07/2022,Expense,Mailchimp,,Tools & Subscription - G&A,22.78,56834123.7
09/07/2022,Expense,Mailchimp,,Tools & Subscription - G&A,22.78,56834146.48
09/07/2022,Expense,Income Capitals ,Income Capitals ,Account1,9554,56843700.48
09/07/2022,Expense,Mailchimp,,Tools & Subscription - G&A,22.78,56843723.26
09/07/2022,Expense,Income Capitals ,Income Capitals ,Account1,9554,56853277.26
09/07/2022,Expense,Income Capitals ,Income Capitals ,Contract labor,-9554,56843723.26
09/07/2022,Expense,Mailchimp,Mike ross,Credit Card - Ramp,22.78,56843746.04
09/07/2022,Expense,Income Capitals ,Income Capitals ,Contract labor,-9554,56834192.04
09/07/2022,Expense,Mailchimp,Mike ross,Credit Card - Ramp,22.78,56834214.82
09/07/2022,Expense,Income Capitals ,Income Capitals ,Account1,9554,56843768.82
09/07/2022,Expense,Mailchimp,,Tools & Subscription - G&A,22.78,56843791.6
09/07/2022,Expense,Income Capitals ,Income Capitals ,Contract labor,-9554,56834237.6
09/07/2022,Expense,Income Capitals ,Income Capitals ,Account1,9554,56843791.6
09/08/2022,Expense,Calendly,Harvey Spector,Credit Card - Ramp,80,56843871.6
09/08/2022,Expense,Airalo,Harvey Spector,Credit Card - Ramp,18,56843889.6
09/08/2022,Expense,Airalo,Harvey Spector,Credit Card - Ramp,18,56843907.6
09/08/2022,Expense,Calendly,Harvey Spector,Credit Card - Ramp,80,56843987.6
09/08/2022,Expense,Calendly,Harvey Spector,Credit Card - Ramp,80,56844067.6
09/08/2022,Expense,Airalo,Harvey Spector,Credit Card - Ramp,18,56844085.6
09/08/2022,Expense,Airalo,,Utilities:Internet & TV services,18,56844103.6
09/08/2022,Expense,Calendly,,Tools & Subscription - G&A,80,56844183.6
09/08/2022,Expense,Airalo,,Utilities:Internet & TV services,18,56844201.6
09/08/2022,Expense,Calendly,,Tools & Subscription - G&A,80,56844281.6
09/08/2022,Expense,Airalo,,Utilities:Internet & TV services,18,56844299.6
09/08/2022,Expense,Calendly,,Tools & Subscription - G&A,80,56844379.6
09/08/2022,Expense,Airalo,,Utilities:Internet & TV services,18,56844397.6
09/08/2022,Expense,Calendly,,Tools & Subscription - G&A,80,56844477.6
09/09/2022,Expense,Royale Specialty,Mike ross,Credit Card - Ramp,13.89,56844491.49
09/09/2022,Expense,Uber,Mike ross,Credit Card - Ramp,18.93,56844510.42
09/09/2022,Expense,PocketSmith,Harvey Spector,Credit Card - Ramp,4.98,56844515.4
09/09/2022,Expense,PocketSmith,,Tools & Subscription - G&A,4.98,56844520.38
09/09/2022,Expense,Airbnb,Harvey Spector,Credit Card - Ramp,1098.47,56845618.85
09/09/2022,Expense,Uber,Mike ross,Credit Card - Ramp,18.93,56845637.78
09/09/2022,Expense,Usersnap,Harris Jose,Credit Card - Ramp,19,56845656.78
09/09/2022,Expense,PocketSmith,Harvey Spector,Credit Card - Ramp,4.98,56845661.76
09/09/2022,Expense,Airbnb,Harvey Spector,Credit Card - Ramp,1098.47,56846760.23
09/09/2022,Expense,Pragmaticengineer.Com,Harvey Spector,Credit Card - Ramp,15,56846775.23
09/09/2022,Expense,Uber,Mike ross,Credit Card - Ramp,18.93,56846794.16
09/09/2022,Expense,Royale Specialty,Mike ross,Meals & Entertainment,13.89,56846808.05
09/09/2022,Expense,Usersnap,,Tools & Subscription - G&A,19,56846827.05
09/09/2022,Expense,Airbnb,,Travel:Hotels,1098.47,56847925.52
09/09/2022,Expense,Royale Specialty,Mike ross,Meals & Entertainment,13.89,56847939.41
09/09/2022,Expense,Airbnb,Harvey Spector,Credit Card - Ramp,1098.47,56849037.88
09/09/2022,Expense,Royale Specialty,Mike ross,Credit Card - Ramp,13.89,56849051.77
09/09/2022,Expense,PocketSmith,,Tools & Subscription - G&A,4.98,56849056.75
09/09/2022,Expense,Airbnb,,Travel:Hotels,1098.47,56850155.22
09/09/2022,Expense,Uber,,Travelling Expenses,18.93,56850174.15
09/09/2022,Expense,Pragmaticengineer.Com,Harvey Spector,Credit Card - Ramp,15,56850189.15
09/09/2022,Expense,Uber,,Travelling Expenses,18.93,56850208.08
09/09/2022,Expense,PocketSmith,Harvey Spector,Credit Card - Ramp,4.98,56850213.06
09/09/2022,Expense,Usersnap,Harris Jose,Credit Card - Ramp,19,56850232.06
09/09/2022,Expense,Pragmaticengineer.Com,,Tools & Subscription - G&A,15,56850247.06
09/09/2022,Expense,Usersnap,,Tools & Subscription - G&A,19,56850266.06
09/09/2022,Expense,Uber,,Travelling Expenses,18.93,56850284.99
09/09/2022,Expense,Usersnap,,Tools & Subscription - G&A,19,56850303.99
09/09/2022,Expense,Pragmaticengineer.Com,,Tools & Subscription - G&A,15,56850318.99
09/09/2022,Expense,Airbnb,,Travel:Hotels,1098.47,56851417.46
09/09/2022,Expense,Uber,,Travelling Expenses,18.93,56851436.39
09/09/2022,Expense,Usersnap,,Tools & Subscription - G&A,19,56851455.39
09/09/2022,Expense,PocketSmith,,Tools & Subscription - G&A,4.98,56851460.37
09/09/2022,Expense,Royale Specialty,Mike ross,Meals & Entertainment,13.89,56851474.26
09/09/2022,Expense,PocketSmith,,Tools & Subscription - G&A,4.98,56851479.24
09/09/2022,Expense,Airbnb,,Travel:Hotels,1098.47,56852577.71
09/09/2022,Expense,Royale Specialty,Mike ross,Credit Card - Ramp,13.89,56852591.6
09/09/2022,Expense,Royale Specialty,Mike ross,Meals & Entertainment,13.89,56852605.49
09/09/2022,Expense,Pragmaticengineer.Com,,Tools & Subscription - G&A,15,56852620.49
09/09/2022,Expense,Pragmaticengineer.Com,Harvey Spector,Credit Card - Ramp,15,56852635.49
09/09/2022,Expense,Royale Specialty,Mike ross,Credit Card - Ramp,13.89,56852649.38
09/09/2022,Expense,Usersnap,Harris Jose,Credit Card - Ramp,19,56852668.38
09/09/2022,Expense,Pragmaticengineer.Com,,Tools & Subscription - G&A,15,56852683.38
09/10/2022,Expense,Pause Cafe,Harvey Spector,Credit Card - Ramp,7,56852690.38
09/10/2022,Expense,Kalamata Mediterranean Cuisine,Mike ross,Credit Card - Ramp,56.98,56852747.36
09/10/2022,Expense,Kalamata Mediterranean Cuisine,Mike ross,Meals & Entertainment,56.98,56852804.34
09/10/2022,Expense,Pause Cafe,Harvey Spector,Meals & Entertainment,7,56852811.34
09/10/2022,Expense,Turkish,Harvey Spector,Meals & Entertainment,764.91,56853576.25
09/10/2022,Expense,Kalamata Mediterranean Cuisine,Mike ross,Meals & Entertainment,56.98,56853633.23
09/10/2022,Expense,Turkish,Harvey Spector,Credit Card - Ramp,764.91,56854398.14
09/10/2022,Expense,Kalamata Mediterranean Cuisine,Mike ross,Meals & Entertainment,56.98,56854455.12
09/10/2022,Expense,Pause Cafe,Harvey Spector,Credit Card - Ramp,7,56854462.12
09/10/2022,Expense,Gogo InFlight,,Travelling Expenses,3.99,56854466.11
09/10/2022,Expense,Turkish,Harvey Spector,Meals & Entertainment,764.91,56855231.02
09/10/2022,Expense,SNCF,,Travelling Expenses,283.22,56855514.24
09/10/2022,Expense,Kalamata Mediterranean Cuisine,Mike ross,Credit Card - Ramp,56.98,56855571.22
09/10/2022,Expense,Turkish,Harvey Spector,Credit Card - Ramp,764.91,56856336.13
09/10/2022,Expense,SNCF,,Travelling Expenses,283.22,56856619.35
09/10/2022,Expense,Gogo InFlight,,Travelling Expenses,3.99,56856623.34
09/10/2022,Expense,Pause Cafe,Harvey Spector,Meals & Entertainment,7,56856630.34
09/10/2022,Expense,SNCF,,Travelling Expenses,283.22,56856913.56
09/10/2022,Expense,Turkish,Harvey Spector,Meals & Entertainment,764.91,56857678.47
09/10/2022,Expense,SNCF,Harvey Spector,Credit Card - Ramp,283.22,56857961.69
09/10/2022,Expense,Pause Cafe,Harvey Spector,Meals & Entertainment,7,56857968.69
09/10/2022,Expense,Gogo InFlight,Harvey Spector,Credit Card - Ramp,3.99,56857972.68
09/10/2022,Expense,SNCF,Harvey Spector,Credit Card - Ramp,283.22,56858255.9
09/10/2022,Expense,SNCF,Harvey Spector,Credit Card - Ramp,283.22,56858539.12
09/10/2022,Expense,Pause Cafe,Harvey Spector,Meals & Entertainment,7,56858546.12
09/10/2022,Expense,Kalamata Mediterranean Cuisine,Mike ross,Meals & Entertainment,56.98,56858603.1
09/10/2022,Expense,Turkish,Harvey Spector,Meals & Entertainment,764.91,56859368.01
09/10/2022,Expense,Pause Cafe,Harvey Spector,Credit Card - Ramp,7,56859375.01
09/10/2022,Expense,Gogo InFlight,Harvey Spector,Credit Card - Ramp,3.99,56859379
09/10/2022,Expense,SNCF,,Travelling Expenses,283.22,56859662.22
09/10/2022,Expense,Gogo InFlight,Harvey Spector,Credit Card - Ramp,3.99,56859666.21
09/10/2022,Expense,Turkish,Harvey Spector,Credit Card - Ramp,764.91,56860431.12
09/10/2022,Expense,Kalamata Mediterranean Cuisine,Mike ross,Credit Card - Ramp,56.98,56860488.1
09/10/2022,Expense,Pause Cafe,Harvey Spector,Credit Card - Ramp,7,56860495.1
09/10/2022,Expense,Kalamata Mediterranean Cuisine,Mike ross,Credit Card - Ramp,56.98,56860552.08
09/10/2022,Expense,Turkish,Harvey Spector,Credit Card - Ramp,764.91,56861316.99
09/10/2022,Expense,Gogo InFlight,,Travelling Expenses,3.99,56861320.98
09/10/2022,Expense,Gogo InFlight,,Travelling Expenses,3.99,56861324.97
09/12/2022,Expense,Heroku,Balapavan Tirumani,Credit Card - Ramp,80,56861404.97
09/12/2022,Expense,Heroku,Balapavan Tirumani,Credit Card - Ramp,80,56861484.97
09/12/2022,Expense,Heroku,Balapavan Tirumani,Tools & Subscription - S&M,80,56861564.97
09/12/2022,Expense,Heroku,Balapavan Tirumani,Tools & Subscription - S&M,80,56861644.97
09/12/2022,Expense,Heroku,Balapavan Tirumani,Credit Card - Ramp,80,56861724.97
09/12/2022,Expense,Fairuz Rotana Cafe Restaurant,Harvey Spector,Credit Card - Ramp,30.84,56861755.81
09/12/2022,Expense,Fairuz Rotana Cafe Restaurant,Harvey Spector,Credit Card - Ramp,30.84,56861786.65
09/12/2022,Expense,Tier Il Shop Subs,,Travelling Expenses,0.6,56861787.25
09/12/2022,Expense,Fairuz Rotana Cafe Restaurant,Harvey Spector,Meals & Entertainment,30.84,56861818.09
09/12/2022,Expense,Tier Il Shop Subs,,Travelling Expenses,0.6,56861818.69
09/12/2022,Expense,Tier Il Shop Subs,,Travelling Expenses,0.6,56861819.29
09/12/2022,Expense,Fairuz Rotana Cafe Restaurant,Harvey Spector,Meals & Entertainment,30.84,56861850.13
09/12/2022,Expense,Tier Il Shop Subs,Harvey Spector,Credit Card - Ramp,0.6,56861850.73
09/12/2022,Expense,Heroku,Balapavan Tirumani,Tools & Subscription - S&M,80,56861930.73
09/12/2022,Expense,Heroku,Balapavan Tirumani,Tools & Subscription - S&M,80,56862010.73
09/12/2022,Expense,Fairuz Rotana Cafe Restaurant,Harvey Spector,Credit Card - Ramp,30.84,56862041.57
09/12/2022,Expense,Fairuz Rotana Cafe Restaurant,Harvey Spector,Meals & Entertainment,30.84,56862072.41
09/12/2022,Expense,Tier Il Shop Subs,,Travelling Expenses,0.6,56862073.01
09/12/2022,Expense,Tier Il Shop Subs,Harvey Spector,Credit Card - Ramp,0.6,56862073.61
09/12/2022,Expense,Tier Il Shop Subs,Harvey Spector,Credit Card - Ramp,0.6,56862074.21
09/12/2022,Expense,Fairuz Rotana Cafe Restaurant,Harvey Spector,Meals & Entertainment,30.84,56862105.05
09/12/2022,Expense,Fairuz Rotana Cafe Restaurant,Harvey Spector,Credit Card - Ramp,30.84,56862135.89
09/13/2022,Expense,Vercel,,Tools & Subscription - G&A,80,56862215.89
09/13/2022,Expense,Intercom,,Tools & Subscription - G&A,157,56862372.89
09/13/2022,Expense,Figma,Mike ross,Credit Card - Ramp,335,56862707.89
09/13/2022,Expense,Datadog,Balapavan Tirumani,Credit Card - Ramp,3.85,56862711.74
09/13/2022,Expense,Vercel,,Tools & Subscription - G&A,80,56862791.74
09/13/2022,Expense,Datadog,,Tools & Subscription - G&A,3.85,56862795.59
09/13/2022,Expense,Vercel,Harris Jose,Credit Card - Ramp,80,56862875.59
09/13/2022,Expense,Datadog,Balapavan Tirumani,Credit Card - Ramp,3.85,56862879.44
09/13/2022,Expense,Intercom,,Tools & Subscription - G&A,157,56863036.44
09/13/2022,Expense,Figma,,Tools & Subscription - G&A,335,56863371.44
09/13/2022,Expense,Figma,,Tools & Subscription - G&A,335,56863706.44
09/13/2022,Expense,Figma,,Tools & Subscription - G&A,335,56864041.44
09/13/2022,Expense,Intercom,,Tools & Subscription - G&A,157,56864198.44
09/13/2022,Expense,Figma,Mike ross,Credit Card - Ramp,335,56864533.44
09/13/2022,Expense,Gett,,Travelling Expenses,9.43,56864542.87
09/13/2022,Expense,Intercom,Balapavan Tirumani,Credit Card - Ramp,157,56864699.87
09/13/2022,Expense,Gett,Harvey Spector,Credit Card - Ramp,9.43,56864709.3
09/13/2022,Expense,Gett,,Travelling Expenses,9.43,56864718.73
09/13/2022,Expense,Vercel,,Tools & Subscription - G&A,80,56864798.73
09/13/2022,Expense,Gett,,Travelling Expenses,9.43,56864808.16
09/13/2022,Expense,Datadog,,Tools & Subscription - G&A,3.85,56864812.01
09/13/2022,Expense,Figma,Mike ross,Credit Card - Ramp,335,56865147.01
09/13/2022,Expense,Gett,Harvey Spector,Credit Card - Ramp,9.43,56865156.44
09/13/2022,Expense,Figma,,Tools & Subscription - G&A,335,56865491.44
09/13/2022,Expense,Intercom,Balapavan Tirumani,Credit Card - Ramp,157,56865648.44
09/13/2022,Expense,Datadog,Balapavan Tirumani,Credit Card - Ramp,3.85,56865652.29
09/13/2022,Expense,Vercel,Harris Jose,Credit Card - Ramp,80,56865732.29
09/13/2022,Expense,Gett,Harvey Spector,Credit Card - Ramp,9.43,56865741.72
09/13/2022,Expense,Vercel,Harris Jose,Credit Card - Ramp,80,56865821.72
09/13/2022,Expense,Intercom,Balapavan Tirumani,Credit Card - Ramp,157,56865978.72
09/13/2022,Expense,Gett,,Travelling Expenses,9.43,56865988.15
09/13/2022,Expense,Vercel,,Tools & Subscription - G&A,80,56866068.15
09/13/2022,Expense,Intercom,,Tools & Subscription - G&A,157,56866225.15
09/13/2022,Expense,Datadog,,Tools & Subscription - G&A,3.85,56866229
09/13/2022,Expense,Datadog,,Tools & Subscription - G&A,3.85,56866232.85
09/14/2022,Expense,Intuit,,Tools & Subscription - G&A,55,56866287.85
09/14/2022,Expense,Miznon,Harvey Spector,Credit Card - Ramp,25.05,56866312.9
09/14/2022,Expense,Miznon,Harvey Spector,Meals & Entertainment,25.05,56866337.95
09/14/2022,Expense,Miznon,Harvey Spector,Credit Card - Ramp,25.05,56866363
09/14/2022,Expense,Intuit,,Tools & Subscription - G&A,55,56866418
09/14/2022,Expense,Bebka Habima Restaurant,Harvey Spector,Meals & Entertainment,10.14,56866428.14
09/14/2022,Expense,Bebka Habima Restaurant,Harvey Spector,Credit Card - Ramp,10.14,56866438.28
09/14/2022,Expense,Intuit,,Tools & Subscription - G&A,55,56866493.28
09/14/2022,Expense,Miznon,Harvey Spector,Meals & Entertainment,25.05,56866518.33
09/14/2022,Expense,Intuit,Harvey Spector,Credit Card - Ramp,55,56866573.33
09/14/2022,Expense,Bebka Habima Restaurant,Harvey Spector,Credit Card - Ramp,10.14,56866583.47
09/14/2022,Expense,Bebka Habima Restaurant,Harvey Spector,Meals & Entertainment,10.14,56866593.61
09/14/2022,Expense,Bebka Habima Restaurant,Harvey Spector,Meals & Entertainment,10.14,56866603.75
09/14/2022,Expense,Miznon,Harvey Spector,Meals & Entertainment,25.05,56866628.8
09/14/2022,Expense,Bebka Habima Restaurant,Harvey Spector,Credit Card - Ramp,10.14,56866638.94
09/14/2022,Expense,Miznon,Harvey Spector,Meals & Entertainment,25.05,56866663.99
09/14/2022,Expense,Intuit,Harvey Spector,Credit Card - Ramp,55,56866718.99
09/14/2022,Expense,Intuit,,Tools & Subscription - G&A,55,56866773.99
09/14/2022,Expense,Miznon,Harvey Spector,Credit Card - Ramp,25.05,56866799.04
09/14/2022,Expense,Bebka Habima Restaurant,Harvey Spector,Credit Card - Ramp,10.14,56866809.18
09/14/2022,Expense,Bebka Habima Restaurant,Harvey Spector,Meals & Entertainment,10.14,56866819.32
09/14/2022,Expense,Miznon,Harvey Spector,Credit Card - Ramp,25.05,56866844.37
09/14/2022,Expense,Intuit,Harvey Spector,Credit Card - Ramp,55,56866899.37
09/15/2022,Expense,lime,Harvey Spector,Credit Card - Ramp,4.89,56866904.26
09/15/2022,Expense,Tel Aviv,Harvey Spector,Credit Card - Ramp,4.4,56866908.66
09/15/2022,Expense,Tel Aviv,Harvey Spector,Credit Card - Ramp,4.4,56866913.06
09/15/2022,Expense,Tel Aviv,Harvey Spector,Meals & Entertainment,4.4,56866917.46
09/15/2022,Expense,lime,Harvey Spector,Credit Card - Ramp,4.89,56866922.35
09/15/2022,Expense,lime,Harvey Spector,Credit Card - Ramp,4.89,56866927.24
09/15/2022,Expense,Tel Aviv,Harvey Spector,Credit Card - Ramp,4.4,56866931.64
09/15/2022,Expense,Tel Aviv,Harvey Spector,Meals & Entertainment,4.4,56866936.04
09/15/2022,Expense,Tel Aviv,Harvey Spector,Meals & Entertainment,4.4,56866940.44
09/15/2022,Expense,lime,,Travelling Expenses,4.89,56866945.33
09/15/2022,Expense,lime,,Travelling Expenses,4.89,56866950.22
09/15/2022,Expense,lime,,Travelling Expenses,4.89,56866955.11
09/15/2022,Expense,Tel Aviv,Harvey Spector,Meals & Entertainment,4.4,56866959.51
09/15/2022,Expense,Tel Aviv,Harvey Spector,Credit Card - Ramp,4.4,56866963.91
09/15/2022,Expense,lime,,Travelling Expenses,4.89,56866968.8
09/16/2022,Expense,Bellboy Bar,,Travel:Hotels,96.77,56867065.57
09/16/2022,Expense,Linear,,Tools & Subscription - G&A,150,56867215.57
09/16/2022,Expense,carta,,Tools & Subscription - G&A,2800,56870015.57
09/16/2022,Expense,Hapizza,Harvey Spector,Meals & Entertainment,53.27,56870068.84
09/16/2022,Expense,Cafe Bar Habima Restaurant,Harvey Spector,Credit Card - Ramp,20.2,56870089.04
09/16/2022,Expense,Hapizza,Harvey Spector,Credit Card - Ramp,53.27,56870142.31
09/16/2022,Expense,carta,,Tools & Subscription - G&A,2800,56872942.31
09/16/2022,Expense,Linear,,Tools & Subscription - G&A,150,56873092.31
09/16/2022,Expense,Linear,Chad Blumenthal,Credit Card - Ramp,150,56873242.31
09/16/2022,Expense,Cafe Bar Habima Restaurant,Harvey Spector,Meals & Entertainment,20.2,56873262.51
09/16/2022,Expense,Bellboy Bar,,Travel:Hotels,96.77,56873359.28
09/16/2022,Expense,Cafe Bar Habima Restaurant,Harvey Spector,Meals & Entertainment,20.2,56873379.48
09/16/2022,Expense,Bellboy Bar,Mike ross,Credit Card - Ramp,96.77,56873476.25
09/16/2022,Expense,Hapizza,Harvey Spector,Credit Card - Ramp,53.27,56873529.52
09/16/2022,Expense,Cafe Bar Habima Restaurant,Harvey Spector,Credit Card - Ramp,20.2,56873549.72
09/16/2022,Expense,Bellboy Bar,Mike ross,Credit Card - Ramp,96.77,56873646.49
09/16/2022,Expense,Cafe Bar Habima Restaurant,Harvey Spector,Credit Card - Ramp,20.2,56873666.69
09/16/2022,Expense,Zapier,,Tools & Subscription - G&A,29.99,56873696.68
09/16/2022,Expense,Hapizza,Harvey Spector,Meals & Entertainment,53.27,56873749.95
09/16/2022,Expense,Linear,Chad Blumenthal,Credit Card - Ramp,150,56873899.95
09/16/2022,Expense,Hapizza,Harvey Spector,Meals & Entertainment,53.27,56873953.22
09/16/2022,Expense,Zapier,Harvey Spector,Credit Card - Ramp,29.99,56873983.21
09/16/2022,Expense,Hapizza,Harvey Spector,Credit Card - Ramp,53.27,56874036.48
09/16/2022,Expense,Zapier,,Tools & Subscription - G&A,29.99,56874066.47
09/16/2022,Expense,Cafe Bar Habima Restaurant,Harvey Spector,Meals & Entertainment,20.2,56874086.67
09/16/2022,Expense,Hapizza,Harvey Spector,Credit Card - Ramp,53.27,56874139.94
09/16/2022,Expense,carta,Mike ross,Credit Card - Ramp,2800,56876939.94
09/16/2022,Expense,Bellboy Bar,,Travel:Hotels,96.77,56877036.71
09/16/2022,Expense,carta,Mike ross,Credit Card - Ramp,2800,56879836.71
09/16/2022,Expense,Linear,,Tools & Subscription - G&A,150,56879986.71
09/16/2022,Expense,carta,,Tools & Subscription - G&A,2800,56882786.71
09/16/2022,Expense,carta,,Tools & Subscription - G&A,2800,56885586.71
09/16/2022,Expense,Hapizza,Harvey Spector,Meals & Entertainment,53.27,56885639.98
09/16/2022,Expense,Zapier,Harvey Spector,Credit Card - Ramp,29.99,56885669.97
09/16/2022,Expense,Bellboy Bar,,Travel:Hotels,96.77,56885766.74
09/16/2022,Expense,Zapier,,Tools & Subscription - G&A,29.99,56885796.73
09/16/2022,Expense,Cafe Bar Habima Restaurant,Harvey Spector,Meals & Entertainment,20.2,56885816.93
09/16/2022,Expense,Cafe Bar Habima Restaurant,Harvey Spector,Credit Card - Ramp,20.2,56885837.13
09/16/2022,Expense,Zapier,,Tools & Subscription - G&A,29.99,56885867.12
09/16/2022,Expense,carta,Mike ross,Credit Card - Ramp,2800,56888667.12
09/16/2022,Expense,Zapier,Harvey Spector,Credit Card - Ramp,29.99,56888697.11
09/16/2022,Expense,Bellboy Bar,Mike ross,Credit Card - Ramp,96.77,56888793.88
09/16/2022,Expense,Linear,,Tools & Subscription - G&A,150,56888943.88
09/16/2022,Expense,Linear,Chad Blumenthal,Credit Card - Ramp,150,56889093.88
09/17/2022,Expense,Tier Il 9,,Travelling Expenses,0.1,56889093.98
09/17/2022,Expense,Factory Hand,Harvey Spector,Office expenses:Office supplies,15.2,56889109.18
09/17/2022,Expense,Tier Il 9,,Travelling Expenses,0.1,56889109.28
09/17/2022,Expense,Tier Il 9,,Travelling Expenses,1.94,56889111.22
09/17/2022,Expense,Airalo,,Utilities:Internet & TV services,37,56889148.22
09/17/2022,Expense,Tier Il 9,,Travelling Expenses,4.71,56889152.93
09/17/2022,Expense,Tier Il 9,,Travelling Expenses,1.84,56889154.77
09/17/2022,Expense,Tier Il 9,,Travelling Expenses,3.58,56889158.35
09/17/2022,Expense,Tier Il 9,,Travelling Expenses,1.94,56889160.29
09/17/2022,Expense,Factory Hand,Harvey Spector,Credit Card - Ramp,15.2,56889175.49
09/17/2022,Expense,Tier Il 9,,Travelling Expenses,1.94,56889177.43
09/17/2022,Expense,Tier Il 9,,Travelling Expenses,0.1,56889177.53
09/17/2022,Expense,Airalo,,Utilities:Internet & TV services,37,56889214.53
09/17/2022,Expense,Tier Il 9,,Travelling Expenses,4.3,56889218.83
09/17/2022,Expense,Factory Hand,Harvey Spector,Credit Card - Ramp,15.2,56889234.03
09/17/2022,Expense,Factory Hand,Harvey Spector,Credit Card - Ramp,15.2,56889249.23
09/17/2022,Expense,Tier Il 9,Harvey Spector,Credit Card - Ramp,1.94,56889251.17
09/17/2022,Expense,Tier Il 9,Harvey Spector,Credit Card - Ramp,4.71,56889255.88
09/17/2022,Expense,Tier Il 9,Harvey Spector,Credit Card - Ramp,1.94,56889257.82
09/17/2022,Expense,Tier Il 9,Harvey Spector,Credit Card - Ramp,4.71,56889262.53
09/17/2022,Expense,Tier Il 9,Harvey Spector,Credit Card - Ramp,1.84,56889264.37
09/17/2022,Expense,Tier Il 9,Harvey Spector,Credit Card - Ramp,3.58,56889267.95
09/17/2022,Expense,Tier Il 9,Harvey Spector,Credit Card - Ramp,1.84,56889269.79
09/17/2022,Expense,Tier Il 9,Harvey Spector,Credit Card - Ramp,4.3,56889274.09
09/17/2022,Expense,Tier Il 9,Harvey Spector,Credit Card - Ramp,1.94,56889276.03
09/17/2022,Expense,Tier Il 9,Harvey Spector,Credit Card - Ramp,1.94,56889277.97
09/17/2022,Expense,Tier Il 9,Harvey Spector,Credit Card - Ramp,3.58,56889281.55
09/17/2022,Expense,Tier Il 9,Harvey Spector,Credit Card - Ramp,0.1,56889281.65
09/17/2022,Expense,Tier Il 9,Harvey Spector,Credit Card - Ramp,0.1,56889281.75
09/17/2022,Expense,Tier Il 9,,Travelling Expenses,1.94,56889283.69
09/17/2022,Expense,Tier Il 9,Harvey Spector,Credit Card - Ramp,4.3,56889287.99
09/17/2022,Expense,Factory Hand,Harvey Spector,Office expenses:Office supplies,15.2,56889303.19
09/17/2022,Expense,Airalo,Harvey Spector,Credit Card - Ramp,37,56889340.19
09/17/2022,Expense,Tier Il 9,,Travelling Expenses,4.71,56889344.9
09/17/2022,Expense,Tier Il 9,Harvey Spector,Credit Card - Ramp,0.1,56889345
09/17/2022,Expense,Tier Il 9,,Travelling Expenses,4.71,56889349.71
09/17/2022,Expense,Tier Il 9,,Travelling Expenses,1.84,56889351.55
09/17/2022,Expense,Airalo,Harvey Spector,Credit Card - Ramp,37,56889388.55
09/17/2022,Expense,Tier Il 9,,Travelling Expenses,3.58,56889392.13
09/17/2022,Expense,Tier Il 9,,Travelling Expenses,1.94,56889394.07
09/17/2022,Expense,Tier Il 9,Harvey Spector,Credit Card - Ramp,1.94,56889396.01
09/17/2022,Expense,Tier Il 9,Harvey Spector,Credit Card - Ramp,4.71,56889400.72
09/17/2022,Expense,Tier Il 9,Harvey Spector,Credit Card - Ramp,3.58,56889404.3
09/17/2022,Expense,Tier Il 9,Harvey Spector,Credit Card - Ramp,1.84,56889406.14
09/17/2022,Expense,Tier Il 9,Harvey Spector,Credit Card - Ramp,4.3,56889410.44
09/17/2022,Expense,Tier Il 9,Harvey Spector,Credit Card - Ramp,1.94,56889412.38
09/17/2022,Expense,Tier Il 9,,Travelling Expenses,0.1,56889412.48
09/17/2022,Expense,Factory Hand,Harvey Spector,Office expenses:Office supplies,15.2,56889427.68
09/17/2022,Expense,Airalo,Harvey Spector,Credit Card - Ramp,37,56889464.68
09/17/2022,Expense,Airalo,,Utilities:Internet & TV services,37,56889501.68
09/17/2022,Expense,Tier Il 9,,Travelling Expenses,1.94,56889503.62
09/17/2022,Expense,Tier Il 9,,Travelling Expenses,3.58,56889507.2
09/17/2022,Expense,Tier Il 9,,Travelling Expenses,1.94,56889509.14
09/17/2022,Expense,Tier Il 9,,Travelling Expenses,1.84,56889510.98
09/17/2022,Expense,Tier Il 9,,Travelling Expenses,3.58,56889514.56
09/17/2022,Expense,Tier Il 9,,Travelling Expenses,4.3,56889518.86
09/17/2022,Expense,Tier Il 9,,Travelling Expenses,4.71,56889523.57
09/17/2022,Expense,Tier Il 9,,Travelling Expenses,4.3,56889527.87
09/17/2022,Expense,Tier Il 9,,Travelling Expenses,1.94,56889529.81
09/17/2022,Expense,Tier Il 9,,Travelling Expenses,1.84,56889531.65
09/17/2022,Expense,Factory Hand,Harvey Spector,Office expenses:Office supplies,15.2,56889546.85
09/17/2022,Expense,Airalo,,Utilities:Internet & TV services,37,56889583.85
09/17/2022,Expense,Tier Il 9,,Travelling Expenses,4.3,56889588.15
09/17/2022,Expense,Factory Hand,Harvey Spector,Credit Card - Ramp,15.2,56889603.35
09/18/2022,Expense,Vistara,,Travel:Airfare,181.75,56889785.1
09/18/2022,Expense,Superhuman,,Professional Service Charges,30,56889815.1
09/18/2022,Expense,Superhuman,,Professional Service Charges,30,56889845.1
09/18/2022,Expense,Vistara,Harvey Spector,Credit Card - Ramp,181.75,56890026.85
09/18/2022,Expense,Superhuman,Harvey Spector,Credit Card - Ramp,30,56890056.85
09/18/2022,Expense,Superhuman,Harvey Spector,Credit Card - Ramp,30,56890086.85
09/18/2022,Expense,La Gufra Restaurant,Harvey Spector,Credit Card - Ramp,4.68,56890091.53
09/18/2022,Expense,Gett,Harvey Spector,Credit Card - Ramp,51.75,56890143.28
09/18/2022,Expense,Vistara,Harvey Spector,Credit Card - Ramp,181.75,56890325.03
09/18/2022,Expense,Superhuman,Harvey Spector,Credit Card - Ramp,30,56890355.03
09/18/2022,Expense,La Gufra Restaurant,Harvey Spector,Credit Card - Ramp,4.68,56890359.71
09/18/2022,Expense,La Gufra Restaurant,Harvey Spector,Credit Card - Ramp,4.68,56890364.39
09/18/2022,Expense,La Gufra Restaurant,Harvey Spector,Credit Card - Ramp,4.68,56890369.07
09/18/2022,Expense,Superhuman,Harvey Spector,Credit Card - Ramp,30,56890399.07
09/18/2022,Expense,Superhuman,,Professional Service Charges,30,56890429.07
09/18/2022,Expense,Gett,,Travelling Expenses,51.75,56890480.82
09/18/2022,Expense,Gett,,Travelling Expenses,51.75,56890532.57
09/18/2022,Expense,Vistara,,Travel:Airfare,181.75,56890714.32
09/18/2022,Expense,La Gufra Restaurant,Harvey Spector,Meals & Entertainment,4.68,56890719
09/18/2022,Expense,La Gufra Restaurant,Harvey Spector,Meals & Entertainment,4.68,56890723.68
09/18/2022,Expense,Superhuman,,Professional Service Charges,30,56890753.68
09/18/2022,Expense,Gett,,Travelling Expenses,51.75,56890805.43
09/18/2022,Expense,La Gufra Restaurant,Harvey Spector,Meals & Entertainment,4.68,56890810.11
09/18/2022,Expense,Vistara,Harvey Spector,Credit Card - Ramp,181.75,56890991.86
09/18/2022,Expense,Gett,Harvey Spector,Credit Card - Ramp,51.75,56891043.61
09/18/2022,Expense,Vistara,,Travel:Airfare,181.75,56891225.36
09/18/2022,Expense,La Gufra Restaurant,Harvey Spector,Meals & Entertainment,4.68,56891230.04
09/18/2022,Expense,Gett,,Travelling Expenses,51.75,56891281.79
09/18/2022,Expense,Gett,Harvey Spector,Credit Card - Ramp,51.75,56891333.54
09/18/2022,Expense,Vistara,,Travel:Airfare,181.75,56891515.29
09/19/2022,Expense,lime,Harvey Spector,Credit Card - Ramp,2.65,56891517.94
09/19/2022,Expense,Palais De La Bou Restaurant,Mike ross,Meals & Entertainment,89.34,56891607.28
09/19/2022,Expense,Palais De La Bou Restaurant,Mike ross,Credit Card - Ramp,89.34,56891696.62
09/19/2022,Expense,Buffet De La Gare,Harvey Spector,Meals & Entertainment,31.32,56891727.94
09/19/2022,Expense,lime,,Travelling Expenses,3.37,56891731.31
09/19/2022,Expense,Buffet De La Gare,Harvey Spector,Meals & Entertainment,31.32,56891762.63
09/19/2022,Expense,Palais De La Bou Restaurant,Mike ross,Meals & Entertainment,89.34,56891851.97
09/19/2022,Expense,Buffet De La Gare,Harvey Spector,Credit Card - Ramp,31.32,56891883.29
09/19/2022,Expense,Dinner Restaurant,Harvey Spector,Meals & Entertainment,14.56,56891897.85
09/19/2022,Expense,lime,,Travelling Expenses,3.37,56891901.22
09/19/2022,Expense,Dinner Restaurant,Harvey Spector,Credit Card - Ramp,14.56,56891915.78
09/19/2022,Expense,Palais De La Bou Restaurant,Mike ross,Credit Card - Ramp,89.34,56892005.12
09/19/2022,Expense,Buffet De La Gare,Harvey Spector,Credit Card - Ramp,31.32,56892036.44
09/19/2022,Expense,lime,,Travelling Expenses,2.65,56892039.09
09/19/2022,Expense,Dinner Restaurant,Harvey Spector,Credit Card - Ramp,14.56,56892053.65
09/19/2022,Expense,Palais De La Bou Restaurant,Mike ross,Credit Card - Ramp,89.34,56892142.99
09/19/2022,Expense,lime,Harvey Spector,Credit Card - Ramp,3.37,56892146.36
09/19/2022,Expense,lime,,Travelling Expenses,2.65,56892149.01
09/19/2022,Expense,lime,Harvey Spector,Credit Card - Ramp,2.65,56892151.66
09/19/2022,Expense,Dinner Restaurant,Harvey Spector,Meals & Entertainment,14.56,56892166.22
09/19/2022,Expense,Buffet De La Gare,Harvey Spector,Meals & Entertainment,31.32,56892197.54
09/19/2022,Expense,Palais De La Bou Restaurant,Mike ross,Meals & Entertainment,89.34,56892286.88
09/19/2022,Expense,lime,Harvey Spector,Credit Card - Ramp,3.37,56892290.25
09/19/2022,Expense,lime,Harvey Spector,Credit Card - Ramp,2.65,56892292.9
09/19/2022,Expense,lime,,Travelling Expenses,2.65,56892295.55
09/19/2022,Expense,Buffet De La Gare,Harvey Spector,Meals & Entertainment,31.32,56892326.87
09/19/2022,Expense,Buffet De La Gare,Harvey Spector,Credit Card - Ramp,31.32,56892358.19
09/19/2022,Expense,Palais De La Bou Restaurant,Mike ross,Meals & Entertainment,89.34,56892447.53
09/19/2022,Expense,Dinner Restaurant,Harvey Spector,Meals & Entertainment,14.56,56892462.09
09/19/2022,Expense,lime,,Travelling Expenses,3.37,56892465.46
09/19/2022,Expense,lime,Harvey Spector,Credit Card - Ramp,3.37,56892468.83
09/19/2022,Expense,Buffet De La Gare,Harvey Spector,Credit Card - Ramp,31.32,56892500.15
09/19/2022,Expense,Dinner Restaurant,Harvey Spector,Credit Card - Ramp,14.56,56892514.71
09/19/2022,Expense,Palais De La Bou Restaurant,Mike ross,Credit Card - Ramp,89.34,56892604.05
09/19/2022,Expense,lime,,Travelling Expenses,3.37,56892607.42
09/19/2022,Expense,lime,,Travelling Expenses,2.65,56892610.07
09/19/2022,Expense,Dinner Restaurant,Harvey Spector,Credit Card - Ramp,14.56,56892624.63
09/19/2022,Expense,Dinner Restaurant,Harvey Spector,Meals & Entertainment,14.56,56892639.19
09/20/2022,Expense,Sepia,Mike ross,Credit Card - Ramp,133.41,56892772.6
09/20/2022,Expense,Uber Eats,Harvey Spector,Meals & Entertainment,18.23,56892790.83
09/20/2022,Credit Card Payment,,RAMP BUSINESS CO,Account1,-12270.76,56880520.07
09/20/2022,Expense,Sepia,Mike ross,Meals & Entertainment,133.41,56880653.48
09/20/2022,Expense,Bird,,Travelling Expenses,5.02,56880658.5
09/20/2022,Credit Card Payment,,RAMP BUSINESS CO,Credit Card - Ramp,-12270.76,56868387.74
09/20/2022,Credit Card Payment,,RAMP BUSINESS CO,Account1,-12270.76,56856116.98
09/20/2022,Expense,Sepia,Mike ross,Meals & Entertainment,133.41,56856250.39
09/20/2022,Expense,Uber Eats,Harvey Spector,Meals & Entertainment,18.23,56856268.62
09/20/2022,Expense,Bird,,Travelling Expenses,4.42,56856273.04
09/20/2022,Expense,lime,,Travelling Expenses,8.44,56856281.48
09/20/2022,Expense,Bird,,Travelling Expenses,5.75,56856287.23
09/20/2022,Expense,lime,Harvey Spector,Credit Card - Ramp,8.44,56856295.67
09/20/2022,Expense,Bird,,Travelling Expenses,5.02,56856300.69
09/20/2022,Expense,Uber Eats,Harvey Spector,Credit Card - Ramp,18.23,56856318.92
09/20/2022,Expense,Uber,,Travelling Expenses,11.15,56856330.07
09/20/2022,Credit Card Payment,,RAMP BUSINESS CO,Credit Card - Ramp,-12270.76,56844059.31
09/20/2022,Expense,Sepia,Mike ross,Meals & Entertainment,133.41,56844192.72
09/20/2022,Expense,Bird,,Travelling Expenses,4.42,56844197.14
09/20/2022,Expense,Uber Eats,Harvey Spector,Meals & Entertainment,18.23,56844215.37
09/20/2022,Credit Card Payment,,RAMP BUSINESS CO,Account1,-12270.76,56831944.61
09/20/2022,Expense,LinkedIn,,Tools & Subscription - G&A,124.56,56832069.17
09/20/2022,Expense,Bird,,Travelling Expenses,5.02,56832074.19
09/20/2022,Expense,lime,,Travelling Expenses,8.44,56832082.63
09/20/2022,Expense,Bird,,Travelling Expenses,5.75,56832088.38
09/20/2022,Expense,Bird,Harvey Spector,Credit Card - Ramp,4.42,56832092.8
09/20/2022,Expense,Bird,Harvey Spector,Credit Card - Ramp,5.75,56832098.55
09/20/2022,Expense,Bird,Harvey Spector,Credit Card - Ramp,5.02,56832103.57
09/20/2022,Expense,Uber,Harvey Spector,Credit Card - Ramp,11.15,56832114.72
09/20/2022,Expense,LinkedIn,,Tools & Subscription - G&A,124.56,56832239.28
09/20/2022,Expense,LinkedIn,Niteesha Ravela,Credit Card - Ramp,124.56,56832363.84
09/20/2022,Expense,Uber,,Travelling Expenses,11.15,56832374.99
09/20/2022,Expense,lime,,Travelling Expenses,8.44,56832383.43
09/20/2022,Expense,Uber Eats,Harvey Spector,Credit Card - Ramp,18.23,56832401.66
09/20/2022,Expense,Sepia,Mike ross,Credit Card - Ramp,133.41,56832535.07
09/20/2022,Expense,LinkedIn,Niteesha Ravela,Credit Card - Ramp,124.56,56832659.63
09/20/2022,Credit Card Payment,,RAMP BUSINESS CO,Credit Card - Ramp,-12270.76,56820388.87
09/20/2022,Expense,Bird,,Travelling Expenses,5.02,56820393.89
09/20/2022,Expense,Bird,,Travelling Expenses,5.75,56820399.64
09/20/2022,Expense,LinkedIn,,Tools & Subscription - G&A,124.56,56820524.2
09/20/2022,Expense,Uber,,Travelling Expenses,11.15,56820535.35
09/20/2022,Expense,Sepia,Mike ross,Meals & Entertainment,133.41,56820668.76
09/20/2022,Expense,Uber,,Travelling Expenses,11.15,56820679.91
09/20/2022,Expense,LinkedIn,,Tools & Subscription - G&A,124.56,56820804.47
09/20/2022,Expense,Bird,,Travelling Expenses,5.75,56820810.22
09/20/2022,Expense,Bird,Harvey Spector,Credit Card - Ramp,5.75,56820815.97
09/20/2022,Expense,Bird,Harvey Spector,Credit Card - Ramp,5.02,56820820.99
09/20/2022,Expense,Uber,Harvey Spector,Credit Card - Ramp,11.15,56820832.14
09/20/2022,Expense,lime,Harvey Spector,Credit Card - Ramp,8.44,56820840.58
09/20/2022,Expense,LinkedIn,Niteesha Ravela,Credit Card - Ramp,124.56,56820965.14
09/20/2022,Credit Card Payment,,RAMP BUSINESS CO,Account1,-12270.76,56808694.38
09/20/2022,Credit Card Payment,,RAMP BUSINESS CO,Credit Card - Ramp,-12270.76,56796423.62
09/20/2022,Expense,lime,Harvey Spector,Credit Card - Ramp,8.44,56796432.06
09/20/2022,Expense,Uber,Harvey Spector,Credit Card - Ramp,11.15,56796443.21
09/20/2022,Expense,Bird,Harvey Spector,Credit Card - Ramp,5.75,56796448.96
09/20/2022,Expense,Bird,Harvey Spector,Credit Card - Ramp,4.42,56796453.38
09/20/2022,Expense,Sepia,Mike ross,Credit Card - Ramp,133.41,56796586.79
09/20/2022,Expense,Uber Eats,Harvey Spector,Credit Card - Ramp,18.23,56796605.02
09/20/2022,Expense,Bird,Harvey Spector,Credit Card - Ramp,5.02,56796610.04
09/20/2022,Expense,Bird,,Travelling Expenses,4.42,56796614.46
09/20/2022,Expense,Uber Eats,Harvey Spector,Credit Card - Ramp,18.23,56796632.69
09/20/2022,Expense,Bird,Harvey Spector,Credit Card - Ramp,4.42,56796637.11
09/20/2022,Expense,lime,,Travelling Expenses,8.44,56796645.55
09/20/2022,Expense,Bird,,Travelling Expenses,4.42,56796649.97
09/20/2022,Expense,Sepia,Mike ross,Credit Card - Ramp,133.41,56796783.38
09/20/2022,Expense,Uber Eats,Harvey Spector,Meals & Entertainment,18.23,56796801.61
09/21/2022,Expense,lime,,Travelling Expenses,2.63,56796804.24
09/21/2022,Expense,Uber Eats,Harvey Spector,Meals & Entertainment,32.96,56796837.2
09/21/2022,Expense,Iz Substance Cafe Restaurant,Harvey Spector,Meals & Entertainment,14.07,56796851.27
09/21/2022,Expense,lime,,Travelling Expenses,2.63,56796853.9
09/21/2022,Expense,lime,Harvey Spector,Credit Card - Ramp,2.63,56796856.53
09/21/2022,Expense,La Coupole,Mike ross,Credit Card - Ramp,37.2,56796893.73
09/21/2022,Expense,lime,,Travelling Expenses,2.63,56796896.36
09/21/2022,Expense,Iz Substance Cafe Restaurant,Harvey Spector,Meals & Entertainment,14.07,56796910.43
09/21/2022,Expense,Iz Substance Cafe Restaurant,Harvey Spector,Meals & Entertainment,14.07,56796924.5
09/21/2022,Expense,Uber Eats,Harvey Spector,Meals & Entertainment,10.95,56796935.45
09/21/2022,Expense,lime,,Travelling Expenses,3.59,56796939.04
09/21/2022,Expense,lime,,Travelling Expenses,3.59,56796942.63
09/21/2022,Expense,lime,,Travelling Expenses,4.79,56796947.42
09/21/2022,Expense,lime,,Travelling Expenses,4.79,56796952.21
09/21/2022,Expense,Uber Eats,Harvey Spector,Meals & Entertainment,10.95,56796963.16
09/21/2022,Expense,La Coupole,Mike ross,Meals & Entertainment,37.2,56797000.36
09/21/2022,Expense,lime,Harvey Spector,Credit Card - Ramp,4.79,56797005.15
09/21/2022,Expense,La Coupole,Mike ross,Meals & Entertainment,37.2,56797042.35
09/21/2022,Expense,lime,,Travelling Expenses,4.79,56797047.14
09/21/2022,Expense,lime,Harvey Spector,Credit Card - Ramp,3.59,56797050.73
09/21/2022,Expense,lime,Harvey Spector,Credit Card - Ramp,2.63,56797053.36
09/21/2022,Expense,lime,,Travelling Expenses,2.63,56797055.99
09/21/2022,Expense,Uber Eats,Harvey Spector,Meals & Entertainment,10.95,56797066.94
09/21/2022,Expense,Uber Eats,Harvey Spector,Meals & Entertainment,10.95,56797077.89
09/21/2022,Expense,Uber Eats,Harvey Spector,Meals & Entertainment,32.96,56797110.85
09/21/2022,Expense,La Coupole,Mike ross,Meals & Entertainment,37.2,56797148.05
09/21/2022,Expense,Iz Substance Cafe Restaurant,Harvey Spector,Meals & Entertainment,14.07,56797162.12
09/21/2022,Expense,lime,,Travelling Expenses,3.59,56797165.71
09/21/2022,Expense,Uber Eats,Harvey Spector,Meals & Entertainment,32.96,56797198.67
09/21/2022,Expense,lime,Harvey Spector,Credit Card - Ramp,3.59,56797202.26
09/21/2022,Expense,Iz Substance Cafe Restaurant,Harvey Spector,Credit Card - Ramp,14.07,56797216.33
09/21/2022,Expense,Iz Substance Cafe Restaurant,Harvey Spector,Credit Card - Ramp,14.07,56797230.4
09/21/2022,Expense,Uber Eats,Harvey Spector,Credit Card - Ramp,32.96,56797263.36
09/21/2022,Expense,lime,Harvey Spector,Credit Card - Ramp,4.79,56797268.15
09/21/2022,Expense,Uber Eats,Harvey Spector,Credit Card - Ramp,32.96,56797301.11
09/21/2022,Expense,Uber Eats,Harvey Spector,Credit Card - Ramp,10.95,56797312.06
09/21/2022,Expense,La Coupole,Mike ross,Credit Card - Ramp,37.2,56797349.26
09/21/2022,Expense,lime,Harvey Spector,Credit Card - Ramp,3.59,56797352.85
09/21/2022,Expense,La Coupole,Mike ross,Meals & Entertainment,37.2,56797390.05
09/21/2022,Expense,Uber Eats,Harvey Spector,Credit Card - Ramp,10.95,56797401
09/21/2022,Expense,Uber Eats,Harvey Spector,Meals & Entertainment,32.96,56797433.96
09/21/2022,Expense,lime,,Travelling Expenses,3.59,56797437.55
09/21/2022,Expense,Uber Eats,Harvey Spector,Credit Card - Ramp,10.95,56797448.5
09/21/2022,Expense,lime,Harvey Spector,Credit Card - Ramp,2.63,56797451.13
09/21/2022,Expense,Uber Eats,Harvey Spector,Credit Card - Ramp,32.96,56797484.09
09/21/2022,Expense,Iz Substance Cafe Restaurant,Harvey Spector,Credit Card - Ramp,14.07,56797498.16
09/21/2022,Expense,La Coupole,Mike ross,Credit Card - Ramp,37.2,56797535.36
09/21/2022,Expense,Uber Eats,Harvey Spector,Credit Card - Ramp,32.96,56797568.32
09/21/2022,Expense,Iz Substance Cafe Restaurant,Harvey Spector,Credit Card - Ramp,14.07,56797582.39
09/21/2022,Expense,Uber Eats,Harvey Spector,Credit Card - Ramp,10.95,56797593.34
09/21/2022,Expense,La Coupole,Mike ross,Credit Card - Ramp,37.2,56797630.54
09/21/2022,Expense,lime,Harvey Spector,Credit Card - Ramp,4.79,56797635.33
09/21/2022,Expense,lime,,Travelling Expenses,4.79,56797640.12
09/22/2022,Expense,Uber Eats,Harvey Spector,Credit Card - Ramp,8.78,56797648.9
09/22/2022,Expense,Dovetail,,Tools & Subscription - G&A,70,56797718.9
09/22/2022,Expense,Uber Eats,Harvey Spector,Meals & Entertainment,8.78,56797727.68
09/22/2022,Expense,lime,,Travelling Expenses,1.19,56797728.87
09/22/2022,Expense,Dovetail,,Tools & Subscription - G&A,70,56797798.87
09/22/2022,Expense,Manhattan Grand Optical,Harvey Spector,Office expenses:Office supplies,58.89,56797857.76
09/22/2022,Expense,Uber,Harvey Spector,Credit Card - Ramp,12.94,56797870.7
09/22/2022,Expense,Vimcal,Harvey Spector,Credit Card - Ramp,15,56797885.7
09/22/2022,Expense,Dovetail,Harvey Spector,Credit Card - Ramp,70,56797955.7
09/22/2022,Expense,lime,,Travelling Expenses,5.47,56797961.17
09/22/2022,Expense,lime,Harvey Spector,Credit Card - Ramp,4.04,56797965.21
09/22/2022,Expense,lime,Harvey Spector,Credit Card - Ramp,1.19,56797966.4
09/22/2022,Expense,Automate,,Tools & Subscription - G&A,29,56797995.4
09/22/2022,Expense,Automate,Balapavan Tirumani,Credit Card - Ramp,29,56798024.4
09/22/2022,Expense,Dovetail,,Tools & Subscription - G&A,70,56798094.4
09/22/2022,Expense,Automate,Balapavan Tirumani,Credit Card - Ramp,29,56798123.4
09/22/2022,Expense,Uber Eats,Harvey Spector,Meals & Entertainment,8.78,56798132.18
09/22/2022,Expense,Uber,,Travelling Expenses,12.94,56798145.12
09/22/2022,Expense,Automate,Balapavan Tirumani,Credit Card - Ramp,29,56798174.12
09/22/2022,Expense,Vimcal,Harvey Spector,Credit Card - Ramp,15,56798189.12
09/22/2022,Expense,Dovetail,Harvey Spector,Credit Card - Ramp,70,56798259.12
09/22/2022,Expense,Dovetail,Harvey Spector,Credit Card - Ramp,70,56798329.12
09/22/2022,Expense,Vimcal,,Tools & Subscription - G&A,15,56798344.12
09/22/2022,Expense,Manhattan Grand Optical,Harvey Spector,Office expenses:Office supplies,58.89,56798403.01
09/22/2022,Expense,Manhattan Grand Optical,Harvey Spector,Credit Card - Ramp,58.89,56798461.9
09/22/2022,Expense,lime,,Travelling Expenses,5.47,56798467.37
09/22/2022,Expense,Uber Eats,Harvey Spector,Credit Card - Ramp,8.78,56798476.15
09/22/2022,Expense,Vimcal,Harvey Spector,Credit Card - Ramp,15,56798491.15
09/22/2022,Expense,lime,,Travelling Expenses,4.04,56798495.19
09/22/2022,Expense,Manhattan Grand Optical,Harvey Spector,Credit Card - Ramp,58.89,56798554.08
09/22/2022,Expense,lime,,Travelling Expenses,1.19,56798555.27
09/22/2022,Expense,lime,Harvey Spector,Credit Card - Ramp,5.47,56798560.74
09/22/2022,Expense,Dovetail,,Tools & Subscription - G&A,70,56798630.74
09/22/2022,Expense,lime,,Travelling Expenses,4.04,56798634.78
09/22/2022,Expense,Automate,,Tools & Subscription - G&A,29,56798663.78
09/22/2022,Expense,lime,Harvey Spector,Credit Card - Ramp,5.47,56798669.25
09/22/2022,Expense,Uber,,Travelling Expenses,12.94,56798682.19
09/22/2022,Expense,Vimcal,,Tools & Subscription - G&A,15,56798697.19
09/22/2022,Expense,lime,,Travelling Expenses,1.19,56798698.38
09/22/2022,Expense,Manhattan Grand Optical,Harvey Spector,Office expenses:Office supplies,58.89,56798757.27
09/22/2022,Expense,lime,,Travelling Expenses,5.47,56798762.74
09/22/2022,Expense,Manhattan Grand Optical,Harvey Spector,Credit Card - Ramp,58.89,56798821.63
09/22/2022,Expense,lime,Harvey Spector,Credit Card - Ramp,4.04,56798825.67
09/22/2022,Expense,lime,Harvey Spector,Credit Card - Ramp,1.19,56798826.86
09/22/2022,Expense,Uber Eats,Harvey Spector,Credit Card - Ramp,8.78,56798835.64
09/22/2022,Expense,Uber Eats,Harvey Spector,Credit Card - Ramp,8.78,56798844.42
09/22/2022,Expense,Uber,Harvey Spector,Credit Card - Ramp,12.94,56798857.36
09/22/2022,Expense,lime,Harvey Spector,Credit Card - Ramp,5.47,56798862.83
09/22/2022,Expense,Uber Eats,Harvey Spector,Meals & Entertainment,8.78,56798871.61
09/22/2022,Expense,lime,,Travelling Expenses,4.04,56798875.65
09/22/2022,Expense,Vimcal,,Tools & Subscription - G&A,15,56798890.65
09/22/2022,Expense,Automate,,Tools & Subscription - G&A,29,56798919.65
09/22/2022,Expense,lime,Harvey Spector,Credit Card - Ramp,1.19,56798920.84
09/22/2022,Expense,lime,Harvey Spector,Credit Card - Ramp,4.04,56798924.88
09/22/2022,Expense,Manhattan Grand Optical,Harvey Spector,Credit Card - Ramp,58.89,56798983.77
09/22/2022,Expense,lime,,Travelling Expenses,5.47,56798989.24
09/22/2022,Expense,Manhattan Grand Optical,Harvey Spector,Office expenses:Office supplies,58.89,56799048.13
09/22/2022,Expense,Uber,Harvey Spector,Credit Card - Ramp,12.94,56799061.07
09/22/2022,Expense,lime,,Travelling Expenses,1.19,56799062.26
09/22/2022,Expense,Vimcal,,Tools & Subscription - G&A,15,56799077.26
09/22/2022,Expense,Uber,,Travelling Expenses,12.94,56799090.2
09/22/2022,Expense,lime,,Travelling Expenses,4.04,56799094.24
09/22/2022,Expense,Automate,,Tools & Subscription - G&A,29,56799123.24
09/22/2022,Expense,Uber,,Travelling Expenses,12.94,56799136.18
09/22/2022,Expense,Uber Eats,Harvey Spector,Meals & Entertainment,8.78,56799144.96
09/23/2022,Expense,lime,,Travelling Expenses,9.22,56799154.18
09/23/2022,Expense,Uber Eats,Harvey Spector,Meals & Entertainment,10.03,56799164.21
09/23/2022,Expense,Uber Eats,Harvey Spector,Credit Card - Ramp,1.18,56799165.39
09/23/2022,Expense,Uber Eats,Harvey Spector,Meals & Entertainment,39.23,56799204.62
09/23/2022,Expense,Zoom,,Tools & Subscription - G&A,13.98,56799218.6
09/23/2022,Expense,Uber Eats,Harvey Spector,Credit Card - Ramp,1.18,56799219.78
09/23/2022,Expense,Super,,Tools & Subscription - G&A,12,56799231.78
09/23/2022,Expense,Superhuman,,Professional Service Charges,30,56799261.78
09/23/2022,Expense,Superhuman,Mike ross,Credit Card - Ramp,30,56799291.78
09/23/2022,Expense,Uber Eats,Harvey Spector,Credit Card - Ramp,39.23,56799331.01
09/23/2022,Expense,Uber Eats,Harvey Spector,Credit Card - Ramp,10.03,56799341.04
09/23/2022,Expense,lime,,Travelling Expenses,9.22,56799350.26
09/23/2022,Expense,Bird,,Travelling Expenses,4.55,56799354.81
09/23/2022,Expense,Uber Eats,Harvey Spector,Credit Card - Ramp,39.23,56799394.04
09/23/2022,Expense,Super,Harvey Spector,Credit Card - Ramp,12,56799406.04
09/23/2022,Expense,Uber Eats,Harvey Spector,Credit Card - Ramp,10.03,56799416.07
09/23/2022,Expense,Zoom,Amani Shariff,Credit Card - Ramp,13.98,56799430.05
09/23/2022,Expense,Uber Eats,Harvey Spector,Credit Card - Ramp,39.23,56799469.28
09/23/2022,Expense,lime,Harvey Spector,Credit Card - Ramp,9.22,56799478.5
09/23/2022,Expense,Zoom,Amani Shariff,Credit Card - Ramp,13.98,56799492.48
09/23/2022,Expense,Super,Harvey Spector,Credit Card - Ramp,12,56799504.48
09/23/2022,Expense,Superhuman,Mike ross,Credit Card - Ramp,30,56799534.48
09/23/2022,Expense,Bird,Harvey Spector,Credit Card - Ramp,4.55,56799539.03
09/23/2022,Expense,Zoom,Amani Shariff,Credit Card - Ramp,13.98,56799553.01
09/23/2022,Expense,Super,Harvey Spector,Credit Card - Ramp,12,56799565.01
09/23/2022,Expense,Uber Eats,Harvey Spector,Credit Card - Ramp,1.18,56799566.19
09/23/2022,Expense,Uber Eats,Harvey Spector,Credit Card - Ramp,10.03,56799576.22
09/23/2022,Expense,Super,,Tools & Subscription - G&A,12,56799588.22
09/23/2022,Expense,Uber Eats,Harvey Spector,Credit Card - Ramp,39.23,56799627.45
09/23/2022,Expense,Uber Eats,Harvey Spector,Meals & Entertainment,10.03,56799637.48
09/23/2022,Expense,lime,,Travelling Expenses,9.22,56799646.7
09/23/2022,Expense,Uber Eats,Harvey Spector,Meals & Entertainment,39.23,56799685.93
09/23/2022,Expense,Uber Eats,Harvey Spector,Meals & Entertainment,1.18,56799687.11
09/23/2022,Expense,Superhuman,Mike ross,Credit Card - Ramp,30,56799717.11
09/23/2022,Expense,Bird,,Travelling Expenses,4.55,56799721.66
09/23/2022,Expense,Zoom,,Tools & Subscription - G&A,13.98,56799735.64
09/23/2022,Expense,Superhuman,Mike ross,Credit Card - Ramp,30,56799765.64
09/23/2022,Expense,Superhuman,,Professional Service Charges,30,56799795.64
09/23/2022,Expense,Bird,Harvey Spector,Credit Card - Ramp,4.55,56799800.19
09/23/2022,Expense,lime,Harvey Spector,Credit Card - Ramp,9.22,56799809.41
09/23/2022,Expense,Super,,Tools & Subscription - G&A,12,56799821.41
09/23/2022,Expense,Superhuman,,Professional Service Charges,30,56799851.41
09/23/2022,Expense,Uber Eats,Harvey Spector,Meals & Entertainment,10.03,56799861.44
09/23/2022,Expense,Uber Eats,Harvey Spector,Meals & Entertainment,1.18,56799862.62
09/23/2022,Expense,Uber Eats,Harvey Spector,Meals & Entertainment,39.23,56799901.85
09/23/2022,Expense,Uber Eats,Harvey Spector,Credit Card - Ramp,1.18,56799903.03
09/23/2022,Expense,Bird,,Travelling Expenses,4.55,56799907.58
09/23/2022,Expense,Zoom,,Tools & Subscription - G&A,13.98,56799921.56
09/23/2022,Expense,Zoom,,Tools & Subscription - G&A,13.98,56799935.54
09/23/2022,Expense,Bird,Harvey Spector,Credit Card - Ramp,4.55,56799940.09
09/23/2022,Expense,Super,,Tools & Subscription - G&A,12,56799952.09
09/23/2022,Expense,lime,,Travelling Expenses,9.22,56799961.31
09/23/2022,Expense,Uber Eats,Harvey Spector,Meals & Entertainment,10.03,56799971.34
09/23/2022,Expense,lime,Harvey Spector,Credit Card - Ramp,9.22,56799980.56
09/23/2022,Expense,Bird,,Travelling Expenses,4.55,56799985.11
09/23/2022,Expense,Superhuman,,Professional Service Charges,30,56800015.11
09/23/2022,Expense,Uber Eats,Harvey Spector,Meals & Entertainment,1.18,56800016.29
09/23/2022,Expense,Uber Eats,Harvey Spector,Meals & Entertainment,1.18,56800017.47
09/23/2022,Expense,Uber Eats,Harvey Spector,Meals & Entertainment,39.23,56800056.7
09/23/2022,Expense,Uber Eats,Harvey Spector,Credit Card - Ramp,10.03,56800066.73
09/24/2022,Expense,Uber Eats,Harvey Spector,Credit Card - Ramp,47.6,56800114.33
09/24/2022,Expense,Cafe Di Roma Restaurant,Harvey Spector,Meals & Entertainment,17.44,56800131.77
09/24/2022,Expense,Les B Restaurant,Harvey Spector,Meals & Entertainment,19.22,56800150.99
09/24/2022,Expense,Uber Eats,Harvey Spector,Credit Card - Ramp,47.6,56800198.59
09/24/2022,Expense,Les B Restaurant,Harvey Spector,Credit Card - Ramp,19.22,56800217.81
09/24/2022,Expense,Les B Restaurant,Harvey Spector,Meals & Entertainment,19.22,56800237.03
09/24/2022,Expense,Les B Restaurant,Harvey Spector,Meals & Entertainment,19.22,56800256.25
09/24/2022,Expense,Uber Eats,Harvey Spector,Meals & Entertainment,47.6,56800303.85
09/24/2022,Expense,Cafe Di Roma Restaurant,Harvey Spector,Meals & Entertainment,17.44,56800321.29
09/24/2022,Expense,Cafe Di Roma Restaurant,Harvey Spector,Credit Card - Ramp,17.44,56800338.73
09/24/2022,Expense,Uber Eats,Harvey Spector,Meals & Entertainment,47.6,56800386.33
09/24/2022,Expense,Cafe Di Roma Restaurant,Harvey Spector,Meals & Entertainment,17.44,56800403.77
09/24/2022,Expense,Cafe Di Roma Restaurant,Harvey Spector,Credit Card - Ramp,17.44,56800421.21
09/24/2022,Expense,Les B Restaurant,Harvey Spector,Credit Card - Ramp,19.22,56800440.43
09/24/2022,Expense,Cafe Di Roma Restaurant,Harvey Spector,Credit Card - Ramp,17.44,56800457.87
09/24/2022,Expense,Cafe Di Roma Restaurant,Harvey Spector,Meals & Entertainment,17.44,56800475.31
09/24/2022,Expense,Les B Restaurant,Harvey Spector,Meals & Entertainment,19.22,56800494.53
09/24/2022,Expense,Uber Eats,Harvey Spector,Meals & Entertainment,47.6,56800542.13
09/24/2022,Expense,Les B Restaurant,Harvey Spector,Credit Card - Ramp,19.22,56800561.35
09/24/2022,Expense,Cafe Di Roma Restaurant,Harvey Spector,Credit Card - Ramp,17.44,56800578.79
09/24/2022,Expense,Uber Eats,Harvey Spector,Meals & Entertainment,47.6,56800626.39
09/24/2022,Expense,Uber Eats,Harvey Spector,Credit Card - Ramp,47.6,56800673.99
09/24/2022,Expense,Uber Eats,Harvey Spector,Credit Card - Ramp,47.6,56800721.59
09/24/2022,Expense,Les B Restaurant,Harvey Spector,Credit Card - Ramp,19.22,56800740.81
09/25/2022,Expense,lime,,Travelling Expenses,1.89,56800742.7
09/25/2022,Expense,lime,Harvey Spector,Credit Card - Ramp,1.89,56800744.59
09/25/2022,Expense,lime,,Travelling Expenses,5.06,56800749.65
09/25/2022,Expense,Maison Dandoy,,Meals & Entertainment,13.7,56800763.35
09/25/2022,Expense,Sancak,,Meals & Entertainment,11.82,56800775.17
09/25/2022,Expense,Maison Dandoy,,Meals & Entertainment,13.7,56800788.87
09/25/2022,Expense,lime,,Travelling Expenses,5.06,56800793.93
09/25/2022,Expense,lime,,Travelling Expenses,5.06,56800798.99
09/25/2022,Expense,Zoom,,Tools & Subscription - G&A,14.99,56800813.98
09/25/2022,Expense,lime,Harvey Spector,Credit Card - Ramp,5.06,56800819.04
09/25/2022,Expense,lime,,Travelling Expenses,1.89,56800820.93
09/25/2022,Expense,lime,Harvey Spector,Credit Card - Ramp,5.06,56800825.99
09/25/2022,Expense,Sancak,Harvey Spector,Credit Card - Ramp,11.82,56800837.81
09/25/2022,Expense,Uber Eats,Harvey Spector,Meals & Entertainment,33.45,56800871.26
09/25/2022,Expense,Uber Eats,Harvey Spector,Credit Card - Ramp,33.45,56800904.71
09/25/2022,Expense,Maison Dandoy,Harvey Spector,Credit Card - Ramp,13.7,56800918.41
09/25/2022,Expense,Sancak,,Meals & Entertainment,11.82,56800930.23
09/25/2022,Expense,Zoom,Chad Blumenthal,Credit Card - Ramp,14.99,56800945.22
09/25/2022,Expense,Uber Eats,Harvey Spector,Meals & Entertainment,33.45,56800978.67
09/25/2022,Expense,Zoom,,Tools & Subscription - G&A,14.99,56800993.66
09/25/2022,Expense,Maison Dandoy,Harvey Spector,Credit Card - Ramp,13.7,56801007.36
09/25/2022,Expense,Uber Eats,Harvey Spector,Credit Card - Ramp,33.45,56801040.81
09/25/2022,Expense,Sancak,Harvey Spector,Credit Card - Ramp,11.82,56801052.63
09/25/2022,Expense,lime,,Travelling Expenses,5.06,56801057.69
09/25/2022,Expense,Zoom,Chad Blumenthal,Credit Card - Ramp,14.99,56801072.68
09/25/2022,Expense,lime,Harvey Spector,Credit Card - Ramp,5.06,56801077.74
09/25/2022,Expense,Uber Eats,Harvey Spector,Credit Card - Ramp,33.45,56801111.19
09/25/2022,Expense,Sancak,Harvey Spector,Credit Card - Ramp,11.82,56801123.01
09/25/2022,Expense,lime,Harvey Spector,Credit Card - Ramp,5.06,56801128.07
09/25/2022,Expense,lime,,Travelling Expenses,1.89,56801129.96
09/25/2022,Expense,Maison Dandoy,,Meals & Entertainment,13.7,56801143.66
09/25/2022,Expense,Uber Eats,Harvey Spector,Credit Card - Ramp,33.45,56801177.11
09/25/2022,Expense,lime,,Travelling Expenses,1.89,56801179
09/25/2022,Expense,Uber Eats,Harvey Spector,Meals & Entertainment,33.45,56801212.45
09/25/2022,Expense,lime,,Travelling Expenses,5.06,56801217.51
09/25/2022,Expense,Maison Dandoy,Harvey Spector,Credit Card - Ramp,13.7,56801231.21
09/25/2022,Expense,Sancak,Harvey Spector,Credit Card - Ramp,11.82,56801243.03
09/25/2022,Expense,Zoom,,Tools & Subscription - G&A,14.99,56801258.02
09/25/2022,Expense,Maison Dandoy,Harvey Spector,Credit Card - Ramp,13.7,56801271.72
09/25/2022,Expense,lime,,Travelling Expenses,5.06,56801276.78
09/25/2022,Expense,Maison Dandoy,,Meals & Entertainment,13.7,56801290.48
09/25/2022,Expense,Sancak,,Meals & Entertainment,11.82,56801302.3
09/25/2022,Expense,Zoom,Chad Blumenthal,Credit Card - Ramp,14.99,56801317.29
09/25/2022,Expense,lime,,Travelling Expenses,5.06,56801322.35
09/25/2022,Expense,lime,Harvey Spector,Credit Card - Ramp,1.89,56801324.24
09/25/2022,Expense,lime,Harvey Spector,Credit Card - Ramp,5.06,56801329.3
09/25/2022,Expense,lime,Harvey Spector,Credit Card - Ramp,1.89,56801331.19
09/25/2022,Expense,lime,Harvey Spector,Credit Card - Ramp,5.06,56801336.25
09/25/2022,Expense,lime,,Travelling Expenses,5.06,56801341.31
09/25/2022,Expense,Zoom,,Tools & Subscription - G&A,14.99,56801356.3
09/25/2022,Expense,Uber Eats,Harvey Spector,Meals & Entertainment,33.45,56801389.75
09/25/2022,Expense,Sancak,,Meals & Entertainment,11.82,56801401.57
09/26/2022,Expense,Uber Eats,Harvey Spector,Meals & Entertainment,36.9,56801438.47
09/26/2022,Expense,Uber Eats,Harvey Spector,Credit Card - Ramp,36.9,56801475.37
09/26/2022,Expense,Uber Eats,Harvey Spector,Credit Card - Ramp,36.9,56801512.27
09/26/2022,Expense,franzgustav,Mike ross,Credit Card - Ramp,34.39,56801546.66
09/26/2022,Expense,franzgustav,Mike ross,Credit Card - Ramp,34.39,56801581.05
09/26/2022,Expense,franzgustav,Mike ross,Credit Card - Ramp,34.39,56801615.44
09/26/2022,Expense,franzgustav,Mike ross,Meals & Entertainment,34.39,56801649.83
09/26/2022,Expense,Uber Eats,Harvey Spector,Credit Card - Ramp,36.9,56801686.73
09/26/2022,Expense,franzgustav,Mike ross,Meals & Entertainment,34.39,56801721.12
09/26/2022,Expense,Uber Eats,Harvey Spector,Meals & Entertainment,36.9,56801758.02
09/26/2022,Expense,Uber Eats,Harvey Spector,Meals & Entertainment,36.9,56801794.92
09/26/2022,Expense,Uber Eats,Harvey Spector,Credit Card - Ramp,36.9,56801831.82
09/26/2022,Expense,Uber Eats,Harvey Spector,Meals & Entertainment,36.9,56801868.72
09/26/2022,Expense,franzgustav,Mike ross,Meals & Entertainment,34.39,56801903.11
09/26/2022,Expense,franzgustav,Mike ross,Meals & Entertainment,34.39,56801937.5
09/26/2022,Expense,franzgustav,Mike ross,Credit Card - Ramp,34.39,56801971.89
09/27/2022,Expense,Stratechery Llc,Harvey Spector,Tools & Subscription - G&A,120,56802091.89
09/27/2022,Expense,Uber Eats,Harvey Spector,Credit Card - Ramp,33.31,56802125.2
09/27/2022,Expense,Sentry,,Tools & Subscription - G&A,29,56802154.2
09/27/2022,Expense,Namecheap,,Tools & Subscription - G&A,14.76,56802168.96
09/27/2022,Expense,Sendinblue,,Tools & Subscription - G&A,56.71,56802225.67
09/27/2022,Expense,Uber Eats,Harvey Spector,Credit Card - Ramp,33.31,56802258.98
09/27/2022,Expense,Uber Eats,Harvey Spector,Meals & Entertainment,33.31,56802292.29
09/27/2022,Expense,Sendinblue,,Tools & Subscription - G&A,56.71,56802349
09/27/2022,Expense,Namecheap,,Tools & Subscription - G&A,14.76,56802363.76
09/27/2022,Expense,Sentry,,Tools & Subscription - G&A,29,56802392.76
09/27/2022,Expense,Splitbee,,Tools & Subscription - G&A,16.52,56802409.28
09/27/2022,Expense,Splitbee,,Tools & Subscription - G&A,16.52,56802425.8
09/27/2022,Expense,Splitbee,,Tools & Subscription - G&A,16.52,56802442.32
09/27/2022,Expense,Uber Eats,Harvey Spector,Meals & Entertainment,33.31,56802475.63
09/27/2022,Expense,Stratechery Llc,Harvey Spector,Tools & Subscription - G&A,120,56802595.63
09/27/2022,Expense,Uber Eats,Harvey Spector,Credit Card - Ramp,33.31,56802628.94
09/27/2022,Expense,Stratechery Llc,Harvey Spector,Tools & Subscription - G&A,120,56802748.94
09/27/2022,Expense,Namecheap,,Tools & Subscription - G&A,14.76,56802763.7
09/27/2022,Expense,Sendinblue,,Tools & Subscription - G&A,56.71,56802820.41
09/27/2022,Expense,Sentry,,Tools & Subscription - G&A,29,56802849.41
09/27/2022,Expense,Uber Eats,Harvey Spector,Meals & Entertainment,33.31,56802882.72
09/27/2022,Expense,Sendinblue,Balapavan Tirumani,Credit Card - Ramp,56.71,56802939.43
09/27/2022,Expense,Sendinblue,Balapavan Tirumani,Credit Card - Ramp,56.71,56802996.14
09/27/2022,Expense,Stratechery Llc,Harvey Spector,Credit Card - Ramp,120,56803116.14
09/27/2022,Expense,Splitbee,Harris Jose,Credit Card - Ramp,16.52,56803132.66
09/27/2022,Expense,Namecheap,Harris Jose,Credit Card - Ramp,14.76,56803147.42
09/27/2022,Expense,Sentry,,Tools & Subscription - G&A,29,56803176.42
09/27/2022,Expense,Uber Eats,Harvey Spector,Meals & Entertainment,33.31,56803209.73
09/27/2022,Expense,Uber Eats,Harvey Spector,Credit Card - Ramp,33.31,56803243.04
09/27/2022,Expense,Sentry,Balapavan Tirumani,Credit Card - Ramp,29,56803272.04
09/27/2022,Expense,Sendinblue,Balapavan Tirumani,Credit Card - Ramp,56.71,56803328.75
09/27/2022,Expense,Splitbee,Harris Jose,Credit Card - Ramp,16.52,56803345.27
09/27/2022,Expense,Stratechery Llc,Harvey Spector,Credit Card - Ramp,120,56803465.27
09/27/2022,Expense,Namecheap,Harris Jose,Credit Card - Ramp,14.76,56803480.03
09/27/2022,Expense,Stratechery Llc,Harvey Spector,Tools & Subscription - G&A,120,56803600.03
09/27/2022,Expense,Stratechery Llc,Harvey Spector,Credit Card - Ramp,120,56803720.03
09/27/2022,Expense,Sentry,Balapavan Tirumani,Credit Card - Ramp,29,56803749.03
09/27/2022,Expense,Namecheap,Harris Jose,Credit Card - Ramp,14.76,56803763.79
09/27/2022,Expense,Sentry,Balapavan Tirumani,Credit Card - Ramp,29,56803792.79
09/27/2022,Expense,Splitbee,,Tools & Subscription - G&A,16.52,56803809.31
09/27/2022,Expense,Namecheap,,Tools & Subscription - G&A,14.76,56803824.07
09/27/2022,Expense,Sendinblue,,Tools & Subscription - G&A,56.71,56803880.78
09/27/2022,Expense,Splitbee,Harris Jose,Credit Card - Ramp,16.52,56803897.3
09/28/2022,Expense,Big Company ,Big Company ,Accounts Payable (A/P),-100000,56703897.3
09/28/2022,Expense,Big Company ,Big Company ,Account1,-100000,56603897.3
09/28/2022,Expense,Papier and Co.,,Office expenses,27.57,56603924.87
09/28/2022,Expense,Papier and Co.,Harvey Spector,Credit Card - Ramp,27.57,56603952.44
09/28/2022,Expense,LinkedIn,Mike ross,Credit Card - Ramp,146.83,56604099.27
09/28/2022,Expense,Papier and Co.,,Office expenses,27.57,56604126.84
09/28/2022,Expense,Big Company ,Big Company ,Account1,-100000,56504126.84
09/28/2022,Expense,Caffe Caffee Restaurant,Harvey Spector,Meals & Entertainment,44.11,56504170.95
09/28/2022,Expense,LinkedIn,,Tools & Subscription - G&A,146.83,56504317.78
09/28/2022,Expense,Uber Eats,Harvey Spector,Credit Card - Ramp,38.93,56504356.71
09/28/2022,Expense,Uber Eats,Harvey Spector,Credit Card - Ramp,38.93,56504395.64
09/28/2022,Expense,Caffe Caffee Restaurant,Harvey Spector,Credit Card - Ramp,44.11,56504439.75
09/28/2022,Expense,Caffe Caffee Restaurant,Harvey Spector,Credit Card - Ramp,44.11,56504483.86
09/28/2022,Expense,Papier and Co.,Harvey Spector,Credit Card - Ramp,27.57,56504511.43
09/28/2022,Expense,Uber Eats,Harvey Spector,Credit Card - Ramp,38.93,56504550.36
09/28/2022,Expense,Caffe Caffee Restaurant,Harvey Spector,Credit Card - Ramp,44.11,56504594.47
09/28/2022,Expense,Big Company ,Big Company ,Accounts Payable (A/P),-100000,56404594.47
09/28/2022,Expense,Uber Eats,Harvey Spector,Meals & Entertainment,38.93,56404633.4
09/28/2022,Expense,LinkedIn,Mike ross,Credit Card - Ramp,146.83,56404780.23
09/28/2022,Expense,Papier and Co.,Harvey Spector,Credit Card - Ramp,27.57,56404807.8
09/28/2022,Expense,LinkedIn,,Tools & Subscription - G&A,146.83,56404954.63
09/28/2022,Expense,Caffe Caffee Restaurant,Harvey Spector,Meals & Entertainment,44.11,56404998.74
09/28/2022,Expense,Caffe Caffee Restaurant,Harvey Spector,Credit Card - Ramp,44.11,56405042.85
09/28/2022,Expense,Caffe Caffee Restaurant,Harvey Spector,Meals & Entertainment,44.11,56405086.96
09/28/2022,Expense,LinkedIn,Mike ross,Credit Card - Ramp,146.83,56405233.79
09/28/2022,Expense,Uber Eats,Harvey Spector,Meals & Entertainment,38.93,56405272.72
09/28/2022,Expense,Papier and Co.,,Office expenses,27.57,56405300.29
09/28/2022,Expense,Caffe Caffee Restaurant,Harvey Spector,Meals & Entertainment,44.11,56405344.4
09/28/2022,Expense,Papier and Co.,Harvey Spector,Credit Card - Ramp,27.57,56405371.97
09/28/2022,Expense,Big Company ,Big Company ,Accounts Payable (A/P),-100000,56305371.97
09/28/2022,Expense,Uber Eats,Harvey Spector,Credit Card - Ramp,38.93,56305410.9
09/28/2022,Expense,LinkedIn,,Tools & Subscription - G&A,146.83,56305557.73
09/28/2022,Expense,Big Company ,Big Company ,Account1,-100000,56205557.73
09/28/2022,Expense,Big Company ,Big Company ,Accounts Payable (A/P),-100000,56105557.73
09/28/2022,Expense,Big Company ,Big Company ,Account1,-100000,56005557.73
09/28/2022,Expense,Uber Eats,Harvey Spector,Meals & Entertainment,38.93,56005596.66
09/28/2022,Expense,Uber Eats,Harvey Spector,Meals & Entertainment,38.93,56005635.59
09/28/2022,Expense,LinkedIn,,Tools & Subscription - G&A,146.83,56005782.42
09/28/2022,Expense,Papier and Co.,,Office expenses,27.57,56005809.99
09/29/2022,Expense,Uber,Harvey Spector,Credit Card - Ramp,11.94,56005821.93
09/29/2022,Expense,SumUp,Harvey Spector,Credit Card - Ramp,14.63,56005836.56
09/29/2022,Expense,SNCF,Harvey Spector,Credit Card - Ramp,99.48,56005936.04
09/29/2022,Expense,Income Capitals ,Income Capitals ,Account1,9505,56015441.04
09/29/2022,Expense,Qatar Airways,Harvey Spector,Credit Card - Ramp,8.15,56015449.19
09/29/2022,Expense,1898 The Post,Mike ross,Credit Card - Ramp,37.31,56015486.5
09/29/2022,Expense,Income Capitals ,Income Capitals ,Account1,9505,56024991.5
09/29/2022,Expense,Netlify,,Tools & Subscription - G&A,95,56025086.5
09/29/2022,Expense,Uber,,Travelling Expenses,11.94,56025098.44
09/29/2022,Expense,Income Capitals ,Income Capitals ,Account1,9505,56034603.44
09/29/2022,Expense,Uber Eats,Harvey Spector,Credit Card - Ramp,46.23,56034649.67
09/29/2022,Expense,1898 The Post,Mike ross,Credit Card - Ramp,37.31,56034686.98
09/29/2022,Expense,Berenice Restaurant,Mike ross,Credit Card - Ramp,40.57,56034727.55
09/29/2022,Expense,Berenice Restaurant,Mike ross,Credit Card - Ramp,40.57,56034768.12
09/29/2022,Expense,Apple,Chris George,Credit Card - Ramp,116.82,56034884.94
09/29/2022,Expense,Uber Eats,Harvey Spector,Meals & Entertainment,46.23,56034931.17
09/29/2022,Expense,Income Capitals ,Income Capitals ,Account1,9505,56044436.17
09/29/2022,Expense,Netlify,,Tools & Subscription - G&A,95,56044531.17
09/29/2022,Expense,Apple,Chris George,Credit Card - Ramp,116.82,56044647.99
09/29/2022,Expense,Uber Eats,Harvey Spector,Credit Card - Ramp,46.23,56044694.22
09/29/2022,Expense,SumUp,,Travelling Expenses,14.63,56044708.85
09/29/2022,Expense,Berenice Restaurant,Mike ross,Meals & Entertainment,40.57,56044749.42
09/29/2022,Expense,Qatar Airways,,Travel:Airfare,8.15,56044757.57
09/29/2022,Expense,Apple,Chris George,Office expenses:Office supplies,116.82,56044874.39
09/29/2022,Expense,Netlify,Balapavan Tirumani,Credit Card - Ramp,95,56044969.39
09/29/2022,Expense,SNCF,,Travelling Expenses,99.48,56045068.87
09/29/2022,Expense,Apple,Chris George,Credit Card - Ramp,116.82,56045185.69
09/29/2022,Expense,Uber,Harvey Spector,Credit Card - Ramp,11.94,56045197.63
09/29/2022,Expense,Uber,,Travelling Expenses,11.94,56045209.57
09/29/2022,Expense,Uber Eats,Harvey Spector,Meals & Entertainment,46.23,56045255.8
09/29/2022,Expense,1898 The Post,Mike ross,Credit Card - Ramp,37.31,56045293.11
09/29/2022,Expense,Income Capitals ,Income Capitals ,Contract labor,-9505,56035788.11
09/29/2022,Expense,SumUp,Harvey Spector,Credit Card - Ramp,14.63,56035802.74
09/29/2022,Expense,Income Capitals ,Income Capitals ,Contract labor,-9505,56026297.74
09/29/2022,Expense,SumUp,,Travelling Expenses,14.63,56026312.37
09/29/2022,Expense,1898 The Post,,Travel:Hotels,37.31,56026349.68
09/29/2022,Expense,1898 The Post,,Travel:Hotels,37.31,56026386.99
09/29/2022,Expense,Netlify,Balapavan Tirumani,Credit Card - Ramp,95,56026481.99
09/29/2022,Expense,Qatar Airways,Harvey Spector,Credit Card - Ramp,8.15,56026490.14
09/29/2022,Expense,Berenice Restaurant,Mike ross,Credit Card - Ramp,40.57,56026530.71
09/29/2022,Expense,Uber,,Travelling Expenses,11.94,56026542.65
09/29/2022,Expense,Uber Eats,Harvey Spector,Meals & Entertainment,46.23,56026588.88
09/29/2022,Expense,Berenice Restaurant,Mike ross,Meals & Entertainment,40.57,56026629.45
09/29/2022,Expense,Qatar Airways,,Travel:Airfare,8.15,56026637.6
09/29/2022,Expense,Apple,Chris George,Office expenses:Office supplies,116.82,56026754.42
09/29/2022,Expense,SNCF,,Travelling Expenses,99.48,56026853.9
09/29/2022,Expense,SumUp,,Travelling Expenses,14.63,56026868.53
09/29/2022,Expense,1898 The Post,,Travel:Hotels,37.31,56026905.84
09/29/2022,Expense,Apple,Chris George,Credit Card - Ramp,116.82,56027022.66
09/29/2022,Expense,Qatar Airways,Harvey Spector,Credit Card - Ramp,8.15,56027030.81
09/29/2022,Expense,Berenice Restaurant,Mike ross,Meals & Entertainment,40.57,56027071.38
09/29/2022,Expense,Uber,Harvey Spector,Credit Card - Ramp,11.94,56027083.32
09/29/2022,Expense,Netlify,,Tools & Subscription - G&A,95,56027178.32
09/29/2022,Expense,Qatar Airways,,Travel:Airfare,8.15,56027186.47
09/29/2022,Expense,Apple,Chris George,Office expenses:Office supplies,116.82,56027303.29
09/29/2022,Expense,Uber Eats,Harvey Spector,Credit Card - Ramp,46.23,56027349.52
09/29/2022,Expense,SumUp,Harvey Spector,Credit Card - Ramp,14.63,56027364.15
09/29/2022,Expense,Berenice Restaurant,Mike ross,Credit Card - Ramp,40.57,56027404.72
09/29/2022,Expense,Uber Eats,Harvey Spector,Credit Card - Ramp,46.23,56027450.95
09/29/2022,Expense,SNCF,Harvey Spector,Credit Card - Ramp,99.48,56027550.43
09/29/2022,Expense,1898 The Post,,Travel:Hotels,37.31,56027587.74
09/29/2022,Expense,Qatar Airways,,Travel:Airfare,8.15,56027595.89
09/29/2022,Expense,SNCF,,Travelling Expenses,99.48,56027695.37
09/29/2022,Expense,Uber Eats,Harvey Spector,Meals & Entertainment,46.23,56027741.6
09/29/2022,Expense,Uber,,Travelling Expenses,11.94,56027753.54
09/29/2022,Expense,Netlify,,Tools & Subscription - G&A,95,56027848.54
09/29/2022,Expense,Netlify,Balapavan Tirumani,Credit Card - Ramp,95,56027943.54
09/29/2022,Expense,Apple,Chris George,Office expenses:Office supplies,116.82,56028060.36
09/29/2022,Expense,Berenice Restaurant,Mike ross,Meals & Entertainment,40.57,56028100.93
09/29/2022,Expense,SNCF,Harvey Spector,Credit Card - Ramp,99.48,56028200.41
09/29/2022,Expense,SumUp,,Travelling Expenses,14.63,56028215.04
09/29/2022,Expense,Income Capitals ,Income Capitals ,Contract labor,-9505,56018710.04
09/29/2022,Expense,Income Capitals ,Income Capitals ,Contract labor,-9505,56009205.04
09/29/2022,Expense,SNCF,,Travelling Expenses,99.48,56009304.52
09/30/2022,Expense,Zapier,,Tools & Subscription - G&A,29.99,56009334.51
09/30/2022,Expense,Adobe,Mike ross,Credit Card - Ramp,14.35,56009348.86
09/30/2022,Expense,Zapier,,Tools & Subscription - G&A,29.99,56009378.85
09/30/2022,Expense,Adobe,,Tools & Subscription - S&M,14.35,56009393.2
09/30/2022,Expense,Uber,,Travelling Expenses,19.2,56009412.4
09/30/2022,Expense,Caffe Caffee Restaurant,Mike ross,Credit Card - Ramp,47.52,56009459.92
09/30/2022,Expense,Uber,,Travelling Expenses,19.2,56009479.12
09/30/2022,Expense,Miro,,Tools & Subscription - G&A,90,56009569.12
09/30/2022,Expense,Zapier,,Tools & Subscription - G&A,29.99,56009599.11
09/30/2022,Expense,Uber,,Travelling Expenses,14.12,56009613.23
09/30/2022,Expense,Adobe,,Tools & Subscription - S&M,14.35,56009627.58
09/30/2022,Expense,Uber,Harvey Spector,Credit Card - Ramp,14.12,56009641.7
09/30/2022,Expense,Miro,,Tools & Subscription - G&A,90,56009731.7
09/30/2022,Expense,Uber,Harvey Spector,Credit Card - Ramp,19.2,56009750.9
09/30/2022,Expense,Caffe Caffee Restaurant,Mike ross,Meals & Entertainment,47.52,56009798.42
09/30/2022,Expense,Miro,Mike ross,Credit Card - Ramp,90,56009888.42
09/30/2022,Expense,Zapier,Chad Blumenthal,Credit Card - Ramp,29.99,56009918.41
09/30/2022,Expense,Miro,,Tools & Subscription - G&A,90,56010008.41
09/30/2022,Expense,Caffe Caffee Restaurant,Mike ross,Meals & Entertainment,47.52,56010055.93
09/30/2022,Expense,Uber,Harvey Spector,Credit Card - Ramp,19.2,56010075.13
09/30/2022,Bill,EntityA,Sep2022 Quarter expenses incurred plus 10% mark up per the MSA,Account2,67024.79,56077099.92
09/30/2022,Expense,Uber,Harvey Spector,Credit Card - Ramp,14.12,56077114.04
09/30/2022,Expense,Caffe Caffee Restaurant,Mike ross,Meals & Entertainment,47.52,56077161.56
09/30/2022,Expense,Uber,,Travelling Expenses,14.12,56077175.68
09/30/2022,Expense,Miro,,Tools & Subscription - G&A,90,56077265.68
09/30/2022,Expense,Uber,,Travelling Expenses,14.12,56077279.8
09/30/2022,Bill,EntityA,Sep2022 Quarter expenses incurred plus 10% mark up per the MSA,Account2,67024.79,56144304.59
09/30/2022,Bill,EntityA,Sep2022 Quarter expenses incurred plus 10% mark up per the MSA,Account2,67024.79,56211329.38
09/30/2022,Expense,Uber,Harvey Spector,Credit Card - Ramp,14.12,56211343.5
09/30/2022,Expense,Miro,Mike ross,Credit Card - Ramp,90,56211433.5
09/30/2022,Bill,EntityA,,outsources Services - Australia,67024.79,56278458.29
09/30/2022,Bill,EntityA,,outsources Services - Australia,67024.79,56345483.08
09/30/2022,Expense,Zapier,Chad Blumenthal,Credit Card - Ramp,29.99,56345513.07
09/30/2022,Expense,Adobe,Mike ross,Credit Card - Ramp,14.35,56345527.42
09/30/2022,Expense,Uber,Harvey Spector,Credit Card - Ramp,19.2,56345546.62
09/30/2022,Expense,Miro,Mike ross,Credit Card - Ramp,90,56345636.62
09/30/2022,Bill,EntityA,,outsources Services - Australia,67024.79,56412661.41
09/30/2022,Expense,Adobe,,Tools & Subscription - S&M,14.35,56412675.76
09/30/2022,Expense,Adobe,Mike ross,Credit Card - Ramp,14.35,56412690.11
09/30/2022,Bill,EntityA,Sep2022 Quarter expenses incurred plus 10% mark up per the MSA,Account2,67024.79,56479714.9
09/30/2022,Expense,Uber,,Travelling Expenses,19.2,56479734.1
09/30/2022,Expense,Zapier,,Tools & Subscription - G&A,29.99,56479764.09
09/30/2022,Expense,Caffe Caffee Restaurant,Mike ross,Meals & Entertainment,47.52,56479811.61
09/30/2022,Expense,Uber,,Travelling Expenses,19.2,56479830.81
09/30/2022,Expense,Caffe Caffee Restaurant,Mike ross,Credit Card - Ramp,47.52,56479878.33
09/30/2022,Expense,Caffe Caffee Restaurant,Mike ross,Credit Card - Ramp,47.52,56479925.85
09/30/2022,Expense,Uber,,Travelling Expenses,14.12,56479939.97
09/30/2022,Expense,Caffe Caffee Restaurant,Mike ross,Credit Card - Ramp,47.52,56479987.49
09/30/2022,Expense,Adobe,,Tools & Subscription - S&M,14.35,56480001.84
09/30/2022,Expense,Zapier,Chad Blumenthal,Credit Card - Ramp,29.99,56480031.83
09/30/2022,Bill,EntityA,,outsources Services - Australia,67024.79,56547056.62
10/01/2022,Expense,Render,Balapavan Tirumani,Credit Card - Ramp,22.42,56547079.04
10/01/2022,Expense,Render,Balapavan Tirumani,Credit Card - Ramp,22.42,56547101.46
10/01/2022,Bill,Big Company ,"Service Expenses for the month of September 2022 
INR  36,89,824.68   @ 81.55",Accounts Payable (A/P),45246.16,56592347.62
10/01/2022,Bill,Big Company ,"Service Expenses for the month of September 2022 
INR  36,89,824.68   @ 81.55",Accounts Payable (A/P),45246.16,56637593.78
10/01/2022,Expense,Render,,Tools & Subscription - G&A,22.42,56637616.2
10/01/2022,Expense,Google G Suite,Mike ross,Credit Card - Ramp,102.51,56637718.71
10/01/2022,Expense,Render,Balapavan Tirumani,Credit Card - Ramp,22.42,56637741.13
10/01/2022,Expense,Google G Suite,Mike ross,Credit Card - Ramp,102.51,56637843.64
10/01/2022,Bill,Big Company ,,Outsources Services - India,45246.16,56683089.8
10/01/2022,Expense,Google G Suite,Mike ross,Credit Card - Ramp,102.51,56683192.31
10/01/2022,Bill,Big Company ,,Outsources Services - India,45246.16,56728438.47
10/01/2022,Expense,Google G Suite,,Tools & Subscription - G&A,102.51,56728540.98
10/01/2022,Bill,Big Company ,,Outsources Services - India,45246.16,56773787.14
10/01/2022,Expense,Render,,Tools & Subscription - G&A,22.42,56773809.56
10/01/2022,Bill,Big Company ,,Outsources Services - India,45246.16,56819055.72
10/01/2022,Bill,Big Company ,"Service Expenses for the month of September 2022 
INR  36,89,824.68   @ 81.55",Accounts Payable (A/P),45246.16,56864301.88
10/01/2022,Expense,Google G Suite,,Tools & Subscription - G&A,102.51,56864404.39
10/01/2022,Expense,Render,,Tools & Subscription - G&A,22.42,56864426.81
10/01/2022,Expense,Google G Suite,,Tools & Subscription - G&A,102.51,56864529.32
10/01/2022,Expense,Render,,Tools & Subscription - G&A,22.42,56864551.74
10/01/2022,Bill,Big Company ,"Service Expenses for the month of September 2022 
INR  36,89,824.68   @ 81.55",Accounts Payable (A/P),45246.16,56909797.9
10/01/2022,Expense,Google G Suite,,Tools & Subscription - G&A,102.51,56909900.41
10/02/2022,Expense,Newrest,Harvey Spector,Meals & Entertainment,18.14,56909918.55
10/02/2022,Expense,The New York Times,Mike ross,Credit Card - Ramp,1.31,56909919.86
10/02/2022,Expense,The New York Times,Mike ross,Credit Card - Ramp,1.31,56909921.17
10/02/2022,Expense,Qatar,Harvey Spector,Credit Card - Ramp,32.42,56909953.59
10/02/2022,Expense,Qatar,,Travel:Airfare,32.42,56909986.01
10/02/2022,Expense,2699 Parking Front Park,Harvey Spector,Credit Card - Ramp,2.96,56909988.97
10/02/2022,Expense,The New York Times,,General business expenses:Memberships & subscriptions,1.31,56909990.28
10/02/2022,Expense,2699 Parking Front Park,Harvey Spector,Travelling Expenses,2.96,56909993.24
10/02/2022,Expense,Newrest,Harvey Spector,Meals & Entertainment,18.14,56910011.38
10/02/2022,Expense,The New York Times,,General business expenses:Memberships & subscriptions,1.31,56910012.69
10/02/2022,Expense,The New York Times,,General business expenses:Memberships & subscriptions,1.31,56910014
10/02/2022,Expense,The New York Times,Mike ross,Credit Card - Ramp,1.31,56910015.31
10/02/2022,Expense,2699 Parking Front Park,Harvey Spector,Travelling Expenses,2.96,56910018.27
10/02/2022,Expense,Qatar,,Travel:Airfare,32.42,56910050.69
10/02/2022,Expense,Newrest,Harvey Spector,Meals & Entertainment,18.14,56910068.83
10/02/2022,Expense,Newrest,Harvey Spector,Meals & Entertainment,18.14,56910086.97
10/02/2022,Expense,The New York Times,Mike ross,Credit Card - Ramp,1.31,56910088.28
10/02/2022,Expense,2699 Parking Front Park,Harvey Spector,Travelling Expenses,2.96,56910091.24
10/02/2022,Expense,2699 Parking Front Park,Harvey Spector,Credit Card - Ramp,2.96,56910094.2
10/02/2022,Expense,Qatar,,Travel:Airfare,32.42,56910126.62
10/02/2022,Expense,Newrest,Harvey Spector,Credit Card - Ramp,18.14,56910144.76
10/02/2022,Expense,2699 Parking Front Park,Harvey Spector,Credit Card - Ramp,2.96,56910147.72
10/02/2022,Expense,Newrest,Harvey Spector,Credit Card - Ramp,18.14,56910165.86
10/02/2022,Expense,Qatar,,Travel:Airfare,32.42,56910198.28
10/02/2022,Expense,Newrest,Harvey Spector,Credit Card - Ramp,18.14,56910216.42
10/02/2022,Expense,Qatar,Harvey Spector,Credit Card - Ramp,32.42,56910248.84
10/02/2022,Expense,The New York Times,,General business expenses:Memberships & subscriptions,1.31,56910250.15
10/02/2022,Expense,Qatar,Harvey Spector,Credit Card - Ramp,32.42,56910282.57
10/02/2022,Expense,Newrest,Harvey Spector,Credit Card - Ramp,18.14,56910300.71
10/02/2022,Expense,2699 Parking Front Park,Harvey Spector,Travelling Expenses,2.96,56910303.67
10/03/2022,Expense,Medium,,General business expenses:Memberships & subscriptions,50,56910353.67
10/03/2022,Expense,Medium,,General business expenses:Memberships & subscriptions,50,56910403.67
10/03/2022,Expense,Medium,Niteesha Ravela,Credit Card - Ramp,50,56910453.67
10/03/2022,Expense,Medium,,General business expenses:Memberships & subscriptions,50,56910503.67
10/03/2022,Expense,Mazurek Co,,Tools & Subscription - G&A,29.95,56910533.62
10/03/2022,Expense,Medium,Niteesha Ravela,Credit Card - Ramp,50,56910583.62
10/03/2022,Expense,Medium,Niteesha Ravela,Credit Card - Ramp,50,56910633.62
10/03/2022,Expense,Mazurek Co,Harvey Spector,Credit Card - Ramp,29.95,56910663.57
10/03/2022,Expense,Mazurek Co,,Tools & Subscription - G&A,29.95,56910693.52
10/03/2022,Expense,Mazurek Co,Harvey Spector,Credit Card - Ramp,29.95,56910723.47
10/03/2022,Expense,Mazurek Co,Harvey Spector,Credit Card - Ramp,29.95,56910753.42
10/03/2022,Expense,Mazurek Co,,Tools & Subscription - G&A,29.95,56910783.37
10/03/2022,Expense,Medium,Niteesha Ravela,Credit Card - Ramp,50,56910833.37
10/03/2022,Expense,Mazurek Co,,Tools & Subscription - G&A,29.95,56910863.32
10/03/2022,Expense,Medium,,General business expenses:Memberships & subscriptions,50,56910913.32
10/04/2022,Expense,Gum.Co Cc Damonxart,Harvey Spector,Credit Card - Ramp,14,56910927.32
10/04/2022,Expense,Gum.Co Cc Damonxart,,General business expenses:Memberships & subscriptions,14,56910941.32
10/04/2022,Expense,Gum.Co Cc Damonxart,,General business expenses:Memberships & subscriptions,14,56910955.32
10/04/2022,Expense,Zoom,,Tools & Subscription - G&A,137.51,56911092.83
10/04/2022,Expense,Gum.Co Cc Damonxart,,General business expenses:Memberships & subscriptions,14,56911106.83
10/04/2022,Expense,Zoom,,Tools & Subscription - G&A,137.51,56911244.34
10/04/2022,Expense,Gum.Co Cc Damonxart,,General business expenses:Memberships & subscriptions,14,56911258.34
10/04/2022,Expense,Zoom,,Tools & Subscription - G&A,137.51,56911395.85
10/04/2022,Expense,Zoom,Mike ross,Credit Card - Ramp,137.51,56911533.36
10/04/2022,Expense,Gum.Co Cc Damonxart,Harvey Spector,Credit Card - Ramp,14,56911547.36
10/04/2022,Expense,Zoom,Mike ross,Credit Card - Ramp,137.51,56911684.87
10/04/2022,Expense,Gum.Co Cc Damonxart,Harvey Spector,Credit Card - Ramp,14,56911698.87
10/04/2022,Expense,Zoom,,Tools & Subscription - G&A,137.51,56911836.38
10/04/2022,Expense,Gum.Co Cc Damonxart,Harvey Spector,Credit Card - Ramp,14,56911850.38
10/04/2022,Expense,Zoom,Mike ross,Credit Card - Ramp,137.51,56911987.89
10/05/2022,Expense,Income Capitals ,Income Capitals ,Contract labor,-10134.72,56901853.17
10/05/2022,Expense,Income Capitals ,Income Capitals ,Contract labor,-10134.72,56891718.45
10/05/2022,Expense,Aroma Restaurant,Mike ross,Meals & Entertainment,60.51,56891778.96
10/05/2022,Expense,Income Capitals ,Income Capitals ,Account1,10134.72,56901913.68
10/05/2022,Expense,Income Capitals ,Income Capitals ,Contract labor,-10134.72,56891778.96
10/05/2022,Expense,Income Capitals ,Income Capitals ,Account1,10134.72,56901913.68
10/05/2022,Expense,Aroma Restaurant,Mike ross,Credit Card - Ramp,60.51,56901974.19
10/05/2022,Expense,Aroma Restaurant,Mike ross,Meals & Entertainment,60.51,56902034.7
10/05/2022,Expense,Aroma Restaurant,Mike ross,Meals & Entertainment,60.51,56902095.21
10/05/2022,Expense,Income Capitals ,Income Capitals ,Account1,10134.72,56912229.93
10/05/2022,Expense,Aroma Restaurant,Mike ross,Credit Card - Ramp,60.51,56912290.44
10/05/2022,Expense,Income Capitals ,Income Capitals ,Account1,10134.72,56922425.16
10/05/2022,Expense,Aroma Restaurant,Mike ross,Credit Card - Ramp,60.51,56922485.67
10/05/2022,Expense,Aroma Restaurant,Mike ross,Credit Card - Ramp,60.51,56922546.18
10/05/2022,Expense,Aroma Restaurant,Mike ross,Meals & Entertainment,60.51,56922606.69
10/05/2022,Expense,Income Capitals ,Income Capitals ,Contract labor,-10134.72,56912471.97
10/06/2022,Deposit,,Interest Accrual,Interest Received,48.18,56912520.15
10/06/2022,Deposit,,Interest Accrual,Savings (6977),48.18,56912568.33
10/06/2022,Deposit,,Interest Accrual,Interest Received,48.18,56912616.51
10/06/2022,Transfer,,PaymentServiceB Checking **7257,Savings (6977),50000,56962616.51
10/06/2022,Deposit,,Interest Accrual,Interest Received,48.18,56962664.69
10/06/2022,Transfer,,PaymentServiceB Checking **7257,Savings (6977),50000,57012664.69
10/06/2022,Transfer,,PaymentServiceB Checking **7257,Account1,-50000,56962664.69
10/06/2022,Expense,Design Studio,CompanyB,Account1,21541.47,56984206.16
10/06/2022,Transfer,,PaymentServiceB Checking **7257,Account1,-50000,56934206.16
10/06/2022,Deposit,,Interest Accrual,Savings (6977),48.18,56934254.34
10/06/2022,Transfer,,PaymentServiceB Checking **7257,Account1,-50000,56884254.34
10/06/2022,Expense,Design Studio,CompanyB,Advertising & marketing,-21541.47,56862712.87
10/06/2022,Expense,Design Studio,CompanyB,Advertising & marketing,-21541.47,56841171.4
10/06/2022,Expense,Design Studio,CompanyB,Account1,21541.47,56862712.87
10/06/2022,Transfer,,PaymentServiceB Checking **7257,Savings (6977),50000,56912712.87
10/06/2022,Expense,Design Studio,CompanyB,Advertising & marketing,-21541.47,56891171.4
10/06/2022,Transfer,,PaymentServiceB Checking **7257,Account1,-50000,56841171.4
10/06/2022,Deposit,,Interest Accrual,Interest Received,48.18,56841219.58
10/06/2022,Deposit,,Interest Accrual,Savings (6977),48.18,56841267.76
10/06/2022,Expense,Design Studio,CompanyB,Account1,21541.47,56862809.23
10/06/2022,Transfer,,PaymentServiceB Checking **7257,Savings (6977),50000,56912809.23
10/06/2022,Expense,Design Studio,CompanyB,Advertising & marketing,-21541.47,56891267.76
10/06/2022,Expense,Design Studio,CompanyB,Account1,21541.47,56912809.23
10/07/2022,Expense,Mailchimp,,Tools & Subscription - G&A,22.22,56912831.45
10/07/2022,Expense,Mailchimp,,Tools & Subscription - G&A,22.22,56912853.67
10/07/2022,Expense,Mailchimp,Mike ross,Credit Card - Ramp,22.22,56912875.89
10/07/2022,Expense,Mailchimp,Mike ross,Credit Card - Ramp,22.22,56912898.11
10/07/2022,Expense,Mailchimp,Mike ross,Credit Card - Ramp,22.22,56912920.33
10/07/2022,Expense,Mailchimp,,Tools & Subscription - G&A,22.22,56912942.55
10/07/2022,Expense,Mailchimp,,Tools & Subscription - G&A,22.22,56912964.77
10/08/2022,Expense,Calendly,Harvey Spector,Credit Card - Ramp,80,56913044.77
10/08/2022,Expense,Thy,Harvey Spector,Credit Card - Ramp,59.44,56913104.21
10/08/2022,Expense,Thy,,Travel:Airfare,59.44,56913163.65
10/08/2022,Expense,Thy,,Travel:Airfare,61.6,56913225.25
10/08/2022,Expense,Calendly,,Tools & Subscription - G&A,80,56913305.25
10/08/2022,Expense,Thy,Harvey Spector,Credit Card - Ramp,61.6,56913366.85
10/08/2022,Expense,Calendly,Harvey Spector,Credit Card - Ramp,80,56913446.85
10/08/2022,Expense,Thy,,Travel:Airfare,59.44,56913506.29
10/08/2022,Expense,Calendly,,Tools & Subscription - G&A,80,56913586.29
10/08/2022,Expense,Thy,Harvey Spector,Credit Card - Ramp,61.6,56913647.89
10/08/2022,Expense,Thy,,Travel:Airfare,59.44,56913707.33
10/08/2022,Expense,Thy,,Travel:Airfare,59.44,56913766.77
10/08/2022,Expense,Calendly,,Tools & Subscription - G&A,80,56913846.77
10/08/2022,Expense,Thy,,Travel:Airfare,61.6,56913908.37
10/08/2022,Expense,Calendly,Harvey Spector,Credit Card - Ramp,80,56913988.37
10/08/2022,Expense,Thy,,Travel:Airfare,61.6,56914049.97
10/08/2022,Expense,Thy,,Travel:Airfare,61.6,56914111.57
10/08/2022,Expense,Thy,Harvey Spector,Credit Card - Ramp,61.6,56914173.17
10/08/2022,Expense,Thy,Harvey Spector,Credit Card - Ramp,59.44,56914232.61
10/08/2022,Expense,Calendly,,Tools & Subscription - G&A,80,56914312.61
10/08/2022,Expense,Thy,Harvey Spector,Credit Card - Ramp,59.44,56914372.05
10/09/2022,Expense,"The Pragmatic Programmers, LLC",,General business expenses:Memberships & subscriptions,16,56914388.05
10/09/2022,Expense,"The Pragmatic Programmers, LLC",Anik Das,Credit Card - Ramp,16,56914404.05
10/09/2022,Expense,Pragmaticengineer.Com,,Tools & Subscription - G&A,15,56914419.05
10/09/2022,Expense,Usersnap,,Tools & Subscription - G&A,19,56914438.05
10/09/2022,Expense,"The Pragmatic Programmers, LLC",,General business expenses:Memberships & subscriptions,16,56914454.05
10/09/2022,Expense,Usersnap,Harris Jose,Credit Card - Ramp,19,56914473.05
10/09/2022,Expense,"The Pragmatic Programmers, LLC",,General business expenses:Memberships & subscriptions,16,56914489.05
10/09/2022,Expense,Pragmaticengineer.Com,,Tools & Subscription - G&A,15,56914504.05
10/09/2022,Expense,Usersnap,,Tools & Subscription - G&A,19,56914523.05
10/09/2022,Expense,Pragmaticengineer.Com,Harvey Spector,Credit Card - Ramp,15,56914538.05
10/09/2022,Expense,Pragmaticengineer.Com,,Tools & Subscription - G&A,15,56914553.05
10/09/2022,Expense,"The Pragmatic Programmers, LLC",,General business expenses:Memberships & subscriptions,16,56914569.05
10/09/2022,Expense,Usersnap,Harris Jose,Credit Card - Ramp,19,56914588.05
10/09/2022,Expense,"The Pragmatic Programmers, LLC",Anik Das,Credit Card - Ramp,16,56914604.05
10/09/2022,Expense,Pragmaticengineer.Com,Harvey Spector,Credit Card - Ramp,15,56914619.05
10/09/2022,Expense,Usersnap,Harris Jose,Credit Card - Ramp,19,56914638.05
10/09/2022,Expense,Pragmaticengineer.Com,,Tools & Subscription - G&A,15,56914653.05
10/09/2022,Expense,"The Pragmatic Programmers, LLC",Anik Das,Credit Card - Ramp,16,56914669.05
10/09/2022,Expense,Pragmaticengineer.Com,Harvey Spector,Credit Card - Ramp,15,56914684.05
10/09/2022,Expense,Usersnap,,Tools & Subscription - G&A,19,56914703.05
10/09/2022,Expense,"The Pragmatic Programmers, LLC",Anik Das,Credit Card - Ramp,16,56914719.05
10/09/2022,Expense,Usersnap,,Tools & Subscription - G&A,19,56914738.05
10/10/2022,Expense,PocketSmith,,Tools & Subscription - G&A,4.98,56914743.03
10/10/2022,Expense,Gum.Co Cc Luca Palmie,Anik Das,Credit Card - Ramp,15.49,56914758.52
10/10/2022,Expense,Pause Cafe,Harvey Spector,Meals & Entertainment,16.63,56914775.15
10/10/2022,Expense,Insider,Harvey Spector,Credit Card - Ramp,1,56914776.15
10/10/2022,Expense,Gum.Co Cc Luca Palmie,,General business expenses:Memberships & subscriptions,15.49,56914791.64
10/10/2022,Expense,Pause Cafe,Harvey Spector,Credit Card - Ramp,16.63,56914808.27
10/10/2022,Expense,Heroku,Balapavan Tirumani,Tools & Subscription - S&M,81.05,56914889.32
10/10/2022,Expense,Pause Cafe,Harvey Spector,Meals & Entertainment,16.63,56914905.95
10/10/2022,Expense,Pause Cafe,Harvey Spector,Credit Card - Ramp,16.63,56914922.58
10/10/2022,Expense,Pause Cafe,Harvey Spector,Meals & Entertainment,16.63,56914939.21
10/10/2022,Expense,Heroku,Balapavan Tirumani,Tools & Subscription - S&M,81.05,56915020.26
10/10/2022,Expense,Gum.Co Cc Luca Palmie,Anik Das,Credit Card - Ramp,15.49,56915035.75
10/10/2022,Expense,Insider,Harvey Spector,Tools & Subscription - G&A,1,56915036.75
10/10/2022,Expense,Heroku,Balapavan Tirumani,Tools & Subscription - S&M,81.05,56915117.8
10/10/2022,Expense,Gum.Co Cc Luca Palmie,,General business expenses:Memberships & subscriptions,15.49,56915133.29
10/10/2022,Expense,Gum.Co Cc Luca Palmie,Anik Das,Credit Card - Ramp,15.49,56915148.78
10/10/2022,Expense,PocketSmith,,Tools & Subscription - G&A,4.98,56915153.76
10/10/2022,Expense,Pause Cafe,Harvey Spector,Credit Card - Ramp,16.63,56915170.39
10/10/2022,Expense,Insider,Harvey Spector,Tools & Subscription - G&A,1,56915171.39
10/10/2022,Expense,Insider,Harvey Spector,Tools & Subscription - G&A,1,56915172.39
10/10/2022,Expense,PocketSmith,Harvey Spector,Credit Card - Ramp,4.98,56915177.37
10/10/2022,Expense,Gum.Co Cc Luca Palmie,,General business expenses:Memberships & subscriptions,15.49,56915192.86
10/10/2022,Expense,Heroku,Balapavan Tirumani,Credit Card - Ramp,81.05,56915273.91
10/10/2022,Expense,Insider,Harvey Spector,Tools & Subscription - G&A,1,56915274.91
10/10/2022,Expense,Gum.Co Cc Luca Palmie,,General business expenses:Memberships & subscriptions,15.49,56915290.4
10/10/2022,Expense,Heroku,Balapavan Tirumani,Tools & Subscription - S&M,81.05,56915371.45
10/10/2022,Expense,Heroku,Balapavan Tirumani,Credit Card - Ramp,81.05,56915452.5
10/10/2022,Expense,Heroku,Balapavan Tirumani,Credit Card - Ramp,81.05,56915533.55
10/10/2022,Expense,Pause Cafe,Harvey Spector,Meals & Entertainment,16.63,56915550.18
10/10/2022,Expense,Pause Cafe,Harvey Spector,Credit Card - Ramp,16.63,56915566.81
10/10/2022,Expense,PocketSmith,,Tools & Subscription - G&A,4.98,56915571.79
10/10/2022,Expense,PocketSmith,Harvey Spector,Credit Card - Ramp,4.98,56915576.77
10/10/2022,Expense,PocketSmith,,Tools & Subscription - G&A,4.98,56915581.75
10/10/2022,Expense,Insider,Harvey Spector,Credit Card - Ramp,1,56915582.75
10/10/2022,Expense,Insider,Harvey Spector,Credit Card - Ramp,1,56915583.75
10/10/2022,Expense,Gum.Co Cc Luca Palmie,Anik Das,Credit Card - Ramp,15.49,56915599.24
10/10/2022,Expense,PocketSmith,Harvey Spector,Credit Card - Ramp,4.98,56915604.22
10/11/2022,Expense,Royale Specialty,Mike ross,Credit Card - Ramp,13.12,56915617.34
10/11/2022,Expense,Royale Specialty,Mike ross,Credit Card - Ramp,13.12,56915630.46
10/11/2022,Expense,Royale Specialty,Mike ross,Credit Card - Ramp,13.12,56915643.58
10/11/2022,Expense,Royale Specialty,Mike ross,Meals & Entertainment,13.12,56915656.7
10/11/2022,Expense,Royale Specialty,Mike ross,Credit Card - Ramp,13.12,56915669.82
10/11/2022,Expense,Royale Specialty,Mike ross,Meals & Entertainment,13.12,56915682.94
10/11/2022,Expense,Royale Specialty,Mike ross,Meals & Entertainment,13.12,56915696.06
10/11/2022,Expense,Royale Specialty,Mike ross,Meals & Entertainment,13.12,56915709.18
10/12/2022,Expense,Tier,Harvey Spector,Credit Card - Ramp,5.35,56915714.53
10/12/2022,Expense,Tier,,Travelling Expenses,5.35,56915719.88
10/12/2022,Expense,Reuben Hills,Mike ross,Meals & Entertainment,15.35,56915735.23
10/12/2022,Expense,Reuben Hills,Mike ross,Credit Card - Ramp,15.35,56915750.58
10/12/2022,Expense,Reuben Hills,Mike ross,Credit Card - Ramp,15.35,56915765.93
10/12/2022,Expense,Reuben Hills,Mike ross,Credit Card - Ramp,15.35,56915781.28
10/12/2022,Expense,pay up,Harvey Spector,Credit Card - Ramp,1358.69,56917139.97
10/12/2022,Expense,pay up,Harvey Spector,Credit Card - Ramp,1358.69,56918498.66
10/12/2022,Expense,pay up,,Travel:Hotels,1358.69,56919857.35
10/12/2022,Expense,Tier,Harvey Spector,Credit Card - Ramp,5.35,56919862.7
10/12/2022,Expense,Tier,Harvey Spector,Credit Card - Ramp,5.35,56919868.05
10/12/2022,Expense,pay up,,Travel:Hotels,1358.69,56921226.74
10/12/2022,Expense,Reuben Hills,Mike ross,Credit Card - Ramp,15.35,56921242.09
10/12/2022,Expense,pay up,,Travel:Hotels,1358.69,56922600.78
10/12/2022,Expense,pay up,Harvey Spector,Credit Card - Ramp,1358.69,56923959.47
10/12/2022,Expense,pay up,,Travel:Hotels,1358.69,56925318.16
10/12/2022,Expense,Tier,,Travelling Expenses,5.35,56925323.51
10/12/2022,Expense,Tier,,Travelling Expenses,5.35,56925328.86
10/12/2022,Expense,Reuben Hills,Mike ross,Meals & Entertainment,15.35,56925344.21
10/12/2022,Expense,Tier,,Travelling Expenses,5.35,56925349.56
10/12/2022,Expense,Reuben Hills,Mike ross,Meals & Entertainment,15.35,56925364.91
10/12/2022,Expense,Reuben Hills,Mike ross,Meals & Entertainment,15.35,56925380.26
10/13/2022,Expense,Framer,,Tools & Subscription - G&A,9.91,56925390.17
10/13/2022,Expense,Intercom,Balapavan Tirumani,Credit Card - Ramp,157,56925547.17
10/13/2022,Expense,Figma,,Tools & Subscription - G&A,385,56925932.17
10/13/2022,Expense,Datadog,Balapavan Tirumani,Credit Card - Ramp,3.25,56925935.42
10/13/2022,Expense,Framer,Harvey Spector,Credit Card - Ramp,9.91,56925945.33
10/13/2022,Expense,Figma,Mike ross,Credit Card - Ramp,385,56926330.33
10/13/2022,Expense,Vercel,Harris Jose,Credit Card - Ramp,140,56926470.33
10/13/2022,Expense,Framer,,Tools & Subscription - G&A,9.91,56926480.24
10/13/2022,Expense,Figma,,Tools & Subscription - G&A,385,56926865.24
10/13/2022,Expense,Vercel,,Tools & Subscription - G&A,140,56927005.24
10/13/2022,Expense,Intercom,,Tools & Subscription - G&A,157,56927162.24
10/13/2022,Expense,Datadog,,Tools & Subscription - G&A,3.25,56927165.49
10/13/2022,Expense,Vercel,,Tools & Subscription - G&A,140,56927305.49
10/13/2022,Expense,Datadog,,Tools & Subscription - G&A,3.25,56927308.74
10/13/2022,Expense,Datadog,,Tools & Subscription - G&A,3.25,56927311.99
10/13/2022,Expense,Intercom,,Tools & Subscription - G&A,157,56927468.99
10/13/2022,Expense,Framer,Harvey Spector,Credit Card - Ramp,9.91,56927478.9
10/13/2022,Expense,Intercom,,Tools & Subscription - G&A,157,56927635.9
10/13/2022,Expense,Intercom,Balapavan Tirumani,Credit Card - Ramp,157,56927792.9
10/13/2022,Expense,Figma,Mike ross,Credit Card - Ramp,385,56928177.9
10/13/2022,Expense,Vercel,Harris Jose,Credit Card - Ramp,140,56928317.9
10/13/2022,Expense,Intercom,,Tools & Subscription - G&A,157,56928474.9
10/13/2022,Expense,Intercom,Balapavan Tirumani,Credit Card - Ramp,157,56928631.9
10/13/2022,Expense,Figma,Mike ross,Credit Card - Ramp,385,56929016.9
10/13/2022,Expense,Figma,,Tools & Subscription - G&A,385,56929401.9
10/13/2022,Expense,Framer,,Tools & Subscription - G&A,9.91,56929411.81
10/13/2022,Expense,Datadog,Balapavan Tirumani,Credit Card - Ramp,3.25,56929415.06
10/13/2022,Expense,Datadog,Balapavan Tirumani,Credit Card - Ramp,3.25,56929418.31
10/13/2022,Expense,Datadog,,Tools & Subscription - G&A,3.25,56929421.56
10/13/2022,Expense,Vercel,,Tools & Subscription - G&A,140,56929561.56
10/13/2022,Expense,Framer,,Tools & Subscription - G&A,9.91,56929571.47
10/13/2022,Expense,Figma,,Tools & Subscription - G&A,385,56929956.47
10/13/2022,Expense,Vercel,,Tools & Subscription - G&A,140,56930096.47
10/13/2022,Expense,Vercel,Harris Jose,Credit Card - Ramp,140,56930236.47
10/13/2022,Expense,Framer,Harvey Spector,Credit Card - Ramp,9.91,56930246.38
10/14/2022,Expense,The Carrington,Mike ross,Credit Card - Ramp,35.28,56930281.66
10/14/2022,Expense,The Carrington,,Meals & Entertainment,35.28,56930316.94
10/14/2022,Expense,Intuit,,Tools & Subscription - G&A,55,56930371.94
10/14/2022,Expense,The Carrington,Mike ross,Credit Card - Ramp,35.28,56930407.22
10/14/2022,Expense,Intuit,,Tools & Subscription - G&A,55,56930462.22
10/14/2022,Expense,Intuit,Harvey Spector,Credit Card - Ramp,55,56930517.22
10/14/2022,Expense,Intuit,Harvey Spector,Credit Card - Ramp,55,56930572.22
10/14/2022,Expense,The Carrington,,Meals & Entertainment,35.28,56930607.5
10/14/2022,Expense,The Carrington,Mike ross,Credit Card - Ramp,35.28,56930642.78
10/14/2022,Expense,Intuit,,Tools & Subscription - G&A,55,56930697.78
10/14/2022,Expense,The Carrington,,Meals & Entertainment,35.28,56930733.06
10/14/2022,Expense,The Carrington,,Meals & Entertainment,35.28,56930768.34
10/14/2022,Expense,The Carrington,Mike ross,Credit Card - Ramp,35.28,56930803.62
10/14/2022,Expense,Intuit,Harvey Spector,Credit Card - Ramp,55,56930858.62
10/14/2022,Expense,Intuit,,Tools & Subscription - G&A,55,56930913.62
10/15/2022,Expense,Uber Eats,Mike ross,Meals & Entertainment,34.84,56930948.46
10/15/2022,Expense,Uber Eats,Mike ross,Credit Card - Ramp,34.84,56930983.3
10/15/2022,Expense,Uber Eats,Mike ross,Meals & Entertainment,34.84,56931018.14
10/15/2022,Expense,Uber Eats,Mike ross,Credit Card - Ramp,34.84,56931052.98
10/15/2022,Expense,Uber Eats,Mike ross,Meals & Entertainment,34.84,56931087.82
10/15/2022,Expense,Uber Eats,Mike ross,Credit Card - Ramp,34.84,56931122.66
10/15/2022,Expense,Uber Eats,Mike ross,Credit Card - Ramp,34.84,56931157.5
10/15/2022,Expense,Uber Eats,Mike ross,Meals & Entertainment,34.84,56931192.34
10/16/2022,Expense,Zapier,,Tools & Subscription - G&A,29.99,56931222.33
10/16/2022,Expense,Linear,,Tools & Subscription - G&A,160,56931382.33
10/16/2022,Expense,Linear,Chad Blumenthal,Credit Card - Ramp,160,56931542.33
10/16/2022,Expense,Zapier,Harvey Spector,Credit Card - Ramp,29.99,56931572.32
10/16/2022,Expense,Zapier,Harvey Spector,Credit Card - Ramp,29.99,56931602.31
10/16/2022,Expense,Linear,Chad Blumenthal,Credit Card - Ramp,160,56931762.31
10/16/2022,Expense,Linear,,Tools & Subscription - G&A,160,56931922.31
10/16/2022,Expense,Linear,Chad Blumenthal,Credit Card - Ramp,160,56932082.31
10/16/2022,Expense,Zapier,Harvey Spector,Credit Card - Ramp,29.99,56932112.3
10/16/2022,Expense,Zapier,,Tools & Subscription - G&A,29.99,56932142.29
10/16/2022,Expense,Linear,,Tools & Subscription - G&A,160,56932302.29
10/16/2022,Expense,Zapier,,Tools & Subscription - G&A,29.99,56932332.28
10/16/2022,Expense,Zapier,,Tools & Subscription - G&A,29.99,56932362.27
10/16/2022,Expense,Linear,,Tools & Subscription - G&A,160,56932522.27
10/17/2022,Expense,Uber Eats,Mike ross,Meals & Entertainment,13.13,56932535.4
10/17/2022,Expense,Uber Eats,Mike ross,Credit Card - Ramp,13.13,56932548.53
10/17/2022,Expense,Uber Eats,Mike ross,Meals & Entertainment,13.13,56932561.66
10/17/2022,Expense,Uber Eats,Mike ross,Credit Card - Ramp,13.13,56932574.79
10/17/2022,Expense,Uber Eats,Mike ross,Credit Card - Ramp,13.13,56932587.92
10/17/2022,Expense,Uber Eats,Mike ross,Meals & Entertainment,13.13,56932601.05
10/17/2022,Expense,Uber Eats,Mike ross,Meals & Entertainment,13.13,56932614.18
10/17/2022,Expense,Uber Eats,Mike ross,Credit Card - Ramp,13.13,56932627.31
10/18/2022,Expense,Cuckoo Callay,Mike ross,Credit Card - Ramp,21.79,56932649.1
10/18/2022,Expense,Uber Eats,Mike ross,Credit Card - Ramp,14.49,56932663.59
10/18/2022,Expense,Superhuman,Harvey Spector,Credit Card - Ramp,30,56932693.59
10/18/2022,Expense,Reuben Hills,Mike ross,Meals & Entertainment,29.78,56932723.37
10/18/2022,Expense,Uber Eats,Mike ross,Credit Card - Ramp,14.49,56932737.86
10/18/2022,Expense,Cuckoo Callay,Mike ross,Meals & Entertainment,21.79,56932759.65
10/18/2022,Expense,Uber Eats,Mike ross,Meals & Entertainment,14.49,56932774.14
10/18/2022,Expense,Superhuman,,Professional Service Charges,30,56932804.14
10/18/2022,Expense,LinkedIn,,Tools & Subscription - G&A,142.37,56932946.51
10/18/2022,Expense,LinkedIn,,Tools & Subscription - G&A,142.37,56933088.88
10/18/2022,Expense,Superhuman,,Professional Service Charges,30,56933118.88
10/18/2022,Expense,LinkedIn,,Tools & Subscription - G&A,142.37,56933261.25
10/18/2022,Expense,Cuckoo Callay,Mike ross,Meals & Entertainment,21.79,56933283.04
10/18/2022,Expense,Reuben Hills,Mike ross,Meals & Entertainment,29.78,56933312.82
10/18/2022,Expense,LinkedIn,Mike ross,Credit Card - Ramp,142.37,56933455.19
10/18/2022,Expense,Uber Eats,Mike ross,Meals & Entertainment,14.49,56933469.68
10/18/2022,Expense,Superhuman,,Professional Service Charges,30,56933499.68
10/18/2022,Expense,LinkedIn,Mike ross,Credit Card - Ramp,142.37,56933642.05
10/18/2022,Expense,Reuben Hills,Mike ross,Credit Card - Ramp,29.78,56933671.83
10/18/2022,Expense,Superhuman,,Professional Service Charges,30,56933701.83
10/18/2022,Expense,Cuckoo Callay,Mike ross,Credit Card - Ramp,21.79,56933723.62
10/18/2022,Expense,Cuckoo Callay,Mike ross,Meals & Entertainment,21.79,56933745.41
10/18/2022,Expense,Uber Eats,Mike ross,Meals & Entertainment,14.49,56933759.9
10/18/2022,Expense,Reuben Hills,Mike ross,Credit Card - Ramp,29.78,56933789.68
10/18/2022,Expense,Reuben Hills,Mike ross,Credit Card - Ramp,29.78,56933819.46
10/18/2022,Expense,Uber Eats,Mike ross,Credit Card - Ramp,14.49,56933833.95
10/18/2022,Expense,Cuckoo Callay,Mike ross,Credit Card - Ramp,21.79,56933855.74
10/18/2022,Expense,LinkedIn,Mike ross,Credit Card - Ramp,142.37,56933998.11
10/18/2022,Expense,Superhuman,Harvey Spector,Credit Card - Ramp,30,56934028.11
10/18/2022,Expense,Superhuman,Harvey Spector,Credit Card - Ramp,30,56934058.11
10/18/2022,Expense,Reuben Hills,Mike ross,Meals & Entertainment,29.78,56934087.89
10/18/2022,Expense,LinkedIn,,Tools & Subscription - G&A,142.37,56934230.26
10/18/2022,Expense,Reuben Hills,Mike ross,Credit Card - Ramp,29.78,56934260.04
10/18/2022,Expense,Superhuman,Harvey Spector,Credit Card - Ramp,30,56934290.04
10/18/2022,Expense,Reuben Hills,Mike ross,Meals & Entertainment,29.78,56934319.82
10/18/2022,Expense,Uber Eats,Mike ross,Meals & Entertainment,14.49,56934334.31
10/18/2022,Expense,Cuckoo Callay,Mike ross,Meals & Entertainment,21.79,56934356.1
10/18/2022,Expense,Uber Eats,Mike ross,Credit Card - Ramp,14.49,56934370.59
10/18/2022,Expense,Cuckoo Callay,Mike ross,Credit Card - Ramp,21.79,56934392.38
10/19/2022,Expense,La Panchina,Mike ross,Meals & Entertainment,43.13,56934435.51
10/19/2022,Expense,Reuben Hills,Mike ross,Meals & Entertainment,8.99,56934444.5
10/19/2022,Expense,La Panchina,Mike ross,Credit Card - Ramp,43.13,56934487.63
10/19/2022,Expense,Amazon Au,Mike ross,Tools & Subscription,31.71,56934519.34
10/19/2022,Expense,Reuben Hills,Mike ross,Credit Card - Ramp,8.99,56934528.33
10/19/2022,Expense,Stockwood Strategy,STOCKWOOD STRATEGY,Professional Service Charges,-7500,56927028.33
10/19/2022,Expense,Amazon Au,Mike ross,Tools & Subscription,31.71,56927060.04
10/19/2022,Expense,La Panchina,Mike ross,Meals & Entertainment,43.13,56927103.17
10/19/2022,Expense,Reuben Hills,Mike ross,Meals & Entertainment,8.99,56927112.16
10/19/2022,Expense,Reuben Hills,Mike ross,Credit Card - Ramp,8.99,56927121.15
10/19/2022,Expense,La Panchina,Mike ross,Credit Card - Ramp,43.13,56927164.28
10/19/2022,Expense,Reuben Hills,Mike ross,Meals & Entertainment,8.99,56927173.27
10/19/2022,Expense,Stockwood Strategy,STOCKWOOD STRATEGY,Account1,7500,56934673.27
10/19/2022,Expense,La Panchina,Mike ross,Meals & Entertainment,43.13,56934716.4
10/19/2022,Expense,Stockwood Strategy,STOCKWOOD STRATEGY,Account1,7500,56942216.4
10/19/2022,Expense,La Panchina,Mike ross,Credit Card - Ramp,43.13,56942259.53
10/19/2022,Expense,Amazon Au,Mike ross,Credit Card - Ramp,31.71,56942291.24
10/19/2022,Expense,Amazon Au,Mike ross,Tools & Subscription,31.71,56942322.95
10/19/2022,Expense,Amazon Au,Mike ross,Credit Card - Ramp,31.71,56942354.66
10/19/2022,Expense,La Panchina,Mike ross,Credit Card - Ramp,43.13,56942397.79
10/19/2022,Expense,Stockwood Strategy,STOCKWOOD STRATEGY,Professional Service Charges,-7500,56934897.79
10/19/2022,Expense,Reuben Hills,Mike ross,Credit Card - Ramp,8.99,56934906.78
10/19/2022,Expense,Stockwood Strategy,STOCKWOOD STRATEGY,Account1,7500,56942406.78
10/19/2022,Expense,Reuben Hills,Mike ross,Credit Card - Ramp,8.99,56942415.77
10/19/2022,Expense,Amazon Au,Mike ross,Tools & Subscription,31.71,56942447.48
10/19/2022,Expense,Stockwood Strategy,STOCKWOOD STRATEGY,Account1,7500,56949947.48
10/19/2022,Expense,La Panchina,Mike ross,Meals & Entertainment,43.13,56949990.61
10/19/2022,Expense,Stockwood Strategy,STOCKWOOD STRATEGY,Professional Service Charges,-7500,56942490.61
10/19/2022,Expense,Amazon Au,Mike ross,Credit Card - Ramp,31.71,56942522.32
10/19/2022,Expense,Stockwood Strategy,STOCKWOOD STRATEGY,Professional Service Charges,-7500,56935022.32
10/19/2022,Expense,Reuben Hills,Mike ross,Meals & Entertainment,8.99,56935031.31
10/20/2022,Expense,LinkedIn,,Tools & Subscription - G&A,119.84,56935151.15
10/20/2022,Expense,Bird,Harvey Spector,Credit Card - Ramp,4.91,56935156.06
10/20/2022,Credit Card Payment,,RAMP,Account1,-6085.7,56929070.36
10/20/2022,Expense,Airbnb,Mike ross,Credit Card - Ramp,117.55,56929187.91
10/20/2022,Expense,Airbnb,,Travel:Hotels,117.55,56929305.46
10/20/2022,Credit Card Credit,Reuben Hills,Mike ross,Credit Card - Ramp,-3.79,56929301.67
10/20/2022,Expense,Bird,,Travelling Expenses,4.91,56929306.58
10/20/2022,Expense,Airbnb,,Travel:Hotels,117.55,56929424.13
10/20/2022,Credit Card Credit,Reuben Hills,Mike ross,Credit Card - Ramp,-3.79,56929420.34
10/20/2022,Credit Card Credit,Reuben Hills,Mike ross,Meals & Entertainment,-3.79,56929416.55
10/20/2022,Credit Card Credit,Reuben Hills,Mike ross,Credit Card - Ramp,-3.79,56929412.76
10/20/2022,Expense,LinkedIn,,Tools & Subscription - G&A,119.84,56929532.6
10/20/2022,Expense,Bird,Harvey Spector,Credit Card - Ramp,4.91,56929537.51
10/20/2022,Expense,Airbnb,Mike ross,Credit Card - Ramp,117.55,56929655.06
10/20/2022,Credit Card Payment,,RAMP,Account1,-6085.7,56923569.36
10/20/2022,Expense,Bird,Harvey Spector,Credit Card - Ramp,4.91,56923574.27
10/20/2022,Credit Card Payment,,RAMP,Account1,-6085.7,56917488.57
10/20/2022,Credit Card Credit,Reuben Hills,Mike ross,Meals & Entertainment,-3.79,56917484.78
10/20/2022,Expense,LinkedIn,Niteesha Ravela,Credit Card - Ramp,119.84,56917604.62
10/20/2022,Expense,LinkedIn,,Tools & Subscription - G&A,119.84,56917724.46
10/20/2022,Expense,Bird,,Travelling Expenses,4.91,56917729.37
10/20/2022,Expense,LinkedIn,Niteesha Ravela,Credit Card - Ramp,119.84,56917849.21
10/20/2022,Credit Card Payment,,RAMP,Credit Card - Ramp,-6085.7,56911763.51
10/20/2022,Credit Card Payment,,RAMP,Credit Card - Ramp,-6085.7,56905677.81
10/20/2022,Expense,LinkedIn,Niteesha Ravela,Credit Card - Ramp,119.84,56905797.65
10/20/2022,Expense,Bird,,Travelling Expenses,4.91,56905802.56
10/20/2022,Credit Card Credit,Reuben Hills,Mike ross,Credit Card - Ramp,-3.79,56905798.77
10/20/2022,Expense,Bird,,Travelling Expenses,4.91,56905803.68
10/20/2022,Credit Card Payment,,RAMP,Credit Card - Ramp,-6085.7,56899717.98
10/20/2022,Credit Card Payment,,RAMP,Credit Card - Ramp,-6085.7,56893632.28
10/20/2022,Expense,LinkedIn,,Tools & Subscription - G&A,119.84,56893752.12
10/20/2022,Expense,Airbnb,Mike ross,Credit Card - Ramp,117.55,56893869.67
10/20/2022,Credit Card Credit,Reuben Hills,Mike ross,Meals & Entertainment,-3.79,56893865.88
10/20/2022,Credit Card Payment,,RAMP,Account1,-6085.7,56887780.18
10/20/2022,Credit Card Credit,Reuben Hills,Mike ross,Meals & Entertainment,-3.79,56887776.39
10/20/2022,Expense,Airbnb,,Travel:Hotels,117.55,56887893.94
10/20/2022,Expense,Airbnb,,Travel:Hotels,117.55,56888011.49
10/21/2022,Expense,Bourke Street Bakery,Mike ross,Meals & Entertainment,8.83,56888020.32
10/21/2022,Expense,Bourke Street Bakery,Mike ross,Credit Card - Ramp,8.83,56888029.15
10/21/2022,Expense,Bourke Street Bakery,Mike ross,Meals & Entertainment,8.83,56888037.98
10/21/2022,Expense,Bourke Street Bakery,Mike ross,Credit Card - Ramp,8.83,56888046.81
10/21/2022,Expense,Bourke Street Bakery,Mike ross,Meals & Entertainment,8.83,56888055.64
10/21/2022,Expense,Bourke Street Bakery,Mike ross,Credit Card - Ramp,8.83,56888064.47
10/21/2022,Expense,Bourke Street Bakery,Mike ross,Meals & Entertainment,8.83,56888073.3
10/21/2022,Expense,Bourke Street Bakery,Mike ross,Credit Card - Ramp,8.83,56888082.13
10/22/2022,Expense,Vimcal,Harvey Spector,Credit Card - Ramp,15,56888097.13
10/22/2022,Expense,Automate,Balapavan Tirumani,Credit Card - Ramp,29,56888126.13
10/22/2022,Expense,Dovetail,Harvey Spector,Credit Card - Ramp,70,56888196.13
10/22/2022,Expense,Vimcal,,Tools & Subscription - G&A,15,56888211.13
10/22/2022,Expense,Automate,,Tools & Subscription - G&A,29,56888240.13
10/22/2022,Expense,Dovetail,,Tools & Subscription - G&A,70,56888310.13
10/22/2022,Expense,Automate,,Tools & Subscription - G&A,29,56888339.13
10/22/2022,Expense,Vimcal,Harvey Spector,Credit Card - Ramp,15,56888354.13
10/22/2022,Expense,Dovetail,,Tools & Subscription - G&A,70,56888424.13
10/22/2022,Expense,Automate,,Tools & Subscription - G&A,29,56888453.13
10/22/2022,Expense,Vimcal,,Tools & Subscription - G&A,15,56888468.13
10/22/2022,Expense,Dovetail,Harvey Spector,Credit Card - Ramp,70,56888538.13
10/22/2022,Expense,Vimcal,Harvey Spector,Credit Card - Ramp,15,56888553.13
10/22/2022,Expense,Vimcal,,Tools & Subscription - G&A,15,56888568.13
10/22/2022,Expense,Dovetail,,Tools & Subscription - G&A,70,56888638.13
10/22/2022,Expense,Automate,,Tools & Subscription - G&A,29,56888667.13
10/22/2022,Expense,Vimcal,,Tools & Subscription - G&A,15,56888682.13
10/22/2022,Expense,Dovetail,,Tools & Subscription - G&A,70,56888752.13
10/22/2022,Expense,Automate,Balapavan Tirumani,Credit Card - Ramp,29,56888781.13
10/22/2022,Expense,Automate,Balapavan Tirumani,Credit Card - Ramp,29,56888810.13
10/22/2022,Expense,Dovetail,Harvey Spector,Credit Card - Ramp,70,56888880.13
10/23/2022,Expense,Benjamin Lewis,Mike ross,Meals & Entertainment,6.32,56888886.45
10/23/2022,Expense,Benjamin Lewis,Mike ross,Meals & Entertainment,6.32,56888892.77
10/23/2022,Expense,Zoom,,Tools & Subscription - G&A,13.39,56888906.16
10/23/2022,Expense,Superhuman,Mike ross,Credit Card - Ramp,30,56888936.16
10/23/2022,Expense,Zoom,,Tools & Subscription - G&A,13.39,56888949.55
10/23/2022,Expense,Superhuman,Mike ross,Credit Card - Ramp,30,56888979.55
10/23/2022,Expense,Super,,Tools & Subscription - G&A,12,56888991.55
10/23/2022,Expense,Superhuman,,Professional Service Charges,30,56889021.55
10/23/2022,Expense,Benjamin Lewis,Mike ross,Meals & Entertainment,6.32,56889027.87
10/23/2022,Expense,Zoom,Amani Shariff,Credit Card - Ramp,13.39,56889041.26
10/23/2022,Expense,Benjamin Lewis,Mike ross,Credit Card - Ramp,6.32,56889047.58
10/23/2022,Expense,Super,Harvey Spector,Credit Card - Ramp,12,56889059.58
10/23/2022,Expense,Super,,Tools & Subscription - G&A,12,56889071.58
10/23/2022,Expense,Zoom,Amani Shariff,Credit Card - Ramp,13.39,56889084.97
10/23/2022,Expense,Zoom,Amani Shariff,Credit Card - Ramp,13.39,56889098.36
10/23/2022,Expense,Superhuman,Mike ross,Credit Card - Ramp,30,56889128.36
10/23/2022,Expense,Super,Harvey Spector,Credit Card - Ramp,12,56889140.36
10/23/2022,Expense,Zoom,,Tools & Subscription - G&A,13.39,56889153.75
10/23/2022,Expense,Benjamin Lewis,Mike ross,Credit Card - Ramp,6.32,56889160.07
10/23/2022,Expense,Superhuman,Mike ross,Credit Card - Ramp,30,56889190.07
10/23/2022,Expense,Super,Harvey Spector,Credit Card - Ramp,12,56889202.07
10/23/2022,Expense,Superhuman,,Professional Service Charges,30,56889232.07
10/23/2022,Expense,Super,,Tools & Subscription - G&A,12,56889244.07
10/23/2022,Expense,Superhuman,,Professional Service Charges,30,56889274.07
10/23/2022,Expense,Zoom,,Tools & Subscription - G&A,13.39,56889287.46
10/23/2022,Expense,Benjamin Lewis,Mike ross,Credit Card - Ramp,6.32,56889293.78
10/23/2022,Expense,Benjamin Lewis,Mike ross,Credit Card - Ramp,6.32,56889300.1
10/23/2022,Expense,Benjamin Lewis,Mike ross,Meals & Entertainment,6.32,56889306.42
10/23/2022,Expense,Superhuman,,Professional Service Charges,30,56889336.42
10/23/2022,Expense,Super,,Tools & Subscription - G&A,12,56889348.42
10/24/2022,Expense,Gum.Co Cc Adam Del Du,,General business expenses:Memberships & subscriptions,33.5,56889381.92
10/24/2022,Expense,Proud Mary,Mike ross,Meals & Entertainment,19.11,56889401.03
10/24/2022,Expense,Benedict Evans,Harvey Spector,Professional Service Charges,10,56889411.03
10/24/2022,Expense,Proud Mary,Mike ross,Credit Card - Ramp,19.11,56889430.14
10/24/2022,Expense,Gum.Co Cc Adam Del Du,Harvey Spector,Credit Card - Ramp,33.5,56889463.64
10/24/2022,Expense,Cole Schafer,Harvey Spector,Tools & Subscription - S&M,97,56889560.64
10/24/2022,Expense,Benedict Evans,Harvey Spector,Credit Card - Ramp,10,56889570.64
10/24/2022,Expense,Proud Mary,Mike ross,Meals & Entertainment,19.11,56889589.75
10/24/2022,Expense,Cole Schafer,Harvey Spector,Tools & Subscription - S&M,97,56889686.75
10/24/2022,Expense,Gum.Co Cc Adam Del Du,Harvey Spector,Credit Card - Ramp,33.5,56889720.25
10/24/2022,Expense,Cole Schafer,Harvey Spector,Credit Card - Ramp,97,56889817.25
10/24/2022,Expense,Gum.Co Cc Adam Del Du,Harvey Spector,Credit Card - Ramp,33.5,56889850.75
10/24/2022,Expense,Benedict Evans,Harvey Spector,Credit Card - Ramp,10,56889860.75
10/24/2022,Expense,Proud Mary,Mike ross,Credit Card - Ramp,19.11,56889879.86
10/24/2022,Expense,Cole Schafer,Harvey Spector,Credit Card - Ramp,97,56889976.86
10/24/2022,Expense,Gum.Co Cc Adam Del Du,,General business expenses:Memberships & subscriptions,33.5,56890010.36
10/24/2022,Expense,Proud Mary,Mike ross,Meals & Entertainment,19.11,56890029.47
10/24/2022,Expense,Gum.Co Cc Adam Del Du,,General business expenses:Memberships & subscriptions,33.5,56890062.97
10/24/2022,Expense,Gum.Co Cc Adam Del Du,Harvey Spector,Credit Card - Ramp,33.5,56890096.47
10/24/2022,Expense,Benedict Evans,Harvey Spector,Professional Service Charges,10,56890106.47
10/24/2022,Expense,Gum.Co Cc Adam Del Du,,General business expenses:Memberships & subscriptions,33.5,56890139.97
10/24/2022,Expense,Proud Mary,Mike ross,Meals & Entertainment,19.11,56890159.08
10/24/2022,Expense,Benedict Evans,Harvey Spector,Credit Card - Ramp,10,56890169.08
10/24/2022,Expense,Benedict Evans,Harvey Spector,Professional Service Charges,10,56890179.08
10/24/2022,Expense,Benedict Evans,Harvey Spector,Credit Card - Ramp,10,56890189.08
10/24/2022,Expense,Cole Schafer,Harvey Spector,Credit Card - Ramp,97,56890286.08
10/24/2022,Expense,Proud Mary,Mike ross,Credit Card - Ramp,19.11,56890305.19
10/24/2022,Expense,Proud Mary,Mike ross,Credit Card - Ramp,19.11,56890324.3
10/24/2022,Expense,Cole Schafer,Harvey Spector,Tools & Subscription - S&M,97,56890421.3
10/24/2022,Expense,Cole Schafer,Harvey Spector,Tools & Subscription - S&M,97,56890518.3
10/24/2022,Expense,Benedict Evans,Harvey Spector,Professional Service Charges,10,56890528.3
10/25/2022,Expense,Design Studio,CompanyB,Advertising & marketing,-7336.99,56883191.31
10/25/2022,Expense,Uber,,Travelling Expenses,89.23,56883280.54
10/25/2022,Expense,Design Studio,CompanyB,Advertising & marketing,-7336.99,56875943.55
10/25/2022,Expense,Design Studio,CompanyB,Account1,7336.99,56883280.54
10/25/2022,Expense,Uber,,Travelling Expenses,89.23,56883369.77
10/25/2022,Expense,Uber,Mike ross,Credit Card - Ramp,89.23,56883459
10/25/2022,Expense,Design Studio,CompanyB,Account1,7336.99,56890795.99
10/25/2022,Expense,Zoom,Chad Blumenthal,Credit Card - Ramp,14.99,56890810.98
10/25/2022,Expense,Design Studio,CompanyB,Advertising & marketing,-7336.99,56883473.99
10/25/2022,Expense,Zoom,,Tools & Subscription - G&A,14.99,56883488.98
10/25/2022,Expense,Uber,Mike ross,Credit Card - Ramp,89.23,56883578.21
10/25/2022,Expense,Miro,,Tools & Subscription - G&A,90,56883668.21
10/25/2022,Expense,Miro,Mike ross,Credit Card - Ramp,90,56883758.21
10/25/2022,Expense,Miro,Mike ross,Credit Card - Ramp,90,56883848.21
10/25/2022,Expense,Uber,,Travelling Expenses,89.23,56883937.44
10/25/2022,Expense,Design Studio,CompanyB,Advertising & marketing,-7336.99,56876600.45
10/25/2022,Expense,Zoom,,Tools & Subscription - G&A,14.99,56876615.44
10/25/2022,Expense,Design Studio,CompanyB,Account1,7336.99,56883952.43
10/25/2022,Expense,Miro,,Tools & Subscription - G&A,90,56884042.43
10/25/2022,Expense,Zoom,,Tools & Subscription - G&A,14.99,56884057.42
10/25/2022,Expense,Miro,,Tools & Subscription - G&A,90,56884147.42
10/25/2022,Expense,Miro,Mike ross,Credit Card - Ramp,90,56884237.42
10/25/2022,Expense,Uber,,Travelling Expenses,89.23,56884326.65
10/25/2022,Expense,Design Studio,CompanyB,Account1,7336.99,56891663.64
10/25/2022,Expense,Uber,Mike ross,Credit Card - Ramp,89.23,56891752.87
10/25/2022,Expense,Zoom,,Tools & Subscription - G&A,14.99,56891767.86
10/25/2022,Expense,Miro,,Tools & Subscription - G&A,90,56891857.86
10/25/2022,Expense,Zoom,Chad Blumenthal,Credit Card - Ramp,14.99,56891872.85
10/25/2022,Expense,Zoom,Chad Blumenthal,Credit Card - Ramp,14.99,56891887.84
10/26/2022,Expense,Income Capitals ,Income Capitals ,Contract labor,-9161.45,56882726.39
10/26/2022,Expense,Income Capitals ,Income Capitals ,Contract labor,-9554,56873172.39
10/26/2022,Transfer,,PaymentServiceB Checking **7257,Account1,-30000,56843172.39
10/26/2022,Expense,Jino Joseph & Associates,JINO JOSEPH & AS,Professional Service Charges,-1800,56841372.39
10/26/2022,Expense,Income Capitals ,Income Capitals ,Contract labor,-9554,56831818.39
10/26/2022,Expense,Jino Joseph & Associates,JINO JOSEPH & AS,Professional Service Charges,-1800,56830018.39
10/26/2022,Expense,Jino Joseph & Associates,JINO JOSEPH & AS,Account1,1800,56831818.39
10/26/2022,Expense,Income Capitals ,Income Capitals ,Contract labor,-9554,56822264.39
10/26/2022,Transfer,,PaymentServiceB Checking **7257,Savings (6977),30000,56852264.39
10/26/2022,Expense,Income Capitals ,Income Capitals ,Contract labor,-9161.45,56843102.94
10/26/2022,Expense,Income Capitals ,Income Capitals ,Contract labor,-9161.45,56833941.49
10/26/2022,Expense,Income Capitals ,Income Capitals ,Account1,9161.45,56843102.94
10/26/2022,Expense,Income Capitals ,Income Capitals ,Account1,9161.45,56852264.39
10/26/2022,Transfer,,PaymentServiceB Checking **7257,Savings (6977),30000,56882264.39
10/26/2022,Expense,Income Capitals ,Income Capitals ,Account1,9554,56891818.39
10/26/2022,Transfer,,PaymentServiceB Checking **7257,Account1,-30000,56861818.39
10/26/2022,Expense,Jino Joseph & Associates,JINO JOSEPH & AS,Account1,1800,56863618.39
10/26/2022,Transfer,,PaymentServiceB Checking **7257,Savings (6977),30000,56893618.39
10/26/2022,Expense,Jino Joseph & Associates,JINO JOSEPH & AS,Account1,1800,56895418.39
10/26/2022,Transfer,,PaymentServiceB Checking **7257,Account1,-30000,56865418.39
10/26/2022,Expense,Income Capitals ,Income Capitals ,Contract labor,-9161.45,56856256.94
10/26/2022,Expense,Income Capitals ,Income Capitals ,Contract labor,-9554,56846702.94
10/26/2022,Expense,Jino Joseph & Associates,JINO JOSEPH & AS,Professional Service Charges,-1800,56844902.94
10/26/2022,Expense,Income Capitals ,Income Capitals ,Account1,9161.45,56854064.39
10/26/2022,Transfer,,PaymentServiceB Checking **7257,Savings (6977),30000,56884064.39
10/26/2022,Transfer,,PaymentServiceB Checking **7257,Account1,-30000,56854064.39
10/26/2022,Expense,Income Capitals ,Income Capitals ,Account1,9554,56863618.39
10/26/2022,Expense,Income Capitals ,Income Capitals ,Account1,9161.45,56872779.84
10/26/2022,Expense,Income Capitals ,Income Capitals ,Account1,9554,56882333.84
10/26/2022,Expense,Jino Joseph & Associates,JINO JOSEPH & AS,Professional Service Charges,-1800,56880533.84
10/26/2022,Expense,Income Capitals ,Income Capitals ,Account1,9554,56890087.84
10/26/2022,Expense,Jino Joseph & Associates,JINO JOSEPH & AS,Account1,1800,56891887.84
10/27/2022,Expense,Splitbee,,Tools & Subscription - G&A,16.52,56891904.36
10/27/2022,Expense,Sendinblue,,Tools & Subscription - G&A,56.22,56891960.58
10/27/2022,Expense,Splitbee,Harris Jose,Credit Card - Ramp,16.52,56891977.1
10/27/2022,Expense,Sentry,Balapavan Tirumani,Credit Card - Ramp,29,56892006.1
10/27/2022,Expense,Splitbee,,Tools & Subscription - G&A,16.52,56892022.62
10/27/2022,Expense,Sentry,Balapavan Tirumani,Credit Card - Ramp,29,56892051.62
10/27/2022,Expense,Sendinblue,Balapavan Tirumani,Credit Card - Ramp,56.22,56892107.84
10/27/2022,Expense,Sentry,,Tools & Subscription - G&A,29,56892136.84
10/27/2022,Expense,Sentry,,Tools & Subscription - G&A,29,56892165.84
10/27/2022,Expense,Splitbee,,Tools & Subscription - G&A,16.52,56892182.36
10/27/2022,Expense,Splitbee,,Tools & Subscription - G&A,16.52,56892198.88
10/27/2022,Expense,Splitbee,Harris Jose,Credit Card - Ramp,16.52,56892215.4
10/27/2022,Expense,Sendinblue,,Tools & Subscription - G&A,56.22,56892271.62
10/27/2022,Expense,Sendinblue,Balapavan Tirumani,Credit Card - Ramp,56.22,56892327.84
10/27/2022,Expense,Sentry,,Tools & Subscription - G&A,29,56892356.84
10/27/2022,Expense,Sendinblue,,Tools & Subscription - G&A,56.22,56892413.06
10/27/2022,Expense,Sendinblue,,Tools & Subscription - G&A,56.22,56892469.28
10/27/2022,Expense,Sentry,,Tools & Subscription - G&A,29,56892498.28
10/27/2022,Expense,Sentry,Balapavan Tirumani,Credit Card - Ramp,29,56892527.28
10/27/2022,Expense,Sendinblue,Balapavan Tirumani,Credit Card - Ramp,56.22,56892583.5
10/27/2022,Expense,Splitbee,Harris Jose,Credit Card - Ramp,16.52,56892600.02
10/29/2022,Expense,Netlify,,Tools & Subscription - G&A,19,56892619.02
10/29/2022,Expense,Netlify,,Tools & Subscription - G&A,19,56892638.02
10/29/2022,Expense,Netlify,Balapavan Tirumani,Credit Card - Ramp,19,56892657.02
10/29/2022,Expense,Netlify,Balapavan Tirumani,Credit Card - Ramp,19,56892676.02
10/29/2022,Expense,Netlify,,Tools & Subscription - G&A,19,56892695.02
10/29/2022,Expense,Netlify,,Tools & Subscription - G&A,19,56892714.02
10/29/2022,Expense,Netlify,Balapavan Tirumani,Credit Card - Ramp,19,56892733.02
10/30/2022,Expense,Artificer,,Meals & Entertainment,6.48,56892739.5
10/30/2022,Expense,Artificer,Mike ross,Credit Card - Ramp,6.48,56892745.98
10/30/2022,Expense,Qantas,Mike ross,Credit Card - Ramp,402.57,56893148.55
10/30/2022,Expense,Zapier,,Tools & Subscription - G&A,29.99,56893178.54
10/30/2022,Expense,GM Cabs,,Travelling Expenses,20.22,56893198.76
10/30/2022,Expense,The New York Times,Mike ross,Credit Card - Ramp,1.3,56893200.06
10/30/2022,Expense,GM Cabs,Mike ross,Credit Card - Ramp,20.22,56893220.28
10/30/2022,Expense,The New York Times,,General business expenses:Memberships & subscriptions,1.3,56893221.58
10/30/2022,Expense,GM Cabs,,Travelling Expenses,20.22,56893241.8
10/30/2022,Expense,Qantas,,Travel:Airfare,402.57,56893644.37
10/30/2022,Expense,Qantas,Mike ross,Credit Card - Ramp,402.57,56894046.94
10/30/2022,Expense,Zapier,Chad Blumenthal,Credit Card - Ramp,29.99,56894076.93
10/30/2022,Expense,GM Cabs,Mike ross,Credit Card - Ramp,20.22,56894097.15
10/30/2022,Expense,Artificer,,Meals & Entertainment,6.48,56894103.63
10/30/2022,Expense,The New York Times,,General business expenses:Memberships & subscriptions,1.3,56894104.93
10/30/2022,Expense,Zapier,,Tools & Subscription - G&A,29.99,56894134.92
10/30/2022,Expense,The New York Times,Mike ross,Credit Card - Ramp,1.3,56894136.22
10/30/2022,Expense,Zapier,Chad Blumenthal,Credit Card - Ramp,29.99,56894166.21
10/30/2022,Expense,Qantas,,Travel:Airfare,402.57,56894568.78
10/30/2022,Expense,Artificer,Mike ross,Credit Card - Ramp,6.48,56894575.26
10/30/2022,Expense,GM Cabs,,Travelling Expenses,20.22,56894595.48
10/30/2022,Expense,Artificer,,Meals & Entertainment,6.48,56894601.96
10/30/2022,Expense,Artificer,Mike ross,Credit Card - Ramp,6.48,56894608.44
10/30/2022,Expense,Zapier,,Tools & Subscription - G&A,29.99,56894638.43
10/30/2022,Expense,Qantas,,Travel:Airfare,402.57,56895041
10/30/2022,Expense,The New York Times,Mike ross,Credit Card - Ramp,1.3,56895042.3
10/30/2022,Expense,GM Cabs,Mike ross,Credit Card - Ramp,20.22,56895062.52
10/30/2022,Expense,The New York Times,Mike ross,Credit Card - Ramp,1.3,56895063.82
10/30/2022,Expense,Qantas,Mike ross,Credit Card - Ramp,402.57,56895466.39
10/30/2022,Expense,Zapier,Chad Blumenthal,Credit Card - Ramp,29.99,56895496.38
10/30/2022,Expense,Artificer,Mike ross,Credit Card - Ramp,6.48,56895502.86
10/30/2022,Expense,Qantas,,Travel:Airfare,402.57,56895905.43
10/30/2022,Expense,The New York Times,,General business expenses:Memberships & subscriptions,1.3,56895906.73
10/30/2022,Expense,Zapier,,Tools & Subscription - G&A,29.99,56895936.72
10/30/2022,Expense,GM Cabs,,Travelling Expenses,20.22,56895956.94
10/30/2022,Expense,Artificer,,Meals & Entertainment,6.48,56895963.42
10/30/2022,Expense,The New York Times,,General business expenses:Memberships & subscriptions,1.3,56895964.72
10/31/2022,Expense,Qantas,,Travel:Airfare,1656.29,56897621.01
10/31/2022,Expense,Adobe,,Tools & Subscription - S&M,14.22,56897635.23
10/31/2022,Bill,Big Company ,,Outsources Services - India,40840.06,56938475.29
10/31/2022,Expense,Qantas,Mike ross,Credit Card - Ramp,1656.29,56940131.58
10/31/2022,Expense,Qantas,,Travel:Airfare,1656.29,56941787.87
10/31/2022,Bill,Big Company ,,Outsources Services - India,40840.06,56982627.93
10/31/2022,Expense,Qantas,Mike ross,Credit Card - Ramp,100.51,56982728.44
10/31/2022,Expense,Bourke Street Bakery,Mike ross,Meals & Entertainment,9,56982737.44
10/31/2022,Expense,Qantas,Mike ross,Credit Card - Ramp,1656.29,56984393.73
10/31/2022,Expense,Adobe,,Tools & Subscription - S&M,14.22,56984407.95
10/31/2022,Expense,Qantas,Mike ross,Credit Card - Ramp,100.51,56984508.46
10/31/2022,Expense,Qantas,Mike ross,Credit Card - Ramp,100.51,56984608.97
10/31/2022,Expense,Qantas,Mike ross,Credit Card - Ramp,1656.29,56986265.26
10/31/2022,Expense,Bourke Street Bakery,Mike ross,Credit Card - Ramp,9,56986274.26
10/31/2022,Expense,Adobe,,Tools & Subscription - S&M,14.22,56986288.48
10/31/2022,Expense,Qantas,,Travel:Airfare,100.51,56986388.99
10/31/2022,Expense,Qantas,,Travel:Airfare,100.51,56986489.5
10/31/2022,Bill,Big Company ,"Service Expenses for the month of October 2022 
INR   33,64,812.60    @ 82.39",Accounts Payable (A/P),40840.06,57027329.56
10/31/2022,Expense,Bourke Street Bakery,Mike ross,Credit Card - Ramp,9,57027338.56
10/31/2022,Expense,Bourke Street Bakery,Mike ross,Meals & Entertainment,9,57027347.56
10/31/2022,Expense,Adobe,,Tools & Subscription - S&M,14.22,57027361.78
10/31/2022,Bill,Big Company ,,Outsources Services - India,40840.06,57068201.84
10/31/2022,Expense,Bourke Street Bakery,Mike ross,Credit Card - Ramp,9,57068210.84
10/31/2022,Expense,Adobe,Mike ross,Credit Card - Ramp,14.22,57068225.06
10/31/2022,Bill,Big Company ,,Outsources Services - India,40840.06,57109065.12
10/31/2022,Expense,Bourke Street Bakery,Mike ross,Meals & Entertainment,9,57109074.12
10/31/2022,Expense,Adobe,Mike ross,Credit Card - Ramp,14.22,57109088.34
10/31/2022,Expense,Qantas,,Travel:Airfare,1656.29,57110744.63
10/31/2022,Expense,Qantas,,Travel:Airfare,1656.29,57112400.92
10/31/2022,Expense,Adobe,Mike ross,Credit Card - Ramp,14.22,57112415.14
10/31/2022,Bill,Big Company ,"Service Expenses for the month of October 2022 
INR   33,64,812.60    @ 82.39",Accounts Payable (A/P),40840.06,57153255.2
10/31/2022,Expense,Qantas,,Travel:Airfare,100.51,57153355.71
10/31/2022,Bill,Big Company ,"Service Expenses for the month of October 2022 
INR   33,64,812.60    @ 82.39",Accounts Payable (A/P),40840.06,57194195.77
10/31/2022,Bill,Big Company ,"Service Expenses for the month of October 2022 
INR   33,64,812.60    @ 82.39",Accounts Payable (A/P),40840.06,57235035.83
10/31/2022,Expense,Bourke Street Bakery,Mike ross,Meals & Entertainment,9,57235044.83
10/31/2022,Expense,Qantas,,Travel:Airfare,100.51,57235145.34
10/31/2022,Expense,Bourke Street Bakery,Mike ross,Credit Card - Ramp,9,57235154.34
11/01/2022,Expense,Samir's Indian Kitchen,Mike ross,Meals & Entertainment,12.54,57235166.88
11/01/2022,Expense,Samir's Indian Kitchen,Mike ross,Meals & Entertainment,12.54,57235179.42
11/01/2022,Expense,Google G Suite,,Tools & Subscription - G&A,103.89,57235283.31
11/01/2022,Expense,Google G Suite,,Tools & Subscription - G&A,103.89,57235387.2
11/01/2022,Expense,Samir's Indian Kitchen,Mike ross,Credit Card - Ramp,12.54,57235399.74
11/01/2022,Expense,Samir's Indian Kitchen,Mike ross,Credit Card - Ramp,12.54,57235412.28
11/01/2022,Expense,Google G Suite,Mike ross,Credit Card - Ramp,103.89,57235516.17
11/01/2022,Expense,Samir's Indian Kitchen,Mike ross,Meals & Entertainment,12.54,57235528.71
11/01/2022,Expense,Google G Suite,,Tools & Subscription - G&A,103.89,57235632.6
11/01/2022,Expense,Samir's Indian Kitchen,Mike ross,Meals & Entertainment,12.54,57235645.14
11/01/2022,Expense,Google G Suite,,Tools & Subscription - G&A,103.89,57235749.03
11/01/2022,Expense,Google G Suite,Mike ross,Credit Card - Ramp,103.89,57235852.92
11/01/2022,Expense,Google G Suite,Mike ross,Credit Card - Ramp,103.89,57235956.81
11/01/2022,Expense,Samir's Indian Kitchen,Mike ross,Credit Card - Ramp,12.54,57235969.35
11/01/2022,Expense,Samir's Indian Kitchen,Mike ross,Credit Card - Ramp,12.54,57235981.89
11/02/2022,Expense,Render,Balapavan Tirumani,Credit Card - Ramp,46.69,57236028.58
11/02/2022,Expense,Gum.Co Cc Makerbox,Harvey Spector,Credit Card - Ramp,39,57236067.58
11/02/2022,Expense,Askable,Mike ross,Tools & Subscription - G&A,646.28,57236713.86
11/02/2022,Expense,Render,,Tools & Subscription - G&A,46.69,57236760.55
11/02/2022,Expense,Gum.Co Cc Makerbox,,General business expenses:Memberships & subscriptions,39,57236799.55
11/02/2022,Expense,Render,Balapavan Tirumani,Credit Card - Ramp,46.69,57236846.24
11/02/2022,Expense,Askable,Mike ross,Tools & Subscription - G&A,646.28,57237492.52
11/02/2022,Expense,Gum.Co Cc Makerbox,,General business expenses:Memberships & subscriptions,39,57237531.52
11/02/2022,Expense,Render,,Tools & Subscription - G&A,46.69,57237578.21
11/02/2022,Expense,Askable,Mike ross,Credit Card - Ramp,646.28,57238224.49
11/02/2022,Expense,Render,Balapavan Tirumani,Credit Card - Ramp,46.69,57238271.18
11/02/2022,Expense,Gum.Co Cc Makerbox,,General business expenses:Memberships & subscriptions,39,57238310.18
11/02/2022,Expense,Askable,Mike ross,Credit Card - Ramp,646.28,57238956.46
11/02/2022,Expense,Render,,Tools & Subscription - G&A,46.69,57239003.15
11/02/2022,Expense,Gum.Co Cc Makerbox,Harvey Spector,Credit Card - Ramp,39,57239042.15
11/02/2022,Expense,Gum.Co Cc Makerbox,,General business expenses:Memberships & subscriptions,39,57239081.15
11/02/2022,Expense,Askable,Mike ross,Tools & Subscription - G&A,646.28,57239727.43
11/02/2022,Expense,Gum.Co Cc Makerbox,Harvey Spector,Credit Card - Ramp,39,57239766.43
11/02/2022,Expense,Render,,Tools & Subscription - G&A,46.69,57239813.12
11/02/2022,Expense,Askable,Mike ross,Tools & Subscription - G&A,646.28,57240459.4
11/02/2022,Expense,Gum.Co Cc Makerbox,Harvey Spector,Credit Card - Ramp,39,57240498.4
11/02/2022,Expense,Askable,Mike ross,Credit Card - Ramp,646.28,57241144.68
11/03/2022,Expense,Namecheap,,Tools & Subscription - G&A,17.16,57241161.84
11/03/2022,Expense,Bondi Chan Restaurant,Mike ross,Meals & Entertainment,58.67,57241220.51
11/03/2022,Expense,Namecheap,Harvey Spector,Credit Card - Ramp,17.16,57241237.67
11/03/2022,Expense,Mazurek Co,Harvey Spector,Credit Card - Ramp,29.95,57241267.62
11/03/2022,Expense,Bondi Chan Restaurant,Mike ross,Meals & Entertainment,58.67,57241326.29
11/03/2022,Expense,Uber,,Travelling Expenses,12.59,57241338.88
11/03/2022,Expense,Mazurek Co,,Tools & Subscription - G&A,29.95,57241368.83
11/03/2022,Expense,Uber,Mike ross,Credit Card - Ramp,15.01,57241383.84
11/03/2022,Expense,Bondi Chan Restaurant,Mike ross,Meals & Entertainment,58.67,57241442.51
11/03/2022,Expense,Uber,Mike ross,Credit Card - Ramp,12.59,57241455.1
11/03/2022,Expense,Bondi Chan Restaurant,Mike ross,Credit Card - Ramp,58.67,57241513.77
11/03/2022,Expense,Mazurek Co,,Tools & Subscription - G&A,29.95,57241543.72
11/03/2022,Expense,Bondi Chan Restaurant,Mike ross,Credit Card - Ramp,58.67,57241602.39
11/03/2022,Expense,Namecheap,,Tools & Subscription - G&A,17.16,57241619.55
11/03/2022,Expense,Mazurek Co,,Tools & Subscription - G&A,29.95,57241649.5
11/03/2022,Expense,Uber,,Travelling Expenses,15.01,57241664.51
11/03/2022,Expense,Uber,Mike ross,Credit Card - Ramp,15.01,57241679.52
11/03/2022,Expense,Uber,Mike ross,Credit Card - Ramp,12.59,57241692.11
11/03/2022,Expense,Mazurek Co,Harvey Spector,Credit Card - Ramp,29.95,57241722.06
11/03/2022,Expense,Uber,,Travelling Expenses,12.59,57241734.65
11/03/2022,Expense,Namecheap,,Tools & Subscription - G&A,17.16,57241751.81
11/03/2022,Expense,Uber,,Travelling Expenses,15.01,57241766.82
11/03/2022,Expense,Mazurek Co,,Tools & Subscription - G&A,29.95,57241796.77
11/03/2022,Expense,Bondi Chan Restaurant,Mike ross,Credit Card - Ramp,58.67,57241855.44
11/03/2022,Expense,Namecheap,Harvey Spector,Credit Card - Ramp,17.16,57241872.6
11/03/2022,Expense,Mazurek Co,Harvey Spector,Credit Card - Ramp,29.95,57241902.55
11/03/2022,Expense,Uber,,Travelling Expenses,12.59,57241915.14
11/03/2022,Expense,Bondi Chan Restaurant,Mike ross,Credit Card - Ramp,58.67,57241973.81
11/03/2022,Expense,Namecheap,,Tools & Subscription - G&A,17.16,57241990.97
11/03/2022,Expense,Uber,Mike ross,Credit Card - Ramp,12.59,57242003.56
11/03/2022,Expense,Uber,,Travelling Expenses,15.01,57242018.57
11/03/2022,Expense,Uber,Mike ross,Credit Card - Ramp,15.01,57242033.58
11/03/2022,Expense,Bondi Chan Restaurant,Mike ross,Meals & Entertainment,58.67,57242092.25
11/03/2022,Expense,Namecheap,Harvey Spector,Credit Card - Ramp,17.16,57242109.41
11/03/2022,Expense,Uber,,Travelling Expenses,12.59,57242122
11/03/2022,Expense,Uber,,Travelling Expenses,15.01,57242137.01
11/04/2022,Expense,Airbnb,,Travel:Hotels,722.61,57242859.62
11/04/2022,Expense,Airbnb,Mike ross,Credit Card - Ramp,722.61,57243582.23
11/04/2022,Expense,Qantas,,Travel:Airfare,64.28,57243646.51
11/04/2022,Expense,Qantas,Mike ross,Credit Card - Ramp,64.28,57243710.79
11/04/2022,Expense,Qantas,,Travel:Airfare,64.28,57243775.07
11/04/2022,Expense,Airbnb,Mike ross,Credit Card - Ramp,722.61,57244497.68
11/04/2022,Expense,Airbnb,Mike ross,Credit Card - Ramp,722.61,57245220.29
11/04/2022,Expense,Airbnb,,Travel:Hotels,722.61,57245942.9
11/04/2022,Expense,Airbnb,,Travel:Hotels,722.61,57246665.51
11/04/2022,Expense,Qantas,Mike ross,Credit Card - Ramp,64.28,57246729.79
11/04/2022,Expense,Qantas,,Travel:Airfare,64.28,57246794.07
11/04/2022,Expense,Qantas,Mike ross,Credit Card - Ramp,64.28,57246858.35
11/04/2022,Expense,Airbnb,,Travel:Hotels,722.61,57247580.96
11/04/2022,Expense,Qantas,,Travel:Airfare,64.28,57247645.24
11/05/2022,Expense,,Interest Accrual,Account1,-0.24,57247645
11/05/2022,Deposit,,Interest Accrual,Interest Received,0.24,57247645.24
11/05/2022,Expense,,Interest Accrual,Account1,-0.24,57247645
11/05/2022,Deposit,,Interest Accrual,Interest Received,49.38,57247694.38
11/05/2022,Deposit,,Interest Accrual,Savings (6977),49.38,57247743.76
11/05/2022,Expense,,Interest Accrual,Interest Received,-0.24,57247743.52
11/05/2022,Deposit,,Interest Accrual,Account1,0.24,57247743.76
11/05/2022,Deposit,,Interest Accrual,Account1,0.24,57247744
11/05/2022,Deposit,,Interest Accrual,Interest Received,0.24,57247744.24
11/05/2022,Deposit,,Interest Accrual,Interest Received,0.24,57247744.48
11/05/2022,Expense,,Interest Accrual,Interest Received,-0.24,57247744.24
11/05/2022,Deposit,,Interest Accrual,Interest Received,49.38,57247793.62
11/05/2022,Deposit,,Interest Accrual,Account1,0.24,57247793.86
11/05/2022,Expense,,Interest Accrual,Interest Received,-0.24,57247793.62
11/05/2022,Deposit,,Interest Accrual,Savings (6977),49.38,57247843
11/05/2022,Deposit,,Interest Accrual,Savings (6977),49.38,57247892.38
11/05/2022,Expense,,Interest Accrual,Account1,-0.24,57247892.14
11/05/2022,Deposit,,Interest Accrual,Interest Received,0.24,57247892.38
11/05/2022,Deposit,,Interest Accrual,Interest Received,49.38,57247941.76
11/05/2022,Expense,,Interest Accrual,Interest Received,-0.24,57247941.52
11/05/2022,Deposit,,Interest Accrual,Interest Received,49.38,57247990.9
11/06/2022,Expense,Airbnb,,Travel:Hotels,1026.59,57249017.49
11/06/2022,Expense,Airbnb,,Travel:Hotels,1026.59,57250044.08
11/06/2022,Expense,Airbnb,Mike ross,Credit Card - Ramp,1026.59,57251070.67
11/06/2022,Expense,Airbnb,Mike ross,Credit Card - Ramp,1026.59,57252097.26
11/06/2022,Expense,Airbnb,,Travel:Hotels,1026.59,57253123.85
11/06/2022,Expense,Airbnb,,Travel:Hotels,1026.59,57254150.44
11/06/2022,Expense,Airbnb,Mike ross,Credit Card - Ramp,1026.59,57255177.03
11/07/2022,Expense,La Panchina,Mike ross,Credit Card - Ramp,31.02,57255208.05
11/07/2022,Expense,Reuben Hills,Mike ross,Credit Card - Ramp,6.86,57255214.91
11/07/2022,Expense,La Panchina,Mike ross,Credit Card - Ramp,31.02,57255245.93
11/07/2022,Expense,La Panchina,Mike ross,Credit Card - Ramp,31.02,57255276.95
11/07/2022,Expense,Reuben Hills,Mike ross,Credit Card - Ramp,6.86,57255283.81
11/07/2022,Expense,Adobe,Mike ross,Credit Card - Ramp,79.22,57255363.03
11/07/2022,Expense,Adobe,Mike ross,Credit Card - Ramp,79.22,57255442.25
11/07/2022,Expense,La Panchina,Mike ross,Meals & Entertainment,31.02,57255473.27
11/07/2022,Expense,Mailchimp,,Tools & Subscription - G&A,22,57255495.27
11/07/2022,Expense,Reuben Hills,Mike ross,Meals & Entertainment,6.86,57255502.13
11/07/2022,Expense,Reuben Hills,Mike ross,Credit Card - Ramp,6.86,57255508.99
11/07/2022,Expense,La Panchina,Mike ross,Meals & Entertainment,31.02,57255540.01
11/07/2022,Expense,Mailchimp,Mike ross,Credit Card - Ramp,22,57255562.01
11/07/2022,Credit Card Credit,Airbnb,,Travel:Hotels,-714.84,57254847.17
11/07/2022,Expense,Adobe,,Tools & Subscription - S&M,79.22,57254926.39
11/07/2022,Credit Card Credit,Airbnb,,Travel:Hotels,-714.84,57254211.55
11/07/2022,Credit Card Credit,Airbnb,Mike ross,Credit Card - Ramp,-714.84,57253496.71
11/07/2022,Credit Card Credit,Airbnb,Mike ross,Credit Card - Ramp,-714.84,57252781.87
11/07/2022,Expense,Reuben Hills,Mike ross,Meals & Entertainment,6.86,57252788.73
11/07/2022,Expense,La Panchina,Mike ross,Meals & Entertainment,31.02,57252819.75
11/07/2022,Expense,Adobe,Mike ross,Credit Card - Ramp,79.22,57252898.97
11/07/2022,Expense,Reuben Hills,Mike ross,Credit Card - Ramp,6.86,57252905.83
11/07/2022,Expense,Reuben Hills,Mike ross,Meals & Entertainment,6.86,57252912.69
11/07/2022,Expense,Mailchimp,Mike ross,Credit Card - Ramp,22,57252934.69
11/07/2022,Expense,Reuben Hills,Mike ross,Meals & Entertainment,6.86,57252941.55
11/07/2022,Expense,Adobe,,Tools & Subscription - S&M,79.22,57253020.77
11/07/2022,Expense,Mailchimp,,Tools & Subscription - G&A,22,57253042.77
11/07/2022,Expense,La Panchina,Mike ross,Meals & Entertainment,31.02,57253073.79
11/07/2022,Expense,Mailchimp,Mike ross,Credit Card - Ramp,22,57253095.79
11/07/2022,Expense,La Panchina,Mike ross,Credit Card - Ramp,31.02,57253126.81
11/07/2022,Credit Card Credit,Airbnb,Mike ross,Credit Card - Ramp,-714.84,57252411.97
11/07/2022,Expense,Mailchimp,,Tools & Subscription - G&A,22,57252433.97
11/07/2022,Expense,Adobe,,Tools & Subscription - S&M,79.22,57252513.19
11/07/2022,Credit Card Credit,Airbnb,,Travel:Hotels,-714.84,57251798.35
11/07/2022,Credit Card Credit,Airbnb,,Travel:Hotels,-714.84,57251083.51
11/07/2022,Expense,Adobe,,Tools & Subscription - S&M,79.22,57251162.73
11/07/2022,Expense,Mailchimp,,Tools & Subscription - G&A,22,57251184.73
11/08/2022,Expense,Vistara,Harvey Spector,Credit Card - Ramp,118.84,57251303.57
11/08/2022,Expense,Calendly,Harvey Spector,Credit Card - Ramp,80,57251383.57
11/08/2022,Credit Card Credit,Automate,Balapavan Tirumani,Credit Card - Ramp,-19.81,57251363.76
11/08/2022,Expense,Cuckoo Callay,Mike ross,Meals & Entertainment,39.22,57251402.98
11/08/2022,Expense,Cuckoo Callay,Mike ross,Credit Card - Ramp,39.22,57251442.2
11/08/2022,Expense,Cuckoo Callay,Mike ross,Meals & Entertainment,39.22,57251481.42
11/08/2022,Expense,Cuckoo Callay,Mike ross,Meals & Entertainment,39.22,57251520.64
11/08/2022,Expense,Vistara,,Travel:Airfare,118.84,57251639.48
11/08/2022,Expense,Calendly,,Tools & Subscription - G&A,80,57251719.48
11/08/2022,Credit Card Credit,Automate,Balapavan Tirumani,Credit Card - Ramp,-19.81,57251699.67
11/08/2022,Expense,Cuckoo Callay,Mike ross,Credit Card - Ramp,39.22,57251738.89
11/08/2022,Credit Card Credit,Automate,,Tools & Subscription - G&A,-19.81,57251719.08
11/08/2022,Expense,Cuckoo Callay,Mike ross,Credit Card - Ramp,39.22,57251758.3
11/08/2022,Expense,Calendly,Harvey Spector,Credit Card - Ramp,80,57251838.3
11/08/2022,Expense,Vistara,,Travel:Airfare,118.84,57251957.14
11/08/2022,Expense,Cuckoo Callay,Mike ross,Credit Card - Ramp,39.22,57251996.36
11/08/2022,Expense,Vistara,Harvey Spector,Credit Card - Ramp,118.84,57252115.2
11/08/2022,Expense,Vistara,Harvey Spector,Credit Card - Ramp,118.84,57252234.04
11/08/2022,Expense,Vistara,,Travel:Airfare,118.84,57252352.88
11/08/2022,Expense,Calendly,,Tools & Subscription - G&A,80,57252432.88
11/08/2022,Credit Card Credit,Automate,,Tools & Subscription - G&A,-19.81,57252413.07
11/08/2022,Credit Card Credit,Automate,,Tools & Subscription - G&A,-19.81,57252393.26
11/08/2022,Expense,Cuckoo Callay,Mike ross,Meals & Entertainment,39.22,57252432.48
11/08/2022,Expense,Calendly,,Tools & Subscription - G&A,80,57252512.48
11/08/2022,Expense,Vistara,,Travel:Airfare,118.84,57252631.32
11/08/2022,Credit Card Credit,Automate,Balapavan Tirumani,Credit Card - Ramp,-19.81,57252611.51
11/08/2022,Expense,Calendly,Harvey Spector,Credit Card - Ramp,80,57252691.51
11/08/2022,Credit Card Credit,Automate,,Tools & Subscription - G&A,-19.81,57252671.7
11/08/2022,Expense,Calendly,,Tools & Subscription - G&A,80,57252751.7
11/09/2022,Expense,Usersnap,Harris Jose,Credit Card - Ramp,19,57252770.7
11/09/2022,Expense,Heroku,Balapavan Tirumani,Tools & Subscription - S&M,87,57252857.7
11/09/2022,Expense,Uber Eats,Mike ross,Meals & Entertainment,21.06,57252878.76
11/09/2022,Expense,Datadog,Balapavan Tirumani,Credit Card - Ramp,3.38,57252882.14
11/09/2022,Expense,Reuben Hills,Mike ross,Credit Card - Ramp,5.98,57252888.12
11/09/2022,Expense,Lemon Squeezy,Harvey Spector,Credit Card - Ramp,139,57253027.12
11/09/2022,Expense,Reuben Hills,Mike ross,Credit Card - Ramp,5.98,57253033.1
11/09/2022,Expense,Heroku,Balapavan Tirumani,Credit Card - Ramp,87,57253120.1
11/09/2022,Expense,Reuben Hills,Mike ross,Credit Card - Ramp,5.98,57253126.08
11/09/2022,Expense,Uber Eats,Mike ross,Meals & Entertainment,21.06,57253147.14
11/09/2022,Expense,Uber Eats,Mike ross,Credit Card - Ramp,21.06,57253168.2
11/09/2022,Expense,Reuben Hills,Mike ross,Meals & Entertainment,5.98,57253174.18
11/09/2022,Expense,Datadog,,Tools & Subscription - G&A,3.38,57253177.56
11/09/2022,Expense,Usersnap,,Tools & Subscription - G&A,19,57253196.56
11/09/2022,Expense,Usersnap,,Tools & Subscription - G&A,19,57253215.56
11/09/2022,Expense,Uber Eats,Mike ross,Credit Card - Ramp,21.06,57253236.62
11/09/2022,Expense,Heroku,Balapavan Tirumani,Tools & Subscription - S&M,87,57253323.62
11/09/2022,Expense,Datadog,Balapavan Tirumani,Credit Card - Ramp,3.38,57253327
11/09/2022,Expense,Heroku,Balapavan Tirumani,Credit Card - Ramp,87,57253414
11/09/2022,Expense,Lemon Squeezy,,Tools & Subscription - G&A,139,57253553
11/09/2022,Expense,Usersnap,Harris Jose,Credit Card - Ramp,19,57253572
11/09/2022,Expense,Reuben Hills,Mike ross,Credit Card - Ramp,5.98,57253577.98
11/09/2022,Expense,Reuben Hills,Mike ross,Meals & Entertainment,5.98,57253583.96
11/09/2022,Expense,Datadog,,Tools & Subscription - G&A,3.38,57253587.34
11/09/2022,Expense,Datadog,,Tools & Subscription - G&A,3.38,57253590.72
11/09/2022,Expense,Usersnap,,Tools & Subscription - G&A,19,57253609.72
11/09/2022,Expense,Uber Eats,Mike ross,Meals & Entertainment,21.06,57253630.78
11/09/2022,Expense,Heroku,Balapavan Tirumani,Tools & Subscription - S&M,87,57253717.78
11/09/2022,Expense,Uber Eats,Mike ross,Credit Card - Ramp,21.06,57253738.84
11/09/2022,Expense,Uber Eats,Mike ross,Meals & Entertainment,21.06,57253759.9
11/09/2022,Expense,Usersnap,,Tools & Subscription - G&A,19,57253778.9
11/09/2022,Expense,Datadog,,Tools & Subscription - G&A,3.38,57253782.28
11/09/2022,Expense,Reuben Hills,Mike ross,Meals & Entertainment,5.98,57253788.26
11/09/2022,Expense,Usersnap,Harris Jose,Credit Card - Ramp,19,57253807.26
11/09/2022,Expense,Datadog,Balapavan Tirumani,Credit Card - Ramp,3.38,57253810.64
11/09/2022,Expense,Uber Eats,Mike ross,Credit Card - Ramp,21.06,57253831.7
11/09/2022,Expense,Heroku,Balapavan Tirumani,Tools & Subscription - S&M,87,57253918.7
11/09/2022,Expense,Lemon Squeezy,Harvey Spector,Credit Card - Ramp,139,57254057.7
11/09/2022,Expense,Lemon Squeezy,Harvey Spector,Credit Card - Ramp,139,57254196.7
11/09/2022,Expense,Reuben Hills,Mike ross,Meals & Entertainment,5.98,57254202.68
11/09/2022,Expense,Lemon Squeezy,,Tools & Subscription - G&A,139,57254341.68
11/09/2022,Expense,Lemon Squeezy,,Tools & Subscription - G&A,139,57254480.68
11/09/2022,Expense,Lemon Squeezy,,Tools & Subscription - G&A,139,57254619.68
11/09/2022,Expense,Heroku,Balapavan Tirumani,Credit Card - Ramp,87,57254706.68
11/10/2022,Expense,Pause Cafe,Harvey Spector,Meals & Entertainment,13,57254719.68
11/10/2022,Expense,Apple,Mike ross,laptop - Macbook,3529.42,57258249.1
11/10/2022,Expense,PocketSmith,,Tools & Subscription - G&A,9.95,57258259.05
11/10/2022,Expense,Uber Eats,Mike ross,Meals & Entertainment,18.3,57258277.35
11/10/2022,Expense,Apple,Mike ross,Credit Card - Ramp,3529.42,57261806.77
11/10/2022,Expense,PocketSmith,,Tools & Subscription - G&A,9.95,57261816.72
11/10/2022,Expense,Pause Cafe,Harvey Spector,Meals & Entertainment,13,57261829.72
11/10/2022,Expense,Sang by Mabasa,Mike ross,Meals & Entertainment,39.8,57261869.52
11/10/2022,Expense,Uber Eats,Mike ross,Meals & Entertainment,18.3,57261887.82
11/10/2022,Expense,Uber Eats,Mike ross,Credit Card - Ramp,18.3,57261906.12
11/10/2022,Expense,Uber Eats,Mike ross,Meals & Entertainment,18.3,57261924.42
11/10/2022,Expense,PocketSmith,Harvey Spector,Credit Card - Ramp,9.95,57261934.37
11/10/2022,Expense,Insider,Harvey Spector,Tools & Subscription - G&A,29,57261963.37
11/10/2022,Expense,PocketSmith,,Tools & Subscription - G&A,9.95,57261973.32
11/10/2022,Expense,Apple,Mike ross,Credit Card - Ramp,3529.42,57265502.74
11/10/2022,Expense,Insider,Harvey Spector,Tools & Subscription - G&A,29,57265531.74
11/10/2022,Expense,Sang by Mabasa,Mike ross,Meals & Entertainment,39.8,57265571.54
11/10/2022,Expense,Apple,Mike ross,laptop - Macbook,3529.42,57269100.96
11/10/2022,Expense,Pause Cafe,Harvey Spector,Meals & Entertainment,13,57269113.96
11/10/2022,Expense,Sang by Mabasa,Mike ross,Credit Card - Ramp,39.8,57269153.76
11/10/2022,Expense,Sang by Mabasa,Mike ross,Meals & Entertainment,39.8,57269193.56
11/10/2022,Expense,Apple,Mike ross,laptop - Macbook,3529.42,57272722.98
11/10/2022,Expense,Apple,Mike ross,Credit Card - Ramp,3529.42,57276252.4
11/10/2022,Expense,Sang by Mabasa,Mike ross,Meals & Entertainment,39.8,57276292.2
11/10/2022,Expense,Insider,Harvey Spector,Tools & Subscription - G&A,29,57276321.2
11/10/2022,Expense,Insider,Harvey Spector,Credit Card - Ramp,29,57276350.2
11/10/2022,Expense,Pause Cafe,Harvey Spector,Credit Card - Ramp,13,57276363.2
11/10/2022,Expense,Sang by Mabasa,Mike ross,Credit Card - Ramp,39.8,57276403
11/10/2022,Expense,Pause Cafe,Harvey Spector,Credit Card - Ramp,13,57276416
11/10/2022,Expense,Uber Eats,Mike ross,Credit Card - Ramp,18.3,57276434.3
11/10/2022,Expense,Insider,Harvey Spector,Tools & Subscription - G&A,29,57276463.3
11/10/2022,Expense,Uber Eats,Mike ross,Credit Card - Ramp,18.3,57276481.6
11/10/2022,Expense,Uber Eats,Mike ross,Credit Card - Ramp,18.3,57276499.9
11/10/2022,Expense,Pause Cafe,Harvey Spector,Meals & Entertainment,13,57276512.9
11/10/2022,Expense,Apple,Mike ross,laptop - Macbook,3529.42,57280042.32
11/10/2022,Expense,Pause Cafe,Harvey Spector,Credit Card - Ramp,13,57280055.32
11/10/2022,Expense,Uber Eats,Mike ross,Meals & Entertainment,18.3,57280073.62
11/10/2022,Expense,Sang by Mabasa,Mike ross,Credit Card - Ramp,39.8,57280113.42
11/10/2022,Expense,Sang by Mabasa,Mike ross,Credit Card - Ramp,39.8,57280153.22
11/10/2022,Expense,Apple,Mike ross,Credit Card - Ramp,3529.42,57283682.64
11/10/2022,Expense,Pause Cafe,Harvey Spector,Credit Card - Ramp,13,57283695.64
11/10/2022,Expense,PocketSmith,Harvey Spector,Credit Card - Ramp,9.95,57283705.59
11/10/2022,Expense,Insider,Harvey Spector,Credit Card - Ramp,29,57283734.59
11/10/2022,Expense,PocketSmith,Harvey Spector,Credit Card - Ramp,9.95,57283744.54
11/10/2022,Expense,Insider,Harvey Spector,Credit Card - Ramp,29,57283773.54
11/10/2022,Expense,PocketSmith,,Tools & Subscription - G&A,9.95,57283783.49
11/11/2022,Expense,Virgin,Chris George,Credit Card - Ramp,153.75,57283937.24
11/11/2022,Expense,Virgin,Chris George,Travelling Expenses,153.75,57284090.99
11/11/2022,Expense,Inventus Law,,Legal & accounting services:Legal Fees,315,57284405.99
11/11/2022,Expense,Inventus Law,Mike ross,Credit Card - Ramp,315,57284720.99
11/11/2022,Expense,Inventus Law,Mike ross,Credit Card - Ramp,315,57285035.99
11/11/2022,Expense,Inventus Law,,Legal & accounting services:Legal Fees,315,57285350.99
11/11/2022,Expense,Gum Co Cc Gzr Art,,General business expenses:Memberships & subscriptions,50,57285400.99
11/11/2022,Expense,Gum Co Cc Gzr Art,Harvey Spector,Credit Card - Ramp,50,57285450.99
11/11/2022,Expense,Virgin,Chris George,Credit Card - Ramp,153.75,57285604.74
11/11/2022,Expense,Inventus Law,Mike ross,Credit Card - Ramp,315,57285919.74
11/11/2022,Expense,Virgin,Chris George,Travelling Expenses,153.75,57286073.49
11/11/2022,Expense,Inventus Law,,Legal & accounting services:Legal Fees,315,57286388.49
11/11/2022,Expense,Virgin,Chris George,Credit Card - Ramp,153.75,57286542.24
11/11/2022,Expense,Gum Co Cc Gzr Art,,General business expenses:Memberships & subscriptions,50,57286592.24
11/11/2022,Expense,Virgin,Chris George,Travelling Expenses,153.75,57286745.99
11/11/2022,Expense,Gum Co Cc Gzr Art,Harvey Spector,Credit Card - Ramp,50,57286795.99
11/11/2022,Expense,Gum Co Cc Gzr Art,,General business expenses:Memberships & subscriptions,50,57286845.99
11/11/2022,Expense,Inventus Law,Mike ross,Credit Card - Ramp,315,57287160.99
11/11/2022,Expense,Virgin,Chris George,Travelling Expenses,153.75,57287314.74
11/11/2022,Expense,Gum Co Cc Gzr Art,Harvey Spector,Credit Card - Ramp,50,57287364.74
11/11/2022,Expense,Gum Co Cc Gzr Art,,General business expenses:Memberships & subscriptions,50,57287414.74
11/11/2022,Expense,Gum Co Cc Gzr Art,Harvey Spector,Credit Card - Ramp,50,57287464.74
11/11/2022,Expense,Inventus Law,,Legal & accounting services:Legal Fees,315,57287779.74
11/13/2022,Expense,Intercom,,Tools & Subscription - G&A,195,57287974.74
11/13/2022,Expense,Intercom,Balapavan Tirumani,Credit Card - Ramp,195,57288169.74
11/13/2022,Expense,Supertravel Temp Auth,,Travel:Hotels,687.2,57288856.94
11/13/2022,Expense,Figma,Mike ross,Credit Card - Ramp,405,57289261.94
11/13/2022,Expense,Vercel,,Tools & Subscription - G&A,140,57289401.94
11/13/2022,Expense,Figma,,Tools & Subscription - G&A,405,57289806.94
11/13/2022,Expense,Figma,,Tools & Subscription - G&A,405,57290211.94
11/13/2022,Expense,Supertravel Temp Auth,,Travel:Hotels,687.2,57290899.14
11/13/2022,Expense,Supertravel Temp Auth,,Travel:Hotels,687.2,57291586.34
11/13/2022,Expense,Framer,,Tools & Subscription - G&A,10.12,57291596.46
11/13/2022,Expense,Intercom,Balapavan Tirumani,Credit Card - Ramp,195,57291791.46
11/13/2022,Expense,Supertravel Temp Auth,Chris George,Credit Card - Ramp,687.2,57292478.66
11/13/2022,Expense,Framer,,Tools & Subscription - G&A,10.12,57292488.78
11/13/2022,Expense,Framer,,Tools & Subscription - G&A,10.12,57292498.9
11/13/2022,Expense,Intercom,,Tools & Subscription - G&A,195,57292693.9
11/13/2022,Expense,Vercel,Harris Jose,Credit Card - Ramp,140,57292833.9
11/13/2022,Expense,Framer,,Tools & Subscription - G&A,10.12,57292844.02
11/13/2022,Expense,Framer,Harvey Spector,Credit Card - Ramp,10.12,57292854.14
11/13/2022,Expense,Vercel,Harris Jose,Credit Card - Ramp,140,57292994.14
11/13/2022,Expense,Intercom,Balapavan Tirumani,Credit Card - Ramp,195,57293189.14
11/13/2022,Expense,Vercel,,Tools & Subscription - G&A,140,57293329.14
11/13/2022,Expense,Figma,,Tools & Subscription - G&A,405,57293734.14
11/13/2022,Expense,Intercom,,Tools & Subscription - G&A,195,57293929.14
11/13/2022,Expense,Intercom,,Tools & Subscription - G&A,195,57294124.14
11/13/2022,Expense,Vercel,,Tools & Subscription - G&A,140,57294264.14
11/13/2022,Expense,Figma,,Tools & Subscription - G&A,405,57294669.14
11/13/2022,Expense,Vercel,,Tools & Subscription - G&A,140,57294809.14
11/13/2022,Expense,Figma,Mike ross,Credit Card - Ramp,405,57295214.14
11/13/2022,Expense,Supertravel Temp Auth,Chris George,Credit Card - Ramp,687.2,57295901.34
11/13/2022,Expense,Framer,Harvey Spector,Credit Card - Ramp,10.12,57295911.46
11/13/2022,Expense,Figma,Mike ross,Credit Card - Ramp,405,57296316.46
11/13/2022,Expense,Supertravel Temp Auth,Chris George,Credit Card - Ramp,687.2,57297003.66
11/13/2022,Expense,Vercel,Harris Jose,Credit Card - Ramp,140,57297143.66
11/13/2022,Expense,Supertravel Temp Auth,,Travel:Hotels,687.2,57297830.86
11/13/2022,Expense,Framer,Harvey Spector,Credit Card - Ramp,10.12,57297840.98
11/14/2022,Expense,Intuit,Harvey Spector,Credit Card - Ramp,55,57297895.98
11/14/2022,Expense,Sustain Digital,"CompanyB, Recruitment fee paid to Sustain Digital for hiring one of our designers (Andrew Mackay)",Professional Service Charges,-20580.64,57277315.34
11/14/2022,Expense,Sustain Digital,"CompanyB, Recruitment fee paid to Sustain Digital for hiring one of our designers (Andrew Mackay)",Professional Service Charges,-20580.64,57256734.7
11/14/2022,Expense,Sustain Digital,"CompanyB, Recruitment fee paid to Sustain Digital for hiring one of our designers (Andrew Mackay)",Account1,20580.64,57277315.34
11/14/2022,Expense,Cuckoo Callay,Mike ross,Meals & Entertainment,12.28,57277327.62
11/14/2022,Expense,Cuckoo Callay,Mike ross,Credit Card - Ramp,12.28,57277339.9
11/14/2022,Expense,Sustain Digital,"CompanyB, Recruitment fee paid to Sustain Digital for hiring one of our designers (Andrew Mackay)",Account1,20580.64,57297920.54
11/14/2022,Expense,Cuckoo Callay,Mike ross,Credit Card - Ramp,12.28,57297932.82
11/14/2022,Expense,Intuit,Harvey Spector,Credit Card - Ramp,55,57297987.82
11/14/2022,Expense,Sustain Digital,"CompanyB, Recruitment fee paid to Sustain Digital for hiring one of our designers (Andrew Mackay)",Account1,20580.64,57318568.46
11/14/2022,Expense,Cuckoo Callay,Mike ross,Credit Card - Ramp,12.28,57318580.74
11/14/2022,Expense,Intuit,,Tools & Subscription - G&A,55,57318635.74
11/14/2022,Expense,Sustain Digital,"CompanyB, Recruitment fee paid to Sustain Digital for hiring one of our designers (Andrew Mackay)",Professional Service Charges,-20580.64,57298055.1
11/14/2022,Expense,Cuckoo Callay,Mike ross,Meals & Entertainment,12.28,57298067.38
11/14/2022,Expense,Cuckoo Callay,Mike ross,Credit Card - Ramp,12.28,57298079.66
11/14/2022,Expense,Intuit,,Tools & Subscription - G&A,55,57298134.66
11/14/2022,Expense,Intuit,,Tools & Subscription - G&A,55,57298189.66
11/14/2022,Expense,Sustain Digital,"CompanyB, Recruitment fee paid to Sustain Digital for hiring one of our designers (Andrew Mackay)",Account1,20580.64,57318770.3
11/14/2022,Expense,Intuit,,Tools & Subscription - G&A,55,57318825.3
11/14/2022,Expense,Cuckoo Callay,Mike ross,Meals & Entertainment,12.28,57318837.58
11/14/2022,Expense,Intuit,Harvey Spector,Credit Card - Ramp,55,57318892.58
11/14/2022,Expense,Sustain Digital,"CompanyB, Recruitment fee paid to Sustain Digital for hiring one of our designers (Andrew Mackay)",Professional Service Charges,-20580.64,57298311.94
11/14/2022,Expense,Cuckoo Callay,Mike ross,Meals & Entertainment,12.28,57298324.22
11/15/2022,Expense,Ghost,,Tools & Subscription - G&A,300,57298624.22
11/15/2022,Expense,Ghost,Harvey Spector,Credit Card - Ramp,300,57298924.22
11/15/2022,Expense,Soul Dining Restaurant,Mike ross,Meals & Entertainment,65.6,57298989.82
11/15/2022,Expense,Ghost,,Tools & Subscription - G&A,300,57299289.82
11/15/2022,Expense,Lucky Pickle Dumpling Co,Mike ross,Meals & Entertainment,40.2,57299330.02
11/15/2022,Expense,Lucky Pickle Dumpling Co,Mike ross,Meals & Entertainment,40.2,57299370.22
11/15/2022,Expense,Soul Dining Restaurant,Mike ross,Meals & Entertainment,65.6,57299435.82
11/15/2022,Expense,Soul Dining Restaurant,Mike ross,Meals & Entertainment,65.6,57299501.42
11/15/2022,Expense,Ghost,,Tools & Subscription - G&A,300,57299801.42
11/15/2022,Expense,Lucky Pickle Dumpling Co,Mike ross,Meals & Entertainment,40.2,57299841.62
11/15/2022,Expense,Ghost,Harvey Spector,Credit Card - Ramp,300,57300141.62
11/15/2022,Expense,Lucky Pickle Dumpling Co,Mike ross,Credit Card - Ramp,40.2,57300181.82
11/15/2022,Expense,Soul Dining Restaurant,Mike ross,Credit Card - Ramp,65.6,57300247.42
11/15/2022,Expense,Lucky Pickle Dumpling Co,Mike ross,Credit Card - Ramp,40.2,57300287.62
11/15/2022,Expense,Soul Dining Restaurant,Mike ross,Credit Card - Ramp,65.6,57300353.22
11/15/2022,Expense,Lucky Pickle Dumpling Co,Mike ross,Credit Card - Ramp,40.2,57300393.42
11/15/2022,Expense,Lucky Pickle Dumpling Co,Mike ross,Meals & Entertainment,40.2,57300433.62
11/15/2022,Expense,Ghost,,Tools & Subscription - G&A,300,57300733.62
11/15/2022,Expense,Soul Dining Restaurant,Mike ross,Credit Card - Ramp,65.6,57300799.22
11/15/2022,Expense,Ghost,Harvey Spector,Credit Card - Ramp,300,57301099.22
11/15/2022,Expense,Soul Dining Restaurant,Mike ross,Meals & Entertainment,65.6,57301164.82
11/15/2022,Expense,Soul Dining Restaurant,Mike ross,Credit Card - Ramp,65.6,57301230.42
11/15/2022,Expense,Lucky Pickle Dumpling Co,Mike ross,Credit Card - Ramp,40.2,57301270.62
11/16/2022,Expense,Berkelouw Paddington,,General business expenses:Memberships & subscriptions,117.95,57301388.57
11/16/2022,Expense,Linear,,Tools & Subscription - G&A,160,57301548.57
11/16/2022,Expense,Zapier,,Tools & Subscription - G&A,29.99,57301578.56
11/16/2022,Expense,Gradient,,Tools & Subscription - G&A,100,57301678.56
11/16/2022,Transfer,,PaymentServiceB Checking **7257,Savings (6977),50000,57351678.56
11/16/2022,Transfer,,PaymentServiceB Checking **7257,Account1,-50000,57301678.56
11/16/2022,Expense,Zapier,,Tools & Subscription - G&A,29.99,57301708.55
11/16/2022,Expense,bills,Mike ross,Credit Card - Ramp,139.06,57301847.61
11/16/2022,Expense,bills,Mike ross,Meals & Entertainment,139.06,57301986.67
11/16/2022,Transfer,,PaymentServiceB Checking **7257,Savings (6977),50000,57351986.67
11/16/2022,Expense,bills,Mike ross,Credit Card - Ramp,139.06,57352125.73
11/16/2022,Transfer,,PaymentServiceB Checking **7257,Account1,-50000,57302125.73
11/16/2022,Expense,Berkelouw Paddington,,General business expenses:Memberships & subscriptions,117.95,57302243.68
11/16/2022,Expense,Berkelouw Paddington,Mike ross,Credit Card - Ramp,117.95,57302361.63
11/16/2022,Transfer,,PaymentServiceB Checking **7257,Savings (6977),50000,57352361.63
11/16/2022,Expense,Zapier,Harvey Spector,Credit Card - Ramp,29.99,57352391.62
11/16/2022,Expense,Zapier,,Tools & Subscription - G&A,29.99,57352421.61
11/16/2022,Expense,Linear,,Tools & Subscription - G&A,160,57352581.61
11/16/2022,Expense,bills,Mike ross,Meals & Entertainment,139.06,57352720.67
11/16/2022,Expense,Berkelouw Paddington,Mike ross,Credit Card - Ramp,117.95,57352838.62
11/16/2022,Expense,Gradient,Harvey Spector,Credit Card - Ramp,100,57352938.62
11/16/2022,Expense,Linear,Chad Blumenthal,Credit Card - Ramp,160,57353098.62
11/16/2022,Transfer,,PaymentServiceB Checking **7257,Account1,-50000,57303098.62
11/16/2022,Expense,Zapier,,Tools & Subscription - G&A,29.99,57303128.61
11/16/2022,Expense,Berkelouw Paddington,Mike ross,Credit Card - Ramp,117.95,57303246.56
11/16/2022,Expense,Linear,Chad Blumenthal,Credit Card - Ramp,160,57303406.56
11/16/2022,Expense,Zapier,Harvey Spector,Credit Card - Ramp,29.99,57303436.55
11/16/2022,Expense,Gradient,Harvey Spector,Credit Card - Ramp,100,57303536.55
11/16/2022,Expense,Berkelouw Paddington,Mike ross,Credit Card - Ramp,117.95,57303654.5
11/16/2022,Expense,bills,Mike ross,Credit Card - Ramp,139.06,57303793.56
11/16/2022,Expense,Berkelouw Paddington,,General business expenses:Memberships & subscriptions,117.95,57303911.51
11/16/2022,Expense,Linear,,Tools & Subscription - G&A,160,57304071.51
11/16/2022,Expense,bills,Mike ross,Meals & Entertainment,139.06,57304210.57
11/16/2022,Expense,Zapier,Harvey Spector,Credit Card - Ramp,29.99,57304240.56
11/16/2022,Expense,Linear,Chad Blumenthal,Credit Card - Ramp,160,57304400.56
11/16/2022,Expense,Gradient,,Tools & Subscription - G&A,100,57304500.56
11/16/2022,Transfer,,PaymentServiceB Checking **7257,Savings (6977),50000,57354500.56
11/16/2022,Transfer,,PaymentServiceB Checking **7257,Account1,-50000,57304500.56
11/16/2022,Expense,Gradient,,Tools & Subscription - G&A,100,57304600.56
11/16/2022,Expense,bills,Mike ross,Credit Card - Ramp,139.06,57304739.62
11/16/2022,Expense,Berkelouw Paddington,,General business expenses:Memberships & subscriptions,117.95,57304857.57
11/16/2022,Expense,Gradient,,Tools & Subscription - G&A,100,57304957.57
11/16/2022,Expense,Linear,,Tools & Subscription - G&A,160,57305117.57
11/16/2022,Expense,bills,Mike ross,Meals & Entertainment,139.06,57305256.63
11/16/2022,Expense,Gradient,Harvey Spector,Credit Card - Ramp,100,57305356.63
11/17/2022,Expense,Shwarmama,Mike ross,Credit Card - Ramp,49.6,57305406.23
11/17/2022,Expense,Shwarmama,Mike ross,Meals & Entertainment,49.6,57305455.83
11/17/2022,Expense,Shwarmama,Mike ross,Credit Card - Ramp,49.6,57305505.43
11/17/2022,Expense,Shwarmama,Mike ross,Meals & Entertainment,49.6,57305555.03
11/17/2022,Expense,Shwarmama,Mike ross,Meals & Entertainment,49.6,57305604.63
11/17/2022,Expense,Shwarmama,Mike ross,Credit Card - Ramp,49.6,57305654.23
11/17/2022,Expense,Shwarmama,Mike ross,Credit Card - Ramp,49.6,57305703.83
11/17/2022,Expense,Shwarmama,Mike ross,Meals & Entertainment,49.6,57305753.43
11/18/2022,Expense,Cuckoo Callay,Mike ross,Credit Card - Ramp,68.55,57305821.98
11/18/2022,Expense,Superhuman,,Professional Service Charges,30,57305851.98
11/18/2022,Expense,Superhuman,Harvey Spector,Credit Card - Ramp,30,57305881.98
11/18/2022,Expense,Cuckoo Callay,Mike ross,Meals & Entertainment,68.55,57305950.53
11/18/2022,Expense,Cuckoo Callay,Mike ross,Credit Card - Ramp,68.55,57306019.08
11/18/2022,Expense,Cuckoo Callay,Mike ross,Meals & Entertainment,68.55,57306087.63
11/18/2022,Expense,LinkedIn,Mike ross,Credit Card - Ramp,151.49,57306239.12
11/18/2022,Expense,Superhuman,Harvey Spector,Credit Card - Ramp,30,57306269.12
11/18/2022,Expense,LinkedIn,Mike ross,Credit Card - Ramp,151.49,57306420.61
11/18/2022,Expense,GitKraken,Harris Jose,Credit Card - Ramp,59.4,57306480.01
11/18/2022,Expense,Superhuman,Harvey Spector,Credit Card - Ramp,30,57306510.01
11/18/2022,Expense,Cuckoo Callay,Mike ross,Credit Card - Ramp,68.55,57306578.56
11/18/2022,Expense,Superhuman,Harvey Spector,Credit Card - Ramp,30,57306608.56
11/18/2022,Expense,Cuckoo Callay,Mike ross,Meals & Entertainment,68.55,57306677.11
11/18/2022,Expense,LinkedIn,Mike ross,Credit Card - Ramp,151.49,57306828.6
11/18/2022,Expense,Cuckoo Callay,Mike ross,Meals & Entertainment,68.55,57306897.15
11/18/2022,Expense,LinkedIn,,Tools & Subscription - G&A,151.49,57307048.64
11/18/2022,Expense,LinkedIn,,Tools & Subscription - G&A,151.49,57307200.13
11/18/2022,Expense,GitKraken,Harris Jose,Credit Card - Ramp,59.4,57307259.53
11/18/2022,Expense,GitKraken,Harris Jose,Credit Card - Ramp,59.4,57307318.93
11/18/2022,Expense,GitKraken,,Tools & Subscription - G&A,59.4,57307378.33
11/18/2022,Expense,LinkedIn,,Tools & Subscription - G&A,151.49,57307529.82
11/18/2022,Expense,Cuckoo Callay,Mike ross,Credit Card - Ramp,68.55,57307598.37
11/18/2022,Expense,Superhuman,,Professional Service Charges,30,57307628.37
11/18/2022,Expense,Superhuman,,Professional Service Charges,30,57307658.37
11/18/2022,Expense,GitKraken,,Tools & Subscription - G&A,59.4,57307717.77
11/18/2022,Expense,Superhuman,,Professional Service Charges,30,57307747.77
11/18/2022,Expense,LinkedIn,,Tools & Subscription - G&A,151.49,57307899.26
11/18/2022,Expense,GitKraken,,Tools & Subscription - G&A,59.4,57307958.66
11/18/2022,Expense,GitKraken,,Tools & Subscription - G&A,59.4,57308018.06
11/19/2022,Expense,LinkedIn,Harvey Spector,Credit Card - Ramp,25.98,57308044.04
11/19/2022,Expense,LinkedIn,Harvey Spector,Credit Card - Ramp,25.98,57308070.02
11/19/2022,Expense,Uber Eats,Mike ross,Meals & Entertainment,16.36,57308086.38
11/19/2022,Expense,Bird,Harvey Spector,Credit Card - Ramp,5.19,57308091.57
11/19/2022,Expense,Bird,,Travelling Expenses,5.19,57308096.76
11/19/2022,Expense,Uber Eats,Mike ross,Credit Card - Ramp,16.36,57308113.12
11/19/2022,Expense,Uber Eats,Mike ross,Credit Card - Ramp,16.36,57308129.48
11/19/2022,Expense,Bird,Harvey Spector,Credit Card - Ramp,5.19,57308134.67
11/19/2022,Expense,LinkedIn,,Tools & Subscription - G&A,25.98,57308160.65
11/19/2022,Expense,LinkedIn,,Tools & Subscription - G&A,25.98,57308186.63
11/19/2022,Expense,Bird,Harvey Spector,Credit Card - Ramp,5.19,57308191.82
11/19/2022,Expense,Bird,,Travelling Expenses,5.19,57308197.01
11/19/2022,Expense,Uber Eats,Mike ross,Meals & Entertainment,16.36,57308213.37
11/19/2022,Expense,Uber Eats,Mike ross,Meals & Entertainment,16.36,57308229.73
11/19/2022,Expense,Bird,,Travelling Expenses,5.19,57308234.92
11/19/2022,Expense,LinkedIn,,Tools & Subscription - G&A,25.98,57308260.9
11/19/2022,Expense,LinkedIn,,Tools & Subscription - G&A,25.98,57308286.88
11/19/2022,Expense,Bird,,Travelling Expenses,5.19,57308292.07
11/19/2022,Expense,Uber Eats,Mike ross,Meals & Entertainment,16.36,57308308.43
11/19/2022,Expense,Uber Eats,Mike ross,Credit Card - Ramp,16.36,57308324.79
11/19/2022,Expense,LinkedIn,Harvey Spector,Credit Card - Ramp,25.98,57308350.77
11/19/2022,Expense,Uber Eats,Mike ross,Credit Card - Ramp,16.36,57308367.13
11/20/2022,Expense,LinkedIn,,Tools & Subscription - G&A,121.6,57308488.73
11/20/2022,Expense,,*ZULILY*2058047040,Account1,14.46,57308503.19
11/20/2022,Deposit,,*ZULILY*2058047040,Office expenses,14.46,57308517.65
11/20/2022,Expense,,*ZULILY*3058049885,Account1,15.54,57308533.19
11/20/2022,Expense,LinkedIn,Niteesha Ravela,Credit Card - Ramp,121.6,57308654.79
11/20/2022,Expense,,*ZULILY*3058049885,Office expenses,-15.54,57308639.25
11/20/2022,Deposit,,*ZULILY*3058049885,Office expenses,15.54,57308654.79
11/20/2022,Expense,,*ZULILY*3058049885,Account1,15.54,57308670.33
11/20/2022,Expense,,*ZULILY*3058049885,Account1,15.54,57308685.87
11/20/2022,Deposit,,*ZULILY*3058049885,Account1,-15.54,57308670.33
11/20/2022,Deposit,,*ZULILY*2058047040,Account1,-14.46,57308655.87
11/20/2022,Deposit,,*ZULILY*3058049885,Account1,-15.54,57308640.33
11/20/2022,Deposit,,*ZULILY*3058049885,Account1,-15.54,57308624.79
11/20/2022,Deposit,,*ZULILY*2058047040,Account1,-14.46,57308610.33
11/20/2022,Expense,,*ZULILY*2058047040,Account1,14.46,57308624.79
11/20/2022,Deposit,,*ZULILY*3058049885,Account1,-15.54,57308609.25
11/20/2022,Expense,,*ZULILY*2058047040,Account1,14.46,57308623.71
11/20/2022,Expense,,*ZULILY*2058047040,Account1,14.46,57308638.17
11/20/2022,Deposit,,*ZULILY*2058047040,Account1,-14.46,57308623.71
11/20/2022,Expense,,*ZULILY*2058047040,Office expenses,-14.46,57308609.25
11/20/2022,Expense,,*ZULILY*3058049885,Office expenses,-15.54,57308593.71
11/20/2022,Deposit,,*ZULILY*2058047040,Account1,-14.46,57308579.25
11/20/2022,Expense,LinkedIn,,Tools & Subscription - G&A,121.6,57308700.85
11/20/2022,Expense,LinkedIn,Niteesha Ravela,Credit Card - Ramp,121.6,57308822.45
11/20/2022,Deposit,,*ZULILY*3058049885,Office expenses,15.54,57308837.99
11/20/2022,Expense,,*ZULILY*2058047040,Office expenses,-14.46,57308823.53
11/20/2022,Expense,,*ZULILY*3058049885,Account1,15.54,57308839.07
11/20/2022,Expense,,*ZULILY*2058047040,Office expenses,-14.46,57308824.61
11/20/2022,Deposit,,*ZULILY*3058049885,Office expenses,15.54,57308840.15
11/20/2022,Expense,LinkedIn,,Tools & Subscription - G&A,121.6,57308961.75
11/20/2022,Deposit,,*ZULILY*2058047040,Office expenses,14.46,57308976.21
11/20/2022,Expense,,*ZULILY*3058049885,Office expenses,-15.54,57308960.67
11/20/2022,Expense,,*ZULILY*2058047040,Office expenses,-14.46,57308946.21
11/20/2022,Deposit,,*ZULILY*2058047040,Office expenses,14.46,57308960.67
11/20/2022,Expense,LinkedIn,,Tools & Subscription - G&A,121.6,57309082.27
11/20/2022,Deposit,,*ZULILY*3058049885,Office expenses,15.54,57309097.81
11/20/2022,Expense,,*ZULILY*3058049885,Office expenses,-15.54,57309082.27
11/20/2022,Deposit,,*ZULILY*2058047040,Office expenses,14.46,57309096.73
11/20/2022,Expense,LinkedIn,Niteesha Ravela,Credit Card - Ramp,121.6,57309218.33
11/21/2022,Expense,Dabang,Mike ross,Meals & Entertainment,13.47,57309231.8
11/21/2022,Expense,Fable,Harvey Spector,Meals & Entertainment,21.96,57309253.76
11/21/2022,Expense,Fable,Harvey Spector,Meals & Entertainment,21.96,57309275.72
11/21/2022,Expense,Fable,Harvey Spector,Credit Card - Ramp,21.96,57309297.68
11/21/2022,Expense,Dabang,Mike ross,Credit Card - Ramp,13.47,57309311.15
11/21/2022,Expense,Dabang,Mike ross,Meals & Entertainment,13.47,57309324.62
11/21/2022,Expense,Fable,Harvey Spector,Meals & Entertainment,21.96,57309346.58
11/21/2022,Expense,Dabang,Mike ross,Meals & Entertainment,13.47,57309360.05
11/21/2022,Expense,Dabang,Mike ross,Credit Card - Ramp,13.47,57309373.52
11/21/2022,Expense,Fable,Harvey Spector,Meals & Entertainment,21.96,57309395.48
11/21/2022,Expense,Dabang,Mike ross,Credit Card - Ramp,13.47,57309408.95
11/21/2022,Expense,Fable,Harvey Spector,Credit Card - Ramp,21.96,57309430.91
11/21/2022,Expense,Dabang,Mike ross,Meals & Entertainment,13.47,57309444.38
11/21/2022,Expense,Fable,Harvey Spector,Credit Card - Ramp,21.96,57309466.34
11/21/2022,Expense,Dabang,Mike ross,Credit Card - Ramp,13.47,57309479.81
11/21/2022,Expense,Fable,Harvey Spector,Credit Card - Ramp,21.96,57309501.77
11/22/2022,Expense,Turkish,Harvey Spector,Meals & Entertainment,543.21,57310044.98
11/22/2022,Expense,Vimcal,Harvey Spector,Credit Card - Ramp,15,57310059.98
11/22/2022,Credit Card Payment,,RAMP,Account1,-12898.76,57297161.22
11/22/2022,Expense,Turkish,Harvey Spector,Credit Card - Ramp,543.21,57297704.43
11/22/2022,Expense,Dovetail,Harvey Spector,Credit Card - Ramp,70,57297774.43
11/22/2022,Credit Card Payment,,RAMP,Credit Card - Ramp,-12898.76,57284875.67
11/22/2022,Expense,Turkish,Harvey Spector,Meals & Entertainment,543.21,57285418.88
11/22/2022,Expense,Dovetail,,Tools & Subscription - G&A,70,57285488.88
11/22/2022,Credit Card Payment,,RAMP,Account1,-12898.76,57272590.12
11/22/2022,Credit Card Payment,,RAMP,Credit Card - Ramp,-12898.76,57259691.36
11/22/2022,Expense,Turkish,Harvey Spector,Credit Card - Ramp,543.21,57260234.57
11/22/2022,Credit Card Payment,,RAMP,Credit Card - Ramp,-12898.76,57247335.81
11/22/2022,Expense,Vimcal,,Tools & Subscription - G&A,15,57247350.81
11/22/2022,Credit Card Payment,,RAMP,Account1,-12898.76,57234452.05
11/22/2022,Expense,Vimcal,Harvey Spector,Credit Card - Ramp,15,57234467.05
11/22/2022,Expense,Dovetail,Harvey Spector,Credit Card - Ramp,70,57234537.05
11/22/2022,Expense,Turkish,Harvey Spector,Meals & Entertainment,543.21,57235080.26
11/22/2022,Expense,Dovetail,,Tools & Subscription - G&A,70,57235150.26
11/22/2022,Expense,Vimcal,,Tools & Subscription - G&A,15,57235165.26
11/22/2022,Expense,Dovetail,,Tools & Subscription - G&A,70,57235235.26
11/22/2022,Expense,Turkish,Harvey Spector,Meals & Entertainment,543.21,57235778.47
11/22/2022,Expense,Dovetail,Harvey Spector,Credit Card - Ramp,70,57235848.47
11/22/2022,Credit Card Payment,,RAMP,Account1,-12898.76,57222949.71
11/22/2022,Credit Card Payment,,RAMP,Credit Card - Ramp,-12898.76,57210050.95
11/22/2022,Expense,Vimcal,,Tools & Subscription - G&A,15,57210065.95
11/22/2022,Expense,Vimcal,,Tools & Subscription - G&A,15,57210080.95
11/22/2022,Expense,Dovetail,,Tools & Subscription - G&A,70,57210150.95
11/22/2022,Expense,Turkish,Harvey Spector,Credit Card - Ramp,543.21,57210694.16
11/22/2022,Expense,Vimcal,Harvey Spector,Credit Card - Ramp,15,57210709.16
11/22/2022,Expense,Turkish,Harvey Spector,Credit Card - Ramp,543.21,57211252.37
11/23/2022,Expense,Superhuman,Mike ross,Credit Card - Ramp,30,57211282.37
11/23/2022,Expense,Super,Harvey Spector,Credit Card - Ramp,12,57211294.37
11/23/2022,Expense,Zoom,Amani Shariff,Credit Card - Ramp,14.15,57211308.52
11/23/2022,Expense,Superhuman,Mike ross,Credit Card - Ramp,30,57211338.52
11/23/2022,Expense,Super,Harvey Spector,Credit Card - Ramp,12,57211350.52
11/23/2022,Expense,Zoom,Amani Shariff,Credit Card - Ramp,14.15,57211364.67
11/23/2022,Expense,Zoom,,Tools & Subscription - G&A,14.15,57211378.82
11/23/2022,Expense,Super,Harvey Spector,Credit Card - Ramp,12,57211390.82
11/23/2022,Expense,Zoom,Amani Shariff,Credit Card - Ramp,14.15,57211404.97
11/23/2022,Expense,Superhuman,Mike ross,Credit Card - Ramp,30,57211434.97
11/23/2022,Credit Card Credit,Turkish,Harvey Spector,Credit Card - Ramp,-764.91,57210670.06
11/23/2022,Expense,Superhuman,Mike ross,Credit Card - Ramp,30,57210700.06
11/23/2022,Credit Card Credit,Turkish,Harvey Spector,Meals & Entertainment,-764.91,57209935.15
11/23/2022,Expense,Superhuman,,Professional Service Charges,30,57209965.15
11/23/2022,Credit Card Credit,Turkish,Harvey Spector,Meals & Entertainment,-764.91,57209200.24
11/23/2022,Expense,Superhuman,,Professional Service Charges,30,57209230.24
11/23/2022,Credit Card Credit,Turkish,Harvey Spector,Meals & Entertainment,-764.91,57208465.33
11/23/2022,Expense,Super,,Tools & Subscription - G&A,12,57208477.33
11/23/2022,Credit Card Credit,Turkish,Harvey Spector,Credit Card - Ramp,-764.91,57207712.42
11/23/2022,Expense,Super,,Tools & Subscription - G&A,12,57207724.42
11/23/2022,Expense,Zoom,,Tools & Subscription - G&A,14.15,57207738.57
11/23/2022,Credit Card Credit,Turkish,Harvey Spector,Credit Card - Ramp,-764.91,57206973.66
11/23/2022,Expense,Zoom,,Tools & Subscription - G&A,14.15,57206987.81
11/23/2022,Expense,Superhuman,,Professional Service Charges,30,57207017.81
11/23/2022,Expense,Superhuman,,Professional Service Charges,30,57207047.81
11/23/2022,Expense,Super,,Tools & Subscription - G&A,12,57207059.81
11/23/2022,Credit Card Credit,Turkish,Harvey Spector,Meals & Entertainment,-764.91,57206294.9
11/23/2022,Expense,Super,,Tools & Subscription - G&A,12,57206306.9
11/23/2022,Expense,Zoom,,Tools & Subscription - G&A,14.15,57206321.05
11/23/2022,Credit Card Credit,Turkish,Harvey Spector,Credit Card - Ramp,-764.91,57205556.14
11/24/2022,Expense,DoorDash,Mike ross,Credit Card - Ramp,26.29,57205582.43
11/24/2022,Expense,Uber Eats,Mike ross,Credit Card - Ramp,16.14,57205598.57
11/24/2022,Expense,DoorDash,Mike ross,Credit Card - Ramp,26.29,57205624.86
11/24/2022,Expense,Uber Eats,Mike ross,Credit Card - Ramp,16.14,57205641
11/24/2022,Expense,Uber Eats,Mike ross,Meals & Entertainment,16.14,57205657.14
11/24/2022,Expense,Benedict Evans,Harvey Spector,Professional Service Charges,10,57205667.14
11/24/2022,Expense,Uber Eats,Mike ross,Meals & Entertainment,16.14,57205683.28
11/24/2022,Expense,DoorDash,Mike ross,Meals & Entertainment,26.29,57205709.57
11/24/2022,Expense,DoorDash,Mike ross,Meals & Entertainment,26.29,57205735.86
11/24/2022,Expense,Benedict Evans,Harvey Spector,Credit Card - Ramp,10,57205745.86
11/24/2022,Expense,Benedict Evans,Harvey Spector,Professional Service Charges,10,57205755.86
11/24/2022,Expense,Benedict Evans,Harvey Spector,Professional Service Charges,10,57205765.86
11/24/2022,Expense,Uber Eats,Mike ross,Credit Card - Ramp,16.14,57205782
11/24/2022,Expense,DoorDash,Mike ross,Credit Card - Ramp,26.29,57205808.29
11/24/2022,Expense,Uber Eats,Mike ross,Meals & Entertainment,16.14,57205824.43
11/24/2022,Expense,Benedict Evans,Harvey Spector,Credit Card - Ramp,10,57205834.43
11/24/2022,Expense,DoorDash,Mike ross,Meals & Entertainment,26.29,57205860.72
11/24/2022,Expense,Benedict Evans,Harvey Spector,Credit Card - Ramp,10,57205870.72
11/24/2022,Expense,DoorDash,Mike ross,Meals & Entertainment,26.29,57205897.01
11/24/2022,Expense,Benedict Evans,Harvey Spector,Professional Service Charges,10,57205907.01
11/24/2022,Expense,Uber Eats,Mike ross,Meals & Entertainment,16.14,57205923.15
11/24/2022,Expense,Uber Eats,Mike ross,Credit Card - Ramp,16.14,57205939.29
11/24/2022,Expense,Benedict Evans,Harvey Spector,Credit Card - Ramp,10,57205949.29
11/24/2022,Expense,DoorDash,Mike ross,Credit Card - Ramp,26.29,57205975.58
11/25/2022,Expense,Creative Market,Mike ross,Credit Card - Ramp,30.98,57206006.56
11/25/2022,Expense,Creative Market,Mike ross,Advertising & marketing,30.98,57206037.54
11/25/2022,Expense,Miro,Mike ross,Credit Card - Ramp,90,57206127.54
11/25/2022,Expense,Creative Market,Mike ross,Advertising & marketing,13.6,57206141.14
11/25/2022,Expense,103 100,,Travelling Expenses,11.39,57206152.53
11/25/2022,Expense,Lucky Pickle Dumpling Co,Mike ross,Meals & Entertainment,13.05,57206165.58
11/25/2022,Expense,Zoom,,Tools & Subscription - G&A,14.99,57206180.57
11/25/2022,Expense,Creative Market,Mike ross,Credit Card - Ramp,13.6,57206194.17
11/25/2022,Expense,103 100,,Travelling Expenses,11.39,57206205.56
11/25/2022,Expense,Creative Market,Mike ross,Advertising & marketing,30.98,57206236.54
11/25/2022,Expense,Miro,,Tools & Subscription - G&A,90,57206326.54
11/25/2022,Expense,Lucky Pickle Dumpling Co,Mike ross,Credit Card - Ramp,13.05,57206339.59
11/25/2022,Expense,Lucky Pickle Dumpling Co,Mike ross,Credit Card - Ramp,13.05,57206352.64
11/25/2022,Expense,Miro,,Tools & Subscription - G&A,90,57206442.64
11/25/2022,Expense,Lucky Pickle Dumpling Co,Mike ross,Credit Card - Ramp,13.05,57206455.69
11/25/2022,Expense,Creative Market,Mike ross,Advertising & marketing,30.98,57206486.67
11/25/2022,Expense,Zoom,,Tools & Subscription - G&A,14.99,57206501.66
11/25/2022,Expense,Creative Market,Mike ross,Credit Card - Ramp,30.98,57206532.64
11/25/2022,Expense,Lucky Pickle Dumpling Co,Mike ross,Credit Card - Ramp,13.05,57206545.69
11/25/2022,Expense,Creative Market,Mike ross,Advertising & marketing,13.6,57206559.29
11/25/2022,Expense,Zoom,Chad Blumenthal,Credit Card - Ramp,14.99,57206574.28
11/25/2022,Expense,Zoom,,Tools & Subscription - G&A,14.99,57206589.27
11/25/2022,Expense,103 100,Mike ross,Credit Card - Ramp,11.39,57206600.66
11/25/2022,Expense,Lucky Pickle Dumpling Co,Mike ross,Meals & Entertainment,13.05,57206613.71
11/25/2022,Expense,Lucky Pickle Dumpling Co,Mike ross,Meals & Entertainment,13.05,57206626.76
11/25/2022,Expense,Miro,Mike ross,Credit Card - Ramp,90,57206716.76
11/25/2022,Expense,103 100,,Travelling Expenses,11.39,57206728.15
11/25/2022,Expense,Miro,,Tools & Subscription - G&A,90,57206818.15
11/25/2022,Expense,103 100,,Travelling Expenses,11.39,57206829.54
11/25/2022,Expense,Creative Market,Mike ross,Credit Card - Ramp,13.6,57206843.14
11/25/2022,Expense,Lucky Pickle Dumpling Co,Mike ross,Meals & Entertainment,13.05,57206856.19
11/25/2022,Expense,Creative Market,Mike ross,Credit Card - Ramp,13.6,57206869.79
11/25/2022,Expense,Zoom,,Tools & Subscription - G&A,14.99,57206884.78
11/25/2022,Expense,Creative Market,Mike ross,Advertising & marketing,30.98,57206915.76
11/25/2022,Expense,103 100,Mike ross,Credit Card - Ramp,11.39,57206927.15
11/25/2022,Expense,Miro,Mike ross,Credit Card - Ramp,90,57207017.15
11/25/2022,Expense,Creative Market,Mike ross,Credit Card - Ramp,30.98,57207048.13
11/25/2022,Expense,103 100,Mike ross,Credit Card - Ramp,11.39,57207059.52
11/25/2022,Expense,Creative Market,Mike ross,Credit Card - Ramp,30.98,57207090.5
11/25/2022,Expense,Zoom,Chad Blumenthal,Credit Card - Ramp,14.99,57207105.49
11/25/2022,Expense,Creative Market,Mike ross,Advertising & marketing,13.6,57207119.09
11/25/2022,Expense,Miro,,Tools & Subscription - G&A,90,57207209.09
11/25/2022,Expense,Creative Market,Mike ross,Advertising & marketing,13.6,57207222.69
11/25/2022,Expense,Zoom,Chad Blumenthal,Credit Card - Ramp,14.99,57207237.68
11/25/2022,Expense,Creative Market,Mike ross,Credit Card - Ramp,13.6,57207251.28
11/27/2022,Expense,The New York Times,Mike ross,Credit Card - Ramp,1.36,57207252.64
11/27/2022,Expense,The New York Times,Mike ross,Credit Card - Ramp,1.36,57207254
11/27/2022,Expense,Sentry,Balapavan Tirumani,Credit Card - Ramp,29,57207283
11/27/2022,Expense,The New York Times,Mike ross,Credit Card - Ramp,1.36,57207284.36
11/27/2022,Deposit,,*ZULILY*5058180177,Account1,-14.34,57207270.02
11/27/2022,Expense,Splitbee,Harris Jose,Credit Card - Ramp,16.52,57207286.54
11/27/2022,Deposit,,*ZULILY*5058180177,Account1,-14.34,57207272.2
11/27/2022,Expense,,*ZULILY*5058180177,Office expenses,-14.34,57207257.86
11/27/2022,Expense,Splitbee,,Tools & Subscription - G&A,16.52,57207274.38
11/27/2022,Expense,The New York Times,,General business expenses:Memberships & subscriptions,1.36,57207275.74
11/27/2022,Expense,The New York Times,,General business expenses:Memberships & subscriptions,1.36,57207277.1
11/27/2022,Expense,Sendinblue,,Tools & Subscription - G&A,56.63,57207333.73
11/27/2022,Expense,Sentry,,Tools & Subscription - G&A,29,57207362.73
11/27/2022,Deposit,,*ZULILY*5058180177,Account1,-14.34,57207348.39
11/27/2022,Expense,,*ZULILY*5058180177,Account1,14.34,57207362.73
11/27/2022,Expense,Splitbee,,Tools & Subscription - G&A,16.52,57207379.25
11/27/2022,Expense,,*ZULILY*5058180177,Account1,14.34,57207393.59
11/27/2022,Expense,Sentry,,Tools & Subscription - G&A,29,57207422.59
11/27/2022,Expense,Sendinblue,Balapavan Tirumani,Credit Card - Ramp,56.63,57207479.22
11/27/2022,Expense,Splitbee,,Tools & Subscription - G&A,16.52,57207495.74
11/27/2022,Expense,Sendinblue,,Tools & Subscription - G&A,56.63,57207552.37
11/27/2022,Deposit,,*ZULILY*5058180177,Office expenses,14.34,57207566.71
11/27/2022,Expense,Sentry,Balapavan Tirumani,Credit Card - Ramp,29,57207595.71
11/27/2022,Expense,Sentry,,Tools & Subscription - G&A,29,57207624.71
11/27/2022,Expense,Sendinblue,Balapavan Tirumani,Credit Card - Ramp,56.63,57207681.34
11/27/2022,Expense,The New York Times,,General business expenses:Memberships & subscriptions,1.36,57207682.7
11/27/2022,Expense,,*ZULILY*5058180177,Office expenses,-14.34,57207668.36
11/27/2022,Expense,Splitbee,Harris Jose,Credit Card - Ramp,16.52,57207684.88
11/27/2022,Deposit,,*ZULILY*5058180177,Office expenses,14.34,57207699.22
11/27/2022,Expense,Splitbee,,Tools & Subscription - G&A,16.52,57207715.74
11/27/2022,Expense,Sentry,Balapavan Tirumani,Credit Card - Ramp,29,57207744.74
11/27/2022,Expense,The New York Times,,General business expenses:Memberships & subscriptions,1.36,57207746.1
11/27/2022,Expense,Sendinblue,,Tools & Subscription - G&A,56.63,57207802.73
11/27/2022,Expense,,*ZULILY*5058180177,Account1,14.34,57207817.07
11/27/2022,Expense,Sendinblue,,Tools & Subscription - G&A,56.63,57207873.7
11/27/2022,Expense,Sendinblue,Balapavan Tirumani,Credit Card - Ramp,56.63,57207930.33
11/27/2022,Expense,Splitbee,Harris Jose,Credit Card - Ramp,16.52,57207946.85
11/27/2022,Deposit,,*ZULILY*5058180177,Account1,-14.34,57207932.51
11/27/2022,Deposit,,*ZULILY*5058180177,Office expenses,14.34,57207946.85
11/27/2022,Expense,,*ZULILY*5058180177,Account1,14.34,57207961.19
11/27/2022,Expense,Sentry,,Tools & Subscription - G&A,29,57207990.19
11/27/2022,Expense,,*ZULILY*5058180177,Office expenses,-14.34,57207975.85
11/27/2022,Expense,,*ZULILY*5058180177,Office expenses,-14.34,57207961.51
11/27/2022,Deposit,,*ZULILY*5058180177,Office expenses,14.34,57207975.85
11/27/2022,Expense,The New York Times,Mike ross,Credit Card - Ramp,1.36,57207977.21
11/28/2022,Expense,Medium,,General business expenses:Memberships & subscriptions,25,57208002.21
11/28/2022,Expense,Medium,Harvey Spector,Credit Card - Ramp,25,57208027.21
11/28/2022,Expense,Medium,Harvey Spector,Credit Card - Ramp,25,57208052.21
11/28/2022,Expense,Masterclass,Harvey Spector,Credit Card - Ramp,180,57208232.21
11/28/2022,Expense,Medium,,General business expenses:Memberships & subscriptions,25,57208257.21
11/28/2022,Expense,Masterclass,Harvey Spector,General business expenses:Continuing education,180,57208437.21
11/28/2022,Expense,Masterclass,Harvey Spector,General business expenses:Continuing education,180,57208617.21
11/28/2022,Expense,Medium,,General business expenses:Memberships & subscriptions,25,57208642.21
11/28/2022,Expense,Masterclass,Harvey Spector,General business expenses:Continuing education,180,57208822.21
11/28/2022,Expense,Masterclass,Harvey Spector,Credit Card - Ramp,180,57209002.21
11/28/2022,Expense,Medium,Harvey Spector,Credit Card - Ramp,25,57209027.21
11/28/2022,Expense,Masterclass,Harvey Spector,Credit Card - Ramp,180,57209207.21
11/28/2022,Expense,Masterclass,Harvey Spector,General business expenses:Continuing education,180,57209387.21
11/28/2022,Expense,Masterclass,Harvey Spector,Credit Card - Ramp,180,57209567.21
11/28/2022,Expense,Medium,Harvey Spector,Credit Card - Ramp,25,57209592.21
11/28/2022,Expense,Medium,,General business expenses:Memberships & subscriptions,25,57209617.21
11/29/2022,Expense,Creative Market,Mike ross,Advertising & marketing,12.06,57209629.27
11/29/2022,Expense,Uber Eats,Mike ross,Meals & Entertainment,17.68,57209646.95
11/29/2022,Expense,Creative Market,Mike ross,Credit Card - Ramp,8.98,57209655.93
11/29/2022,Expense,Creative Market,Mike ross,Credit Card - Ramp,12.06,57209667.99
11/29/2022,Expense,Creative Market,Mike ross,Credit Card - Ramp,8.98,57209676.97
11/29/2022,Expense,Creative Market,Mike ross,Credit Card - Ramp,12.06,57209689.03
11/29/2022,Expense,Readwise,,Tools & Subscription - G&A,47.94,57209736.97
11/29/2022,Expense,Uber Eats,Mike ross,Meals & Entertainment,17.68,57209754.65
11/29/2022,Expense,Creative Market,Mike ross,Advertising & marketing,8.98,57209763.63
11/29/2022,Expense,Netlify,,Tools & Subscription - G&A,19,57209782.63
11/29/2022,Expense,Creative Market,Mike ross,Advertising & marketing,12.06,57209794.69
11/29/2022,Expense,Readwise,,Tools & Subscription - G&A,47.94,57209842.63
11/29/2022,Expense,Netlify,,Tools & Subscription - G&A,19,57209861.63
11/29/2022,Expense,Creative Market,Mike ross,Advertising & marketing,12.06,57209873.69
11/29/2022,Expense,Creative Market,Mike ross,Advertising & marketing,8.98,57209882.67
11/29/2022,Expense,Uber Eats,Mike ross,Meals & Entertainment,17.68,57209900.35
11/29/2022,Expense,Readwise,,Tools & Subscription - G&A,47.94,57209948.29
11/29/2022,Expense,Netlify,,Tools & Subscription - G&A,19,57209967.29
11/29/2022,Expense,Creative Market,Mike ross,Credit Card - Ramp,12.06,57209979.35
11/29/2022,Expense,Creative Market,Mike ross,Advertising & marketing,12.06,57209991.41
11/29/2022,Expense,Readwise,Harvey Spector,Credit Card - Ramp,47.94,57210039.35
11/29/2022,Expense,Creative Market,Mike ross,Advertising & marketing,8.98,57210048.33
11/29/2022,Expense,Creative Market,Mike ross,Credit Card - Ramp,8.98,57210057.31
11/29/2022,Expense,Readwise,Harvey Spector,Credit Card - Ramp,47.94,57210105.25
11/29/2022,Expense,Creative Market,Mike ross,Advertising & marketing,8.98,57210114.23
11/29/2022,Expense,Uber Eats,Mike ross,Credit Card - Ramp,17.68,57210131.91
11/29/2022,Expense,Uber Eats,Mike ross,Credit Card - Ramp,17.68,57210149.59
11/29/2022,Expense,Uber Eats,Mike ross,Meals & Entertainment,17.68,57210167.27
11/29/2022,Expense,Netlify,Balapavan Tirumani,Credit Card - Ramp,19,57210186.27
11/29/2022,Expense,Netlify,Balapavan Tirumani,Credit Card - Ramp,19,57210205.27
11/29/2022,Expense,Netlify,Balapavan Tirumani,Credit Card - Ramp,19,57210224.27
11/29/2022,Expense,Uber Eats,Mike ross,Credit Card - Ramp,17.68,57210241.95
11/29/2022,Expense,Readwise,Harvey Spector,Credit Card - Ramp,47.94,57210289.89
11/29/2022,Expense,Netlify,,Tools & Subscription - G&A,19,57210308.89
11/29/2022,Expense,Readwise,,Tools & Subscription - G&A,47.94,57210356.83
11/29/2022,Expense,Creative Market,Mike ross,Credit Card - Ramp,12.06,57210368.89
11/29/2022,Expense,Uber Eats,Mike ross,Credit Card - Ramp,17.68,57210386.57
11/29/2022,Expense,Creative Market,Mike ross,Credit Card - Ramp,8.98,57210395.55
11/30/2022,Expense,Income Capitals ,Income Capitals ,Contract labor,-11158.95,57199236.6
11/30/2022,Expense,Adobe,Mike ross,Credit Card - Ramp,15.06,57199251.66
11/30/2022,Expense,Fable,Harvey Spector,Meals & Entertainment,24.37,57199276.03
11/30/2022,Expense,Zapier,,Tools & Subscription - G&A,29.99,57199306.02
11/30/2022,Expense,Income Capitals ,Income Capitals ,Contract labor,-9554,57189752.02
11/30/2022,Expense,Fable,Harvey Spector,Meals & Entertainment,24.37,57189776.39
11/30/2022,Expense,Adobe,,Tools & Subscription - S&M,15.06,57189791.45
11/30/2022,Expense,Adobe,,Tools & Subscription - S&M,15.06,57189806.51
11/30/2022,Expense,Zapier,,Tools & Subscription - G&A,29.99,57189836.5
11/30/2022,Bill,Big Company ,,Outsources Services - India,44418.86,57234255.36
11/30/2022,Expense,Income Capitals ,Income Capitals ,Account1,9554,57243809.36
11/30/2022,Expense,Income Capitals ,Income Capitals ,Contract labor,-9554,57234255.36
11/30/2022,Expense,Income Capitals ,Income Capitals ,Contract labor,-11158.95,57223096.41
11/30/2022,Expense,Adobe,Mike ross,Credit Card - Ramp,15.06,57223111.47
11/30/2022,Expense,Fable,Harvey Spector,Credit Card - Ramp,24.37,57223135.84
11/30/2022,Bill,Big Company ,,Outsources Services - India,44418.86,57267554.7
11/30/2022,Expense,Zapier,Chad Blumenthal,Credit Card - Ramp,29.99,57267584.69
11/30/2022,Expense,Zapier,Chad Blumenthal,Credit Card - Ramp,29.99,57267614.68
11/30/2022,Expense,Fable,Harvey Spector,Credit Card - Ramp,24.37,57267639.05
11/30/2022,Expense,Fable,Harvey Spector,Credit Card - Ramp,24.37,57267663.42
11/30/2022,Bill,Big Company ,"Service Expenses for the month of November 2022 
INR   36,24,446.00    @ 81.597",Accounts Payable (A/P),44418.86,57312082.28
11/30/2022,Expense,Income Capitals ,Income Capitals ,Account1,11158.95,57323241.23
11/30/2022,Expense,Income Capitals ,Income Capitals ,Account1,11158.95,57334400.18
11/30/2022,Expense,Income Capitals ,Income Capitals ,Account1,9554,57343954.18
11/30/2022,Bill,Big Company ,,Outsources Services - India,44418.86,57388373.04
11/30/2022,Expense,Income Capitals ,Income Capitals ,Account1,9554,57397927.04
11/30/2022,Expense,Income Capitals ,Income Capitals ,Account1,11158.95,57409085.99
11/30/2022,Expense,Income Capitals ,Income Capitals ,Account1,9554,57418639.99
11/30/2022,Expense,Income Capitals ,Income Capitals ,Contract labor,-11158.95,57407481.04
11/30/2022,Expense,Income Capitals ,Income Capitals ,Contract labor,-9554,57397927.04
11/30/2022,Expense,Income Capitals ,Income Capitals ,Account1,11158.95,57409085.99
11/30/2022,Expense,Income Capitals ,Income Capitals ,Contract labor,-11158.95,57397927.04
11/30/2022,Expense,Zapier,,Tools & Subscription - G&A,29.99,57397957.03
11/30/2022,Expense,Fable,Harvey Spector,Meals & Entertainment,24.37,57397981.4
11/30/2022,Expense,Adobe,,Tools & Subscription - S&M,15.06,57397996.46
11/30/2022,Bill,Big Company ,,Outsources Services - India,44418.86,57442415.32
11/30/2022,Bill,Big Company ,"Service Expenses for the month of November 2022 
INR   36,24,446.00    @ 81.597",Accounts Payable (A/P),44418.86,57486834.18
11/30/2022,Expense,Adobe,Mike ross,Credit Card - Ramp,15.06,57486849.24
11/30/2022,Bill,Big Company ,"Service Expenses for the month of November 2022 
INR   36,24,446.00    @ 81.597",Accounts Payable (A/P),44418.86,57531268.1
11/30/2022,Bill,Big Company ,"Service Expenses for the month of November 2022 
INR   36,24,446.00    @ 81.597",Accounts Payable (A/P),44418.86,57575686.96
11/30/2022,Expense,Fable,Harvey Spector,Credit Card - Ramp,24.37,57575711.33
11/30/2022,Expense,Fable,Harvey Spector,Meals & Entertainment,24.37,57575735.7
11/30/2022,Expense,Adobe,,Tools & Subscription - S&M,15.06,57575750.76
11/30/2022,Expense,Income Capitals ,Income Capitals ,Contract labor,-9554,57566196.76
11/30/2022,Expense,Zapier,Chad Blumenthal,Credit Card - Ramp,29.99,57566226.75
11/30/2022,Expense,Zapier,,Tools & Subscription - G&A,29.99,57566256.74
12/01/2022,Expense,Slack,Mike ross,Credit Card - Ramp,55.01,57566311.75
12/01/2022,Expense,Google G Suite,,Tools & Subscription - G&A,113.9,57566425.65
12/01/2022,Expense,Avatarai.Me,,Tools & Subscription - G&A,3.18,57566428.83
12/01/2022,Expense,Slack,,Tools & Subscription - G&A,55.01,57566483.84
12/01/2022,Expense,Google G Suite,Mike ross,Credit Card - Ramp,113.9,57566597.74
12/01/2022,Expense,Avatarai.Me,Harvey Spector,Credit Card - Ramp,3.18,57566600.92
12/01/2022,Expense,Google G Suite,,Tools & Subscription - G&A,113.9,57566714.82
12/01/2022,Expense,Slack,,Tools & Subscription - G&A,55.01,57566769.83
12/01/2022,Expense,Google G Suite,Mike ross,Credit Card - Ramp,113.9,57566883.73
12/01/2022,Expense,Avatarai.Me,Harvey Spector,Credit Card - Ramp,3.18,57566886.91
12/01/2022,Expense,Avatarai.Me,,Tools & Subscription - G&A,3.18,57566890.09
12/01/2022,Expense,Google G Suite,,Tools & Subscription - G&A,113.9,57567003.99
12/01/2022,Expense,Slack,Mike ross,Credit Card - Ramp,55.01,57567059
12/01/2022,Expense,Slack,,Tools & Subscription - G&A,55.01,57567114.01
12/01/2022,Expense,Slack,Mike ross,Credit Card - Ramp,55.01,57567169.02
12/01/2022,Expense,Google G Suite,Mike ross,Credit Card - Ramp,113.9,57567282.92
12/01/2022,Expense,Avatarai.Me,Harvey Spector,Credit Card - Ramp,3.18,57567286.1
12/01/2022,Expense,Avatarai.Me,,Tools & Subscription - G&A,3.18,57567289.28
12/01/2022,Expense,Google G Suite,,Tools & Subscription - G&A,113.9,57567403.18
12/01/2022,Expense,Avatarai.Me,,Tools & Subscription - G&A,3.18,57567406.36
12/01/2022,Expense,Slack,,Tools & Subscription - G&A,55.01,57567461.37
12/02/2022,Expense,Render,Balapavan Tirumani,Credit Card - Ramp,56,57567517.37
12/02/2022,Expense,Uber,,Travelling Expenses,54.97,57567572.34
12/02/2022,Expense,Uber,Mike ross,Credit Card - Ramp,6.85,57567579.19
12/02/2022,Expense,Uber,,Travelling Expenses,6.85,57567586.04
12/02/2022,Expense,Airport Retail Enter Restaurant,Mike ross,Credit Card - Ramp,20.42,57567606.46
12/02/2022,Expense,Airport Retail Enter Restaurant,Mike ross,Credit Card - Ramp,20.42,57567626.88
12/02/2022,Expense,Buffer,,Tools & Subscription - G&A,240,57567866.88
12/02/2022,Expense,Airport Retail Enter Restaurant,Mike ross,Credit Card - Ramp,20.42,57567887.3
12/02/2022,Expense,Uber,,Travelling Expenses,6.85,57567894.15
12/02/2022,Expense,Buffer,,Tools & Subscription - G&A,240,57568134.15
12/02/2022,Expense,Render,,Tools & Subscription - G&A,56,57568190.15
12/02/2022,Expense,Uber,,Travelling Expenses,9.37,57568199.52
12/02/2022,Expense,Uber,,Travelling Expenses,54.97,57568254.49
12/02/2022,Expense,Buffer,Harvey Spector,Credit Card - Ramp,240,57568494.49
12/02/2022,Expense,Render,Balapavan Tirumani,Credit Card - Ramp,56,57568550.49
12/02/2022,Expense,Airport Retail Enter Restaurant,Mike ross,Meals & Entertainment,20.42,57568570.91
12/02/2022,Expense,Uber,Mike ross,Credit Card - Ramp,54.97,57568625.88
12/02/2022,Expense,Airport Retail Enter Restaurant,Mike ross,Meals & Entertainment,20.42,57568646.3
12/02/2022,Expense,Uber,,Travelling Expenses,9.37,57568655.67
12/02/2022,Expense,Airport Retail Enter Restaurant,Mike ross,Meals & Entertainment,20.42,57568676.09
12/02/2022,Expense,Render,,Tools & Subscription - G&A,56,57568732.09
12/02/2022,Expense,Airport Retail Enter Restaurant,Mike ross,Credit Card - Ramp,20.42,57568752.51
12/02/2022,Expense,Render,,Tools & Subscription - G&A,56,57568808.51
12/02/2022,Expense,Uber,,Travelling Expenses,6.85,57568815.36
12/02/2022,Expense,Uber,,Travelling Expenses,9.37,57568824.73
12/02/2022,Expense,Uber,,Travelling Expenses,54.97,57568879.7
12/02/2022,Expense,Buffer,,Tools & Subscription - G&A,240,57569119.7
12/02/2022,Expense,Buffer,Harvey Spector,Credit Card - Ramp,240,57569359.7
12/02/2022,Expense,Uber,Mike ross,Credit Card - Ramp,54.97,57569414.67
12/02/2022,Expense,Uber,Mike ross,Credit Card - Ramp,6.85,57569421.52
12/02/2022,Expense,Uber,,Travelling Expenses,54.97,57569476.49
12/02/2022,Expense,Uber,,Travelling Expenses,9.37,57569485.86
12/02/2022,Expense,Buffer,,Tools & Subscription - G&A,240,57569725.86
12/02/2022,Expense,Airport Retail Enter Restaurant,Mike ross,Meals & Entertainment,20.42,57569746.28
12/02/2022,Expense,Render,,Tools & Subscription - G&A,56,57569802.28
12/02/2022,Expense,Uber,Mike ross,Credit Card - Ramp,6.85,57569809.13
12/02/2022,Expense,Uber,Mike ross,Credit Card - Ramp,9.37,57569818.5
12/02/2022,Expense,Render,Balapavan Tirumani,Credit Card - Ramp,56,57569874.5
12/02/2022,Expense,Uber,Mike ross,Credit Card - Ramp,9.37,57569883.87
12/02/2022,Expense,Uber,Mike ross,Credit Card - Ramp,54.97,57569938.84
12/02/2022,Expense,Buffer,Harvey Spector,Credit Card - Ramp,240,57570178.84
12/02/2022,Expense,Uber,,Travelling Expenses,6.85,57570185.69
12/02/2022,Expense,Uber,Mike ross,Credit Card - Ramp,9.37,57570195.06
12/03/2022,Expense,Mazurek Co,Harvey Spector,Credit Card - Ramp,29.95,57570225.01
12/03/2022,Deposit,,Interest Accrual INTEREST,Interest Received,4.73,57570229.74
12/03/2022,Deposit,,Interest Accrual INTEREST,Savings (6977),4.73,57570234.47
12/03/2022,Deposit,,Interest Accrual INTEREST,Savings (6977),4.73,57570239.2
12/03/2022,Deposit,,Interest Accrual INTEREST,Savings (6977),4.73,57570243.93
12/03/2022,Expense,Uber,,Travelling Expenses,28.25,57570272.18
12/03/2022,Deposit,,Interest Accrual INTEREST,Interest Received,4.73,57570276.91
12/03/2022,Deposit,,Interest Accrual INTEREST,Interest Received,4.73,57570281.64
12/03/2022,Expense,Mazurek Co,Harvey Spector,Credit Card - Ramp,29.95,57570311.59
12/03/2022,Expense,Mazurek Co,,Tools & Subscription - G&A,29.95,57570341.54
12/03/2022,Deposit,,Interest Accrual INTEREST,Interest Received,4.73,57570346.27
12/03/2022,Expense,Mazurek Co,,Tools & Subscription - G&A,29.95,57570376.22
12/03/2022,Expense,Uber,,Travelling Expenses,28.25,57570404.47
12/03/2022,Expense,Uber,Mike ross,Credit Card - Ramp,28.25,57570432.72
12/03/2022,Expense,Uber,Mike ross,Credit Card - Ramp,28.25,57570460.97
12/03/2022,Expense,Mazurek Co,Harvey Spector,Credit Card - Ramp,29.95,57570490.92
12/03/2022,Expense,Mazurek Co,,Tools & Subscription - G&A,29.95,57570520.87
12/03/2022,Expense,Uber,Mike ross,Credit Card - Ramp,28.25,57570549.12
12/03/2022,Expense,Mazurek Co,,Tools & Subscription - G&A,29.95,57570579.07
12/03/2022,Expense,Uber,,Travelling Expenses,28.25,57570607.32
12/03/2022,Expense,Uber,,Travelling Expenses,28.25,57570635.57
12/04/2022,Transfer,,PaymentServiceB Checking **7257,Savings (6977),150000,57720635.57
12/04/2022,Expense,Uber,,Travelling Expenses,13.38,57720648.95
12/04/2022,Expense,Uber Eats,Mike ross,Meals & Entertainment,33.19,57720682.14
12/04/2022,Expense,Uber,Mike ross,Credit Card - Ramp,13.38,57720695.52
12/04/2022,Expense,Uber,Mike ross,Credit Card - Ramp,10.59,57720706.11
12/04/2022,Expense,Uber,,Travelling Expenses,13.38,57720719.49
12/04/2022,Transfer,,PaymentServiceB Checking **7257,Account1,-150000,57570719.49
12/04/2022,Expense,Uber,,Travelling Expenses,13.38,57570732.87
12/04/2022,Expense,Uber Eats,Mike ross,Credit Card - Ramp,33.19,57570766.06
12/04/2022,Expense,Uber Eats,Mike ross,Meals & Entertainment,33.19,57570799.25
12/04/2022,Expense,Uber,,Travelling Expenses,10.59,57570809.84
12/04/2022,Expense,Uber,Mike ross,Credit Card - Ramp,13.38,57570823.22
12/04/2022,Expense,Uber,,Travelling Expenses,10.59,57570833.81
12/04/2022,Transfer,,PaymentServiceB Checking **7257,Account1,-150000,57420833.81
12/04/2022,Transfer,,PaymentServiceB Checking **7257,Savings (6977),150000,57570833.81
12/04/2022,Expense,Uber Eats,Mike ross,Meals & Entertainment,33.19,57570867
12/04/2022,Expense,Uber,,Travelling Expenses,13.38,57570880.38
12/04/2022,Expense,Uber,Mike ross,Credit Card - Ramp,13.38,57570893.76
12/04/2022,Expense,Uber Eats,Mike ross,Credit Card - Ramp,33.19,57570926.95
12/04/2022,Expense,Uber,,Travelling Expenses,10.59,57570937.54
12/04/2022,Transfer,,PaymentServiceB Checking **7257,Savings (6977),150000,57720937.54
12/04/2022,Transfer,,PaymentServiceB Checking **7257,Savings (6977),150000,57870937.54
12/04/2022,Expense,Uber Eats,Mike ross,Meals & Entertainment,33.19,57870970.73
12/04/2022,Transfer,,PaymentServiceB Checking **7257,Account1,-150000,57720970.73
12/04/2022,Expense,Uber,Mike ross,Credit Card - Ramp,10.59,57720981.32
12/04/2022,Expense,Uber Eats,Mike ross,Credit Card - Ramp,33.19,57721014.51
12/04/2022,Transfer,,PaymentServiceB Checking **7257,Account1,-150000,57571014.51
12/04/2022,Expense,Uber,Mike ross,Credit Card - Ramp,10.59,57571025.1
12/04/2022,Expense,Uber Eats,Mike ross,Credit Card - Ramp,33.19,57571058.29
12/04/2022,Expense,Uber,,Travelling Expenses,10.59,57571068.88
12/05/2022,Expense,Ssp Fred'S Footsteps,Mike ross,Credit Card - Ramp,24.07,57571092.95
12/05/2022,Expense,,Fees_ Exchange Fee for International transfer,Account1,1000,57572092.95
12/05/2022,Expense,EntityA,ChronicleHQ Australia,Account2,-100000,57472092.95
12/05/2022,Expense,Ssp Fred'S Footsteps,Mike ross,Credit Card - Ramp,24.07,57472117.02
12/05/2022,Expense,Ssp Fred'S Footsteps,Mike ross,Contributions to charities,24.07,57472141.09
12/05/2022,Expense,Uber,,Travelling Expenses,36.96,57472178.05
12/05/2022,Expense,,Fees,General business expenses:Bank fees & service charges,-1000,57471178.05
12/05/2022,Expense,EntityA,ChronicleHQ Australia,Account1,-100000,57371178.05
12/05/2022,Expense,EntityA,ChronicleHQ Australia,Account2,-100000,57271178.05
12/05/2022,Expense,Kometa,Mike ross,Credit Card - Ramp,501.24,57271679.29
12/05/2022,Expense,Kometa,Mike ross,Professional Service Charges,501.24,57272180.53
12/05/2022,Expense,Kometa,Mike ross,Credit Card - Ramp,501.24,57272681.77
12/05/2022,Expense,Uber,,Travelling Expenses,8.38,57272690.15
12/05/2022,Expense,Ssp Fred'S Footsteps,Mike ross,Contributions to charities,24.07,57272714.22
12/05/2022,Expense,Uber,Mike ross,Credit Card - Ramp,8.38,57272722.6
12/05/2022,Expense,Uber,Mike ross,Credit Card - Ramp,36.96,57272759.56
12/05/2022,Expense,GM Cabs,,Travelling Expenses,24.7,57272784.26
12/05/2022,Expense,,Fees_ Exchange Fee for International transfer,Account1,1000,57273784.26
12/05/2022,Expense,GM Cabs,Mike ross,Credit Card - Ramp,24.7,57273808.96
12/05/2022,Expense,Uber,Mike ross,Credit Card - Ramp,36.96,57273845.92
12/05/2022,Expense,Uber,Mike ross,Credit Card - Ramp,8.38,57273854.3
12/05/2022,Expense,,Fees,General business expenses:Bank fees & service charges,-1000,57272854.3
12/05/2022,Expense,GM Cabs,Mike ross,Credit Card - Ramp,24.7,57272879
12/05/2022,Expense,Ssp Fred'S Footsteps,Mike ross,Contributions to charities,24.07,57272903.07
12/05/2022,Expense,Kometa,Mike ross,Credit Card - Ramp,501.24,57273404.31
12/05/2022,Expense,GM Cabs,,Travelling Expenses,24.7,57273429.01
12/05/2022,Expense,GM Cabs,,Travelling Expenses,24.7,57273453.71
12/05/2022,Expense,Uber,,Travelling Expenses,36.96,57273490.67
12/05/2022,Expense,Uber,,Travelling Expenses,8.38,57273499.05
12/05/2022,Expense,Ssp Fred'S Footsteps,Mike ross,Credit Card - Ramp,24.07,57273523.12
12/05/2022,Expense,Kometa,Mike ross,Professional Service Charges,501.24,57274024.36
12/05/2022,Expense,EntityA,ChronicleHQ Australia,Account1,-100000,57174024.36
12/05/2022,Expense,Ssp Fred'S Footsteps,Mike ross,Contributions to charities,24.07,57174048.43
12/05/2022,Expense,EntityA,ChronicleHQ Australia,Account1,-100000,57074048.43
12/05/2022,Expense,Uber,,Travelling Expenses,8.38,57074056.81
12/05/2022,Expense,GM Cabs,,Travelling Expenses,24.7,57074081.51
12/05/2022,Expense,Uber,,Travelling Expenses,8.38,57074089.89
12/05/2022,Expense,Kometa,Mike ross,Professional Service Charges,501.24,57074591.13
12/05/2022,Expense,Uber,,Travelling Expenses,36.96,57074628.09
12/05/2022,Expense,,Fees,General business expenses:Bank fees & service charges,-1000,57073628.09
12/05/2022,Expense,EntityA,ChronicleHQ Australia,Account2,-100000,56973628.09
12/05/2022,Expense,EntityA,ChronicleHQ Australia,Account1,-100000,56873628.09
12/05/2022,Expense,Uber,,Travelling Expenses,36.96,56873665.05
12/05/2022,Expense,,Fees_ Exchange Fee for International transfer,Account1,1000,56874665.05
12/05/2022,Expense,Kometa,Mike ross,Credit Card - Ramp,501.24,56875166.29
12/05/2022,Expense,Ssp Fred'S Footsteps,Mike ross,Credit Card - Ramp,24.07,56875190.36
12/05/2022,Expense,,Fees,General business expenses:Bank fees & service charges,-1000,56874190.36
12/05/2022,Expense,,Fees_ Exchange Fee for International transfer,Account1,1000,56875190.36
12/05/2022,Expense,Uber,Mike ross,Credit Card - Ramp,8.38,56875198.74
12/05/2022,Expense,Uber,Mike ross,Credit Card - Ramp,36.96,56875235.7
12/05/2022,Expense,GM Cabs,Mike ross,Credit Card - Ramp,24.7,56875260.4
12/05/2022,Expense,Kometa,Mike ross,Professional Service Charges,501.24,56875761.64
12/05/2022,Expense,EntityA,ChronicleHQ Australia,Account2,-100000,56775761.64
12/06/2022,Expense,HCC Medical Insurance Services,,Insurance,54,56775815.64
12/06/2022,Expense,Adobe,Mike ross,Credit Card - Ramp,82.28,56775897.92
12/06/2022,Expense,Bourke Street Bakery,Mike ross,Meals & Entertainment,4.5,56775902.42
12/06/2022,Expense,Taplio,,Tools & Subscription - G&A,39,56775941.42
12/06/2022,Expense,Adobe,,Tools & Subscription - S&M,82.28,56776023.7
12/06/2022,Expense,Uber Eats,Mike ross,Meals & Entertainment,16.41,56776040.11
12/06/2022,Expense,HCC Medical Insurance Services,,Insurance,54,56776094.11
12/06/2022,Expense,HCC Medical Insurance Services,Harvey Spector,Credit Card - Ramp,54,56776148.11
12/06/2022,Expense,Adobe,Mike ross,Credit Card - Ramp,82.28,56776230.39
12/06/2022,Expense,Bourke Street Bakery,Mike ross,Credit Card - Ramp,4.5,56776234.89
12/06/2022,Expense,Uber Eats,Mike ross,Credit Card - Ramp,16.41,56776251.3
12/06/2022,Expense,Adobe,Mike ross,Credit Card - Ramp,82.28,56776333.58
12/06/2022,Expense,HCC Medical Insurance Services,Harvey Spector,Credit Card - Ramp,54,56776387.58
12/06/2022,Expense,Taplio,Harvey Spector,Credit Card - Ramp,39,56776426.58
12/06/2022,Expense,Uber Eats,Mike ross,Credit Card - Ramp,16.41,56776442.99
12/06/2022,Expense,Bourke Street Bakery,Mike ross,Credit Card - Ramp,4.5,56776447.49
12/06/2022,Expense,Uber Eats,Mike ross,Meals & Entertainment,16.41,56776463.9
12/06/2022,Expense,Uber Eats,Mike ross,Credit Card - Ramp,16.41,56776480.31
12/06/2022,Expense,Adobe,,Tools & Subscription - S&M,82.28,56776562.59
12/06/2022,Expense,Uber Eats,Mike ross,Meals & Entertainment,16.41,56776579
12/06/2022,Expense,Bourke Street Bakery,Mike ross,Meals & Entertainment,4.5,56776583.5
12/06/2022,Expense,HCC Medical Insurance Services,,Insurance,54,56776637.5
12/06/2022,Expense,Bourke Street Bakery,Mike ross,Meals & Entertainment,4.5,56776642
12/06/2022,Expense,Taplio,,Tools & Subscription - G&A,39,56776681
12/06/2022,Expense,Taplio,,Tools & Subscription - G&A,39,56776720
12/06/2022,Expense,Taplio,,Tools & Subscription - G&A,39,56776759
12/06/2022,Expense,Bourke Street Bakery,Mike ross,Meals & Entertainment,4.5,56776763.5
12/06/2022,Expense,Uber Eats,Mike ross,Credit Card - Ramp,16.41,56776779.91
12/06/2022,Expense,HCC Medical Insurance Services,,Insurance,54,56776833.91
12/06/2022,Expense,Taplio,Harvey Spector,Credit Card - Ramp,39,56776872.91
12/06/2022,Expense,Taplio,Harvey Spector,Credit Card - Ramp,39,56776911.91
12/06/2022,Expense,Uber Eats,Mike ross,Meals & Entertainment,16.41,56776928.32
12/06/2022,Expense,Adobe,,Tools & Subscription - S&M,82.28,56777010.6
12/06/2022,Expense,HCC Medical Insurance Services,Harvey Spector,Credit Card - Ramp,54,56777064.6
12/06/2022,Expense,Adobe,,Tools & Subscription - S&M,82.28,56777146.88
12/06/2022,Expense,HCC Medical Insurance Services,Harvey Spector,Credit Card - Ramp,54,56777200.88
12/06/2022,Expense,Bourke Street Bakery,Mike ross,Credit Card - Ramp,4.5,56777205.38
12/06/2022,Expense,Bourke Street Bakery,Mike ross,Credit Card - Ramp,4.5,56777209.88
12/07/2022,Expense,Cafe 1001 Restaurant,Mike ross,Meals & Entertainment,16.09,56777225.97
12/07/2022,Expense,Reuben Hills,Mike ross,Meals & Entertainment,4.1,56777230.07
12/07/2022,Expense,Uber,,Travelling Expenses,11.52,56777241.59
12/07/2022,Expense,Cafe 1001 Restaurant,Mike ross,Meals & Entertainment,16.09,56777257.68
12/07/2022,Expense,Reuben Hills,Mike ross,Credit Card - Ramp,4.1,56777261.78
12/07/2022,Expense,Cafe 1001 Restaurant,Mike ross,Credit Card - Ramp,16.09,56777277.87
12/07/2022,Expense,La Panchina,Mike ross,Credit Card - Ramp,45.2,56777323.07
12/07/2022,Expense,Reuben Hills,Mike ross,Credit Card - Ramp,4.1,56777327.17
12/07/2022,Expense,La Panchina,Mike ross,Credit Card - Ramp,45.2,56777372.37
12/07/2022,Expense,Uber,,Travelling Expenses,11.52,56777383.89
12/07/2022,Expense,Namecheap,,Tools & Subscription - G&A,28.98,56777412.87
12/07/2022,Expense,Cafe 1001 Restaurant,Mike ross,Meals & Entertainment,16.09,56777428.96
12/07/2022,Expense,Reuben Hills,Mike ross,Credit Card - Ramp,4.1,56777433.06
12/07/2022,Expense,La Panchina,Mike ross,Credit Card - Ramp,45.2,56777478.26
12/07/2022,Expense,La Panchina,Mike ross,Meals & Entertainment,45.2,56777523.46
12/07/2022,Expense,La Panchina,Mike ross,Meals & Entertainment,45.2,56777568.66
12/07/2022,Expense,Reuben Hills,Mike ross,Meals & Entertainment,4.1,56777572.76
12/07/2022,Expense,Uber,,Travelling Expenses,11.52,56777584.28
12/07/2022,Expense,Cafe 1001 Restaurant,Mike ross,Credit Card - Ramp,16.09,56777600.37
12/07/2022,Expense,Mailchimp,,Tools & Subscription - G&A,22.02,56777622.39
12/07/2022,Expense,Namecheap,,Tools & Subscription - G&A,28.98,56777651.37
12/07/2022,Expense,Uber,,Travelling Expenses,11.52,56777662.89
12/07/2022,Expense,Uber,Mike ross,Credit Card - Ramp,11.52,56777674.41
12/07/2022,Expense,Reuben Hills,Mike ross,Meals & Entertainment,4.1,56777678.51
12/07/2022,Expense,La Panchina,Mike ross,Meals & Entertainment,45.2,56777723.71
12/07/2022,Expense,Reuben Hills,Mike ross,Meals & Entertainment,4.1,56777727.81
12/07/2022,Expense,Cafe 1001 Restaurant,Mike ross,Credit Card - Ramp,16.09,56777743.9
12/07/2022,Expense,Cafe 1001 Restaurant,Mike ross,Credit Card - Ramp,16.09,56777759.99
12/07/2022,Expense,Namecheap,,Tools & Subscription - G&A,28.98,56777788.97
12/07/2022,Expense,Namecheap,Harvey Spector,Credit Card - Ramp,28.98,56777817.95
12/07/2022,Expense,Uber,Mike ross,Credit Card - Ramp,11.52,56777829.47
12/07/2022,Expense,Mailchimp,Mike ross,Credit Card - Ramp,22.02,56777851.49
12/07/2022,Expense,Namecheap,Harvey Spector,Credit Card - Ramp,28.98,56777880.47
12/07/2022,Expense,La Panchina,Mike ross,Credit Card - Ramp,45.2,56777925.67
12/07/2022,Expense,Reuben Hills,Mike ross,Credit Card - Ramp,4.1,56777929.77
12/07/2022,Expense,Namecheap,,Tools & Subscription - G&A,28.98,56777958.75
12/07/2022,Expense,Mailchimp,,Tools & Subscription - G&A,22.02,56777980.77
12/07/2022,Expense,Cafe 1001 Restaurant,Mike ross,Meals & Entertainment,16.09,56777996.86
12/07/2022,Expense,Uber,Mike ross,Credit Card - Ramp,11.52,56778008.38
12/07/2022,Expense,Namecheap,Harvey Spector,Credit Card - Ramp,28.98,56778037.36
12/07/2022,Expense,Mailchimp,Mike ross,Credit Card - Ramp,22.02,56778059.38
12/07/2022,Expense,Mailchimp,,Tools & Subscription - G&A,22.02,56778081.4
12/07/2022,Expense,La Panchina,Mike ross,Meals & Entertainment,45.2,56778126.6
12/07/2022,Expense,Mailchimp,,Tools & Subscription - G&A,22.02,56778148.62
12/07/2022,Expense,Mailchimp,Mike ross,Credit Card - Ramp,22.02,56778170.64
12/08/2022,Expense,OpenAI,,Tools & Subscription - G&A,17.74,56778188.38
12/08/2022,Expense,Paypal,Amani Shariff,Credit Card - Ramp,28.94,56778217.32
12/08/2022,Expense,Paypal,Amani Shariff,Credit Card - Ramp,28.94,56778246.26
12/08/2022,Expense,OpenAI,Balapavan Tirumani,Credit Card - Ramp,17.74,56778264
12/08/2022,Expense,Four Ate Five,Mike ross,Credit Card - Ramp,28.7,56778292.7
12/08/2022,Expense,Four Ate Five,Mike ross,Credit Card - Ramp,28.7,56778321.4
12/08/2022,Expense,Four Ate Five,Mike ross,Meals & Entertainment,28.7,56778350.1
12/08/2022,Expense,Heroku,Balapavan Tirumani,Tools & Subscription - S&M,87,56778437.1
12/08/2022,Expense,Paypal,Amani Shariff,Office expenses,28.94,56778466.04
12/08/2022,Expense,OpenAI,,Tools & Subscription - G&A,17.74,56778483.78
12/08/2022,Expense,Heroku,Balapavan Tirumani,Credit Card - Ramp,87,56778570.78
12/08/2022,Expense,Paypal,Amani Shariff,Credit Card - Ramp,28.94,56778599.72
12/08/2022,Expense,Paypal,Amani Shariff,Office expenses,28.94,56778628.66
12/08/2022,Expense,Four Ate Five,Mike ross,Meals & Entertainment,28.7,56778657.36
12/08/2022,Expense,OpenAI,Balapavan Tirumani,Credit Card - Ramp,17.74,56778675.1
12/08/2022,Expense,Four Ate Five,Mike ross,Credit Card - Ramp,28.7,56778703.8
12/08/2022,Expense,Heroku,Balapavan Tirumani,Credit Card - Ramp,87,56778790.8
12/08/2022,Expense,Heroku,Balapavan Tirumani,Tools & Subscription - S&M,87,56778877.8
12/08/2022,Expense,Four Ate Five,Mike ross,Credit Card - Ramp,28.7,56778906.5
12/08/2022,Expense,Paypal,Amani Shariff,Credit Card - Ramp,28.94,56778935.44
12/08/2022,Expense,OpenAI,,Tools & Subscription - G&A,17.74,56778953.18
12/08/2022,Expense,Four Ate Five,Mike ross,Meals & Entertainment,28.7,56778981.88
12/08/2022,Expense,Paypal,Amani Shariff,Office expenses,28.94,56779010.82
12/08/2022,Expense,Heroku,Balapavan Tirumani,Tools & Subscription - S&M,87,56779097.82
12/08/2022,Expense,Heroku,Balapavan Tirumani,Tools & Subscription - S&M,87,56779184.82
12/08/2022,Expense,Four Ate Five,Mike ross,Meals & Entertainment,28.7,56779213.52
12/08/2022,Expense,OpenAI,,Tools & Subscription - G&A,17.74,56779231.26
12/08/2022,Expense,OpenAI,Balapavan Tirumani,Credit Card - Ramp,17.74,56779249
12/08/2022,Expense,Paypal,Amani Shariff,Office expenses,28.94,56779277.94
12/08/2022,Expense,Heroku,Balapavan Tirumani,Credit Card - Ramp,87,56779364.94
12/09/2022,Expense,Usersnap,Harris Jose,Credit Card - Ramp,19,56779383.94
12/09/2022,Expense,Datadog,Balapavan Tirumani,Credit Card - Ramp,4.23,56779388.17
12/09/2022,Expense,Uber,Mike ross,Credit Card - Ramp,17.25,56779405.42
12/09/2022,Expense,Uber,Mike ross,Credit Card - Ramp,17.25,56779422.67
12/09/2022,Expense,Uber,Mike ross,Credit Card - Ramp,10.09,56779432.76
12/09/2022,Expense,Uber,Mike ross,Credit Card - Ramp,17.25,56779450.01
12/09/2022,Expense,Uber,Mike ross,Credit Card - Ramp,10.09,56779460.1
12/09/2022,Expense,Uber,,Travelling Expenses,10.09,56779470.19
12/09/2022,Expense,Datadog,,Tools & Subscription - G&A,4.23,56779474.42
12/09/2022,Expense,Datadog,,Tools & Subscription - G&A,4.23,56779478.65
12/09/2022,Expense,Datadog,,Tools & Subscription - G&A,4.23,56779482.88
12/09/2022,Expense,Uber,Mike ross,Credit Card - Ramp,10.09,56779492.97
12/09/2022,Expense,Uber,,Travelling Expenses,17.25,56779510.22
12/09/2022,Expense,Datadog,Balapavan Tirumani,Credit Card - Ramp,4.23,56779514.45
12/09/2022,Expense,Uber,,Travelling Expenses,17.25,56779531.7
12/09/2022,Expense,Usersnap,,Tools & Subscription - G&A,19,56779550.7
12/09/2022,Expense,Usersnap,,Tools & Subscription - G&A,19,56779569.7
12/09/2022,Expense,Uber,,Travelling Expenses,17.25,56779586.95
12/09/2022,Expense,Usersnap,Harris Jose,Credit Card - Ramp,19,56779605.95
12/09/2022,Expense,Uber,,Travelling Expenses,10.09,56779616.04
12/09/2022,Expense,Uber,,Travelling Expenses,10.09,56779626.13
12/09/2022,Expense,Usersnap,Harris Jose,Credit Card - Ramp,19,56779645.13
12/09/2022,Expense,Uber,,Travelling Expenses,10.09,56779655.22
12/09/2022,Expense,Uber,,Travelling Expenses,17.25,56779672.47
12/09/2022,Expense,Usersnap,,Tools & Subscription - G&A,19,56779691.47
12/09/2022,Expense,Datadog,Balapavan Tirumani,Credit Card - Ramp,4.23,56779695.7
12/09/2022,Expense,Usersnap,,Tools & Subscription - G&A,19,56779714.7
12/09/2022,Expense,Datadog,,Tools & Subscription - G&A,4.23,56779718.93
12/10/2022,Expense,PocketSmith,,Tools & Subscription - G&A,9.95,56779728.88
12/10/2022,Expense,Pause Cafe,Harvey Spector,Meals & Entertainment,14.81,56779743.69
12/10/2022,Expense,Airalo,,Utilities:Internet & TV services,12,56779755.69
12/10/2022,Expense,PocketSmith,Harvey Spector,Credit Card - Ramp,9.95,56779765.64
12/10/2022,Expense,PocketSmith,,Tools & Subscription - G&A,9.95,56779775.59
12/10/2022,Expense,PocketSmith,Harvey Spector,Credit Card - Ramp,9.95,56779785.54
12/10/2022,Expense,Airalo,Harvey Spector,Credit Card - Ramp,12,56779797.54
12/10/2022,Expense,PocketSmith,,Tools & Subscription - G&A,9.95,56779807.49
12/10/2022,Expense,Airalo,,Utilities:Internet & TV services,12,56779819.49
12/10/2022,Expense,Airalo,Harvey Spector,Credit Card - Ramp,12,56779831.49
12/10/2022,Expense,Pause Cafe,Harvey Spector,Meals & Entertainment,14.81,56779846.3
12/10/2022,Expense,Airalo,,Utilities:Internet & TV services,12,56779858.3
12/10/2022,Expense,PocketSmith,,Tools & Subscription - G&A,9.95,56779868.25
12/10/2022,Expense,Pause Cafe,Harvey Spector,Credit Card - Ramp,14.81,56779883.06
12/10/2022,Expense,Pause Cafe,Harvey Spector,Meals & Entertainment,14.81,56779897.87
12/10/2022,Expense,Pause Cafe,Harvey Spector,Meals & Entertainment,14.81,56779912.68
12/10/2022,Expense,Pause Cafe,Harvey Spector,Credit Card - Ramp,14.81,56779927.49
12/10/2022,Expense,Airalo,Harvey Spector,Credit Card - Ramp,12,56779939.49
12/10/2022,Expense,Pause Cafe,Harvey Spector,Credit Card - Ramp,14.81,56779954.3
12/10/2022,Expense,Pause Cafe,Harvey Spector,Credit Card - Ramp,14.81,56779969.11
12/10/2022,Expense,PocketSmith,Harvey Spector,Credit Card - Ramp,9.95,56779979.06
12/10/2022,Expense,Airalo,,Utilities:Internet & TV services,12,56779991.06
12/11/2022,Expense,Uber,,Travelling Expenses,17.65,56780008.71
12/11/2022,Expense,Uber,,Travelling Expenses,17.65,56780026.36
12/11/2022,Expense,Uber,,Travelling Expenses,17.65,56780044.01
12/11/2022,Expense,Uber,Mike ross,Credit Card - Ramp,17.65,56780061.66
12/11/2022,Expense,Uber,Mike ross,Credit Card - Ramp,17.65,56780079.31
12/11/2022,Expense,Uber,,Travelling Expenses,17.65,56780096.96
12/11/2022,Expense,Uber,Mike ross,Credit Card - Ramp,17.65,56780114.61
12/12/2022,Expense,GM Cabs,,Travelling Expenses,10.38,56780124.99
12/12/2022,Expense,GM Cabs,Mike ross,Credit Card - Ramp,10.38,56780135.37
12/12/2022,Expense,Artificer,,Meals & Entertainment,3.07,56780138.44
12/12/2022,Expense,GM Cabs,Mike ross,Credit Card - Ramp,10.38,56780148.82
12/12/2022,Expense,Artificer,Mike ross,Credit Card - Ramp,3.07,56780151.89
12/12/2022,Expense,Artificer,Mike ross,Credit Card - Ramp,3.07,56780154.96
12/12/2022,Expense,GM Cabs,,Travelling Expenses,10.38,56780165.34
12/12/2022,Expense,Artificer,,Meals & Entertainment,3.07,56780168.41
12/12/2022,Expense,GM Cabs,Mike ross,Credit Card - Ramp,10.38,56780178.79
12/12/2022,Expense,GM Cabs,,Travelling Expenses,10.38,56780189.17
12/12/2022,Expense,Artificer,,Meals & Entertainment,3.07,56780192.24
12/12/2022,Expense,Artificer,Mike ross,Credit Card - Ramp,3.07,56780195.31
12/12/2022,Expense,Artificer,Mike ross,Credit Card - Ramp,3.07,56780198.38
12/12/2022,Expense,Artificer,,Meals & Entertainment,3.07,56780201.45
12/12/2022,Expense,GM Cabs,,Travelling Expenses,10.38,56780211.83
12/13/2022,Expense,Vercel,Harris Jose,Credit Card - Ramp,140,56780351.83
12/13/2022,Expense,Intercom,,Tools & Subscription - G&A,176,56780527.83
12/13/2022,Expense,Figma,Mike ross,Credit Card - Ramp,405,56780932.83
12/13/2022,Expense,Mtw,,Tools & Subscription - G&A,31.9,56780964.73
12/13/2022,Expense,Barnes & Noble,,General business expenses:Memberships & subscriptions,33.35,56780998.08
12/13/2022,Expense,Vercel,,Tools & Subscription - G&A,140,56781138.08
12/13/2022,Expense,Intercom,,Tools & Subscription - G&A,176,56781314.08
12/13/2022,Expense,Cuckoo Callay,Mike ross,Credit Card - Ramp,12.45,56781326.53
12/13/2022,Expense,Mtw,Chris George,Credit Card - Ramp,31.9,56781358.43
12/13/2022,Expense,Barnes & Noble,Chad Blumenthal,Credit Card - Ramp,33.35,56781391.78
12/13/2022,Expense,Figma,Mike ross,Credit Card - Ramp,405,56781796.78
12/13/2022,Expense,Vercel,,Tools & Subscription - G&A,140,56781936.78
12/13/2022,Expense,Framer,Harvey Spector,Credit Card - Ramp,9.87,56781946.65
12/13/2022,Expense,Cuckoo Callay,Mike ross,Credit Card - Ramp,12.45,56781959.1
12/13/2022,Expense,Barnes & Noble,Chad Blumenthal,Credit Card - Ramp,33.35,56781992.45
12/13/2022,Expense,Cuckoo Callay,Mike ross,Meals & Entertainment,12.45,56782004.9
12/13/2022,Expense,Mtw,Chris George,Credit Card - Ramp,31.9,56782036.8
12/13/2022,Expense,Figma,,Tools & Subscription - G&A,405,56782441.8
12/13/2022,Expense,Framer,,Tools & Subscription - G&A,9.87,56782451.67
12/13/2022,Expense,Mtw,,Tools & Subscription - G&A,31.9,56782483.57
12/13/2022,Expense,Mtw,,Tools & Subscription - G&A,31.9,56782515.47
12/13/2022,Expense,Barnes & Noble,Chad Blumenthal,Credit Card - Ramp,33.35,56782548.82
12/13/2022,Expense,Framer,,Tools & Subscription - G&A,9.87,56782558.69
12/13/2022,Expense,Intercom,Balapavan Tirumani,Credit Card - Ramp,176,56782734.69
12/13/2022,Expense,Figma,,Tools & Subscription - G&A,405,56783139.69
12/13/2022,Expense,Cuckoo Callay,Mike ross,Meals & Entertainment,12.45,56783152.14
12/13/2022,Expense,Figma,,Tools & Subscription - G&A,405,56783557.14
12/13/2022,Expense,Figma,,Tools & Subscription - G&A,405,56783962.14
12/13/2022,Expense,Framer,,Tools & Subscription - G&A,9.87,56783972.01
12/13/2022,Expense,Intercom,Balapavan Tirumani,Credit Card - Ramp,176,56784148.01
12/13/2022,Expense,Barnes & Noble,Chad Blumenthal,Credit Card - Ramp,33.35,56784181.36
12/13/2022,Expense,Framer,Harvey Spector,Credit Card - Ramp,9.87,56784191.23
12/13/2022,Expense,Intercom,,Tools & Subscription - G&A,176,56784367.23
12/13/2022,Expense,Vercel,Harris Jose,Credit Card - Ramp,140,56784507.23
12/13/2022,Expense,Barnes & Noble,,General business expenses:Memberships & subscriptions,33.35,56784540.58
12/13/2022,Expense,Figma,Mike ross,Credit Card - Ramp,405,56784945.58
12/13/2022,Expense,Mtw,,Tools & Subscription - G&A,31.9,56784977.48
12/13/2022,Expense,Vercel,,Tools & Subscription - G&A,140,56785117.48
12/13/2022,Expense,Mtw,Chris George,Credit Card - Ramp,31.9,56785149.38
12/13/2022,Expense,Framer,Harvey Spector,Credit Card - Ramp,9.87,56785159.25
12/13/2022,Expense,Vercel,Harris Jose,Credit Card - Ramp,140,56785299.25
12/13/2022,Expense,Cuckoo Callay,Mike ross,Credit Card - Ramp,12.45,56785311.7
12/13/2022,Expense,Framer,,Tools & Subscription - G&A,9.87,56785321.57
12/13/2022,Expense,Vercel,,Tools & Subscription - G&A,140,56785461.57
12/13/2022,Expense,Cuckoo Callay,Mike ross,Meals & Entertainment,12.45,56785474.02
12/13/2022,Expense,Intercom,Balapavan Tirumani,Credit Card - Ramp,176,56785650.02
12/13/2022,Expense,Intercom,,Tools & Subscription - G&A,176,56785826.02
12/13/2022,Expense,Cuckoo Callay,Mike ross,Credit Card - Ramp,12.45,56785838.47
12/13/2022,Expense,Barnes & Noble,,General business expenses:Memberships & subscriptions,33.35,56785871.82
12/13/2022,Expense,Cuckoo Callay,Mike ross,Meals & Entertainment,12.45,56785884.27
12/13/2022,Expense,Barnes & Noble,,General business expenses:Memberships & subscriptions,33.35,56785917.62
12/14/2022,Expense,Intuit,Harvey Spector,Credit Card - Ramp,55,56785972.62
12/14/2022,Expense,Wolfgang Puck,Mike ross,Credit Card - Ramp,30.65,56786003.27
12/14/2022,Expense,Uber,Mike ross,Credit Card - Ramp,20.87,56786024.14
12/14/2022,Expense,Wolfgang Puck,Mike ross,Meals & Entertainment,30.65,56786054.79
12/14/2022,Expense,Uber,,Travelling Expenses,20.87,56786075.66
12/14/2022,Expense,Intuit,,Tools & Subscription - G&A,55,56786130.66
12/14/2022,Expense,Wolfgang Puck,Mike ross,Meals & Entertainment,30.65,56786161.31
12/14/2022,Expense,Wolfgang Puck,Mike ross,Credit Card - Ramp,30.65,56786191.96
12/14/2022,Expense,Wolfgang Puck,Mike ross,Credit Card - Ramp,30.65,56786222.61
12/14/2022,Expense,Uber,Mike ross,Credit Card - Ramp,20.87,56786243.48
12/14/2022,Expense,Intuit,Harvey Spector,Credit Card - Ramp,55,56786298.48
12/14/2022,Expense,Wolfgang Puck,Mike ross,Credit Card - Ramp,30.65,56786329.13
12/14/2022,Expense,Uber,Mike ross,Credit Card - Ramp,20.87,56786350
12/14/2022,Expense,Uber,,Travelling Expenses,20.87,56786370.87
12/14/2022,Expense,Intuit,,Tools & Subscription - G&A,55,56786425.87
12/14/2022,Expense,Uber,,Travelling Expenses,20.87,56786446.74
12/14/2022,Expense,Wolfgang Puck,Mike ross,Meals & Entertainment,30.65,56786477.39
12/14/2022,Expense,Wolfgang Puck,Mike ross,Meals & Entertainment,30.65,56786508.04
12/14/2022,Expense,Uber,,Travelling Expenses,20.87,56786528.91
12/14/2022,Expense,Intuit,,Tools & Subscription - G&A,55,56786583.91
12/14/2022,Expense,Intuit,,Tools & Subscription - G&A,55,56786638.91
12/14/2022,Expense,Intuit,Harvey Spector,Credit Card - Ramp,55,56786693.91
12/15/2022,Expense,Income Capitals ,Income Capitals ,Account1,9665.63,56796359.54
12/15/2022,Expense,Income Capitals ,Income Capitals ,Account1,9665.63,56806025.17
12/15/2022,Expense,Income Capitals ,Income Capitals ,Account1,9665.63,56815690.8
12/15/2022,Expense,Income Capitals ,Income Capitals ,Contract labor,-9665.63,56806025.17
12/15/2022,Expense,Income Capitals ,Income Capitals ,Contract labor,-9665.63,56796359.54
12/15/2022,Expense,Income Capitals ,Income Capitals ,Account1,9665.63,56806025.17
12/15/2022,Expense,Income Capitals ,Income Capitals ,Contract labor,-9665.63,56796359.54
12/15/2022,Expense,Income Capitals ,Income Capitals ,Contract labor,-9665.63,56786693.91
12/16/2022,Expense,Turkish Airlines,,Travel:Airfare,3.22,56786697.13
12/16/2022,Expense,Linear,,Tools & Subscription - G&A,160,56786857.13
12/16/2022,Expense,Turkish Airlines,Harvey Spector,Credit Card - Ramp,3.22,56786860.35
12/16/2022,Expense,Msw Mumbai Airport Loun Restaurant,Harvey Spector,Meals & Entertainment,45.92,56786906.27
12/16/2022,Expense,Notion Labs,,Tools & Subscription - G&A,52.74,56786959.01
12/16/2022,Expense,Turkish Airlines,,Travel:Airfare,3.22,56786962.23
12/16/2022,Expense,Turkish Airlines,Harvey Spector,Credit Card - Ramp,3.22,56786965.45
12/16/2022,Expense,Linear,Chad Blumenthal,Credit Card - Ramp,160,56787125.45
12/16/2022,Expense,Zapier,,Tools & Subscription - G&A,29.99,56787155.44
12/16/2022,Expense,Msw Mumbai Airport Loun Restaurant,Harvey Spector,Meals & Entertainment,45.92,56787201.36
12/16/2022,Expense,Notion Labs,,Tools & Subscription - G&A,52.74,56787254.1
12/16/2022,Expense,Turkish Airlines,Harvey Spector,Credit Card - Ramp,3.22,56787257.32
12/16/2022,Expense,Notion Labs,Mike ross,Credit Card - Ramp,52.74,56787310.06
12/16/2022,Expense,Zapier,Harvey Spector,Credit Card - Ramp,29.99,56787340.05
12/16/2022,Expense,Msw Mumbai Airport Loun Restaurant,Harvey Spector,Credit Card - Ramp,45.92,56787385.97
12/16/2022,Expense,Turkish Airlines,,Travel:Airfare,3.22,56787389.19
12/16/2022,Expense,Msw Mumbai Airport Loun Restaurant,Harvey Spector,Credit Card - Ramp,45.92,56787435.11
12/16/2022,Expense,Zapier,,Tools & Subscription - G&A,29.99,56787465.1
12/16/2022,Expense,Notion Labs,,Tools & Subscription - G&A,52.74,56787517.84
12/16/2022,Expense,Msw Mumbai Airport Loun Restaurant,Harvey Spector,Credit Card - Ramp,45.92,56787563.76
12/16/2022,Expense,Zapier,Harvey Spector,Credit Card - Ramp,29.99,56787593.75
12/16/2022,Expense,Notion Labs,Mike ross,Credit Card - Ramp,52.74,56787646.49
12/16/2022,Expense,Linear,Chad Blumenthal,Credit Card - Ramp,160,56787806.49
12/16/2022,Expense,Notion Labs,,Tools & Subscription - G&A,52.74,56787859.23
12/16/2022,Expense,Msw Mumbai Airport Loun Restaurant,Harvey Spector,Meals & Entertainment,45.92,56787905.15
12/16/2022,Expense,Zapier,,Tools & Subscription - G&A,29.99,56787935.14
12/16/2022,Expense,Linear,,Tools & Subscription - G&A,160,56788095.14
12/16/2022,Expense,Linear,,Tools & Subscription - G&A,160,56788255.14
12/16/2022,Expense,Zapier,Harvey Spector,Credit Card - Ramp,29.99,56788285.13
12/16/2022,Expense,Notion Labs,Mike ross,Credit Card - Ramp,52.74,56788337.87
12/16/2022,Expense,Msw Mumbai Airport Loun Restaurant,Harvey Spector,Credit Card - Ramp,45.92,56788383.79
12/16/2022,Expense,Linear,Chad Blumenthal,Credit Card - Ramp,160,56788543.79
12/16/2022,Expense,Linear,,Tools & Subscription - G&A,160,56788703.79
12/16/2022,Expense,Zapier,,Tools & Subscription - G&A,29.99,56788733.78
12/16/2022,Expense,Msw Mumbai Airport Loun Restaurant,Harvey Spector,Meals & Entertainment,45.92,56788779.7
12/16/2022,Expense,Turkish Airlines,,Travel:Airfare,3.22,56788782.92
12/17/2022,Expense,Cay Saati,Harvey Spector,Meals & Entertainment,32.9,56788815.82
12/17/2022,Expense,Cay Saati,Harvey Spector,Credit Card - Ramp,32.9,56788848.72
12/17/2022,Expense,Cay Saati,Harvey Spector,Credit Card - Ramp,32.9,56788881.62
12/17/2022,Expense,Cay Saati,Harvey Spector,Meals & Entertainment,32.9,56788914.52
12/17/2022,Expense,Cay Saati,Harvey Spector,Credit Card - Ramp,32.9,56788947.42
12/17/2022,Expense,Cay Saati,Harvey Spector,Credit Card - Ramp,32.9,56788980.32
12/17/2022,Expense,Cay Saati,Harvey Spector,Meals & Entertainment,32.9,56789013.22
12/17/2022,Expense,Cay Saati,Harvey Spector,Meals & Entertainment,32.9,56789046.12
12/18/2022,Expense,Superhuman,,Professional Service Charges,30,56789076.12
12/18/2022,Expense,Superhuman,Harvey Spector,Credit Card - Ramp,30,56789106.12
12/18/2022,Expense,LinkedIn,Mike ross,Credit Card - Ramp,151.53,56789257.65
12/18/2022,Expense,Superhuman,Harvey Spector,Credit Card - Ramp,30,56789287.65
12/18/2022,Expense,Superhuman,Harvey Spector,Credit Card - Ramp,30,56789317.65
12/18/2022,Expense,Superhuman,,Professional Service Charges,30,56789347.65
12/18/2022,Expense,LinkedIn,Mike ross,Credit Card - Ramp,151.53,56789499.18
12/18/2022,Expense,LinkedIn,Mike ross,Credit Card - Ramp,151.53,56789650.71
12/18/2022,Expense,LinkedIn,,Tools & Subscription - G&A,151.53,56789802.24
12/18/2022,Expense,Superhuman,,Professional Service Charges,30,56789832.24
12/18/2022,Expense,LinkedIn,,Tools & Subscription - G&A,151.53,56789983.77
12/18/2022,Expense,Superhuman,,Professional Service Charges,30,56790013.77
12/18/2022,Expense,Superhuman,Harvey Spector,Credit Card - Ramp,30,56790043.77
12/18/2022,Expense,LinkedIn,,Tools & Subscription - G&A,151.53,56790195.3
12/18/2022,Expense,LinkedIn,,Tools & Subscription - G&A,151.53,56790346.83
12/19/2022,Expense,LinkedIn,Harvey Spector,Credit Card - Ramp,25.62,56790372.45
12/19/2022,Expense,Uber,Mike ross,Credit Card - Ramp,8.99,56790381.44
12/19/2022,Expense,Reuben Hills,Mike ross,Credit Card - Ramp,43.49,56790424.93
12/19/2022,Expense,LinkedIn,,Tools & Subscription - G&A,25.62,56790450.55
12/19/2022,Expense,Uber,,Travelling Expenses,8.99,56790459.54
12/19/2022,Expense,Uber,,Travelling Expenses,8.99,56790468.53
12/19/2022,Expense,Uber,,Travelling Expenses,8.99,56790477.52
12/19/2022,Expense,Reuben Hills,Mike ross,Credit Card - Ramp,43.49,56790521.01
12/19/2022,Expense,Reuben Hills,Mike ross,Credit Card - Ramp,43.49,56790564.5
12/19/2022,Expense,LinkedIn,,Tools & Subscription - G&A,25.62,56790590.12
12/19/2022,Expense,Uber,Mike ross,Credit Card - Ramp,8.99,56790599.11
12/19/2022,Expense,Reuben Hills,Mike ross,Meals & Entertainment,43.49,56790642.6
12/19/2022,Expense,Uber,Mike ross,Credit Card - Ramp,8.99,56790651.59
12/19/2022,Expense,LinkedIn,,Tools & Subscription - G&A,25.62,56790677.21
12/19/2022,Expense,Reuben Hills,Mike ross,Meals & Entertainment,43.49,56790720.7
12/19/2022,Expense,Uber,,Travelling Expenses,8.99,56790729.69
12/19/2022,Expense,Reuben Hills,Mike ross,Meals & Entertainment,43.49,56790773.18
12/19/2022,Expense,Reuben Hills,Mike ross,Meals & Entertainment,43.49,56790816.67
12/19/2022,Expense,LinkedIn,Harvey Spector,Credit Card - Ramp,25.62,56790842.29
12/19/2022,Expense,Reuben Hills,Mike ross,Credit Card - Ramp,43.49,56790885.78
12/19/2022,Expense,LinkedIn,Harvey Spector,Credit Card - Ramp,25.62,56790911.4
12/19/2022,Expense,LinkedIn,,Tools & Subscription - G&A,25.62,56790937.02
12/20/2022,Expense,Bourke Street Bakery,Mike ross,Meals & Entertainment,8.67,56790945.69
12/20/2022,Credit Card Payment,,RAMP STATEMENT,Credit Card - Ramp,-4144.19,56786801.5
12/20/2022,Expense,LinkedIn,,Tools & Subscription - G&A,119.93,56786921.43
12/20/2022,Expense,Bourke Street Bakery,Mike ross,Meals & Entertainment,8.67,56786930.1
12/20/2022,Expense,King,Harvey Spector,Meals & Entertainment,8.05,56786938.15
12/20/2022,Expense,Bourke Street Bakery,Mike ross,Meals & Entertainment,8.67,56786946.82
12/20/2022,Expense,LinkedIn,Niteesha Ravela,Credit Card - Ramp,119.93,56787066.75
12/20/2022,Credit Card Payment,,RAMP STATEMENT,Account1,-4144.19,56782922.56
12/20/2022,Expense,Artificer,,Meals & Entertainment,6.53,56782929.09
12/20/2022,Expense,Artificer,,Meals & Entertainment,6.53,56782935.62
12/20/2022,Expense,LinkedIn,Niteesha Ravela,Credit Card - Ramp,119.93,56783055.55
12/20/2022,Expense,LinkedIn,Niteesha Ravela,Credit Card - Ramp,119.93,56783175.48
12/20/2022,Expense,Artificer,,Meals & Entertainment,6.53,56783182.01
12/20/2022,Expense,King,Harvey Spector,Credit Card - Ramp,8.05,56783190.06
12/20/2022,Expense,Bourke Street Bakery,Mike ross,Credit Card - Ramp,8.67,56783198.73
12/20/2022,Expense,Artificer,,Meals & Entertainment,6.53,56783205.26
12/20/2022,Credit Card Payment,,RAMP STATEMENT,Credit Card - Ramp,-4144.19,56779061.07
12/20/2022,Expense,LinkedIn,,Tools & Subscription - G&A,119.93,56779181
12/20/2022,Expense,King,Harvey Spector,Meals & Entertainment,8.05,56779189.05
12/20/2022,Expense,LinkedIn,,Tools & Subscription - G&A,119.93,56779308.98
12/20/2022,Credit Card Payment,,RAMP STATEMENT,Credit Card - Ramp,-4144.19,56775164.79
12/20/2022,Credit Card Payment,,RAMP STATEMENT,Account1,-4144.19,56771020.6
12/20/2022,Expense,Bourke Street Bakery,Mike ross,Meals & Entertainment,8.67,56771029.27
12/20/2022,Expense,Artificer,Mike ross,Credit Card - Ramp,6.53,56771035.8
12/20/2022,Expense,Bourke Street Bakery,Mike ross,Credit Card - Ramp,8.67,56771044.47
12/20/2022,Credit Card Payment,,RAMP STATEMENT,Credit Card - Ramp,-4144.19,56766900.28
12/20/2022,Expense,King,Harvey Spector,Meals & Entertainment,8.05,56766908.33
12/20/2022,Expense,King,Harvey Spector,Credit Card - Ramp,8.05,56766916.38
12/20/2022,Expense,Bourke Street Bakery,Mike ross,Credit Card - Ramp,8.67,56766925.05
12/20/2022,Expense,Artificer,Mike ross,Credit Card - Ramp,6.53,56766931.58
12/20/2022,Expense,Bourke Street Bakery,Mike ross,Credit Card - Ramp,8.67,56766940.25
12/20/2022,Expense,Artificer,Mike ross,Credit Card - Ramp,6.53,56766946.78
12/20/2022,Expense,King,Harvey Spector,Credit Card - Ramp,8.05,56766954.83
12/20/2022,Credit Card Payment,,RAMP STATEMENT,Account1,-4144.19,56762810.64
12/20/2022,Expense,Artificer,Mike ross,Credit Card - Ramp,6.53,56762817.17
12/20/2022,Expense,LinkedIn,,Tools & Subscription - G&A,119.93,56762937.1
12/20/2022,Credit Card Payment,,RAMP STATEMENT,Account1,-4144.19,56758792.91
12/20/2022,Expense,King,Harvey Spector,Meals & Entertainment,8.05,56758800.96
12/20/2022,Expense,King,Harvey Spector,Credit Card - Ramp,8.05,56758809.01
12/21/2022,Expense,Bourke Street Bakery,Mike ross,Meals & Entertainment,9.54,56758818.55
12/21/2022,Expense,Bourke Street Bakery,Mike ross,Credit Card - Ramp,9.54,56758828.09
12/21/2022,Expense,Bourke Street Bakery,Mike ross,Credit Card - Ramp,9.54,56758837.63
12/21/2022,Expense,Bourke Street Bakery,Mike ross,Meals & Entertainment,9.54,56758847.17
12/21/2022,Expense,Bourke Street Bakery,Mike ross,Credit Card - Ramp,9.54,56758856.71
12/21/2022,Expense,Bourke Street Bakery,Mike ross,Credit Card - Ramp,9.54,56758866.25
12/21/2022,Expense,Bourke Street Bakery,Mike ross,Meals & Entertainment,9.54,56758875.79
12/21/2022,Expense,Bourke Street Bakery,Mike ross,Meals & Entertainment,9.54,56758885.33
12/22/2022,Expense,Artificer,Mike ross,Credit Card - Ramp,7.07,56758892.4
12/22/2022,Expense,Cuckoo Callay,Mike ross,Credit Card - Ramp,23.23,56758915.63
12/22/2022,Expense,Uber,Mike ross,Credit Card - Ramp,13.58,56758929.21
12/22/2022,Expense,Vimcal,,Tools & Subscription - G&A,15,56758944.21
12/22/2022,Expense,Vimcal,Harvey Spector,Credit Card - Ramp,15,56758959.21
12/22/2022,Expense,Uber,,Travelling Expenses,11.36,56758970.57
12/22/2022,Expense,Artificer,,Meals & Entertainment,7.07,56758977.64
12/22/2022,Expense,Dovetail,,Tools & Subscription - G&A,70,56759047.64
12/22/2022,Expense,Vimcal,,Tools & Subscription - G&A,15,56759062.64
12/22/2022,Expense,Cuckoo Callay,Mike ross,Meals & Entertainment,23.23,56759085.87
12/22/2022,Expense,Artificer,Mike ross,Credit Card - Ramp,7.07,56759092.94
12/22/2022,Expense,Cuckoo Callay,Mike ross,Credit Card - Ramp,23.23,56759116.17
12/22/2022,Expense,Uber,,Travelling Expenses,13.58,56759129.75
12/22/2022,Expense,Vimcal,Harvey Spector,Credit Card - Ramp,15,56759144.75
12/22/2022,Expense,Uber,,Travelling Expenses,11.36,56759156.11
12/22/2022,Expense,Cuckoo Callay,Mike ross,Meals & Entertainment,23.23,56759179.34
12/22/2022,Expense,Vimcal,,Tools & Subscription - G&A,15,56759194.34
12/22/2022,Expense,Dovetail,,Tools & Subscription - G&A,70,56759264.34
12/22/2022,Expense,Dovetail,Harvey Spector,Credit Card - Ramp,70,56759334.34
12/22/2022,Expense,Artificer,Mike ross,Credit Card - Ramp,7.07,56759341.41
12/22/2022,Expense,Cuckoo Callay,Mike ross,Meals & Entertainment,23.23,56759364.64
12/22/2022,Expense,Cuckoo Callay,Mike ross,Credit Card - Ramp,23.23,56759387.87
12/22/2022,Expense,Dovetail,Harvey Spector,Credit Card - Ramp,70,56759457.87
12/22/2022,Expense,Uber,Mike ross,Credit Card - Ramp,13.58,56759471.45
12/22/2022,Expense,Uber,Mike ross,Credit Card - Ramp,11.36,56759482.81
12/22/2022,Expense,Uber,Mike ross,Credit Card - Ramp,13.58,56759496.39
12/22/2022,Expense,Artificer,,Meals & Entertainment,7.07,56759503.46
12/22/2022,Expense,Uber,Mike ross,Credit Card - Ramp,11.36,56759514.82
12/22/2022,Expense,Cuckoo Callay,Mike ross,Meals & Entertainment,23.23,56759538.05
12/22/2022,Expense,Vimcal,,Tools & Subscription - G&A,15,56759553.05
12/22/2022,Expense,Dovetail,,Tools & Subscription - G&A,70,56759623.05
12/22/2022,Expense,Uber,,Travelling Expenses,13.58,56759636.63
12/22/2022,Expense,Artificer,,Meals & Entertainment,7.07,56759643.7
12/22/2022,Expense,Dovetail,Harvey Spector,Credit Card - Ramp,70,56759713.7
12/22/2022,Expense,Uber,,Travelling Expenses,11.36,56759725.06
12/22/2022,Expense,Artificer,Mike ross,Credit Card - Ramp,7.07,56759732.13
12/22/2022,Expense,Cuckoo Callay,Mike ross,Credit Card - Ramp,23.23,56759755.36
12/22/2022,Expense,Artificer,,Meals & Entertainment,7.07,56759762.43
12/22/2022,Expense,Vimcal,Harvey Spector,Credit Card - Ramp,15,56759777.43
12/22/2022,Expense,Uber,,Travelling Expenses,11.36,56759788.79
12/22/2022,Expense,Dovetail,,Tools & Subscription - G&A,70,56759858.79
12/22/2022,Expense,Uber,,Travelling Expenses,13.58,56759872.37
12/22/2022,Expense,Uber,Mike ross,Credit Card - Ramp,11.36,56759883.73
12/22/2022,Expense,Uber,,Travelling Expenses,13.58,56759897.31
12/23/2022,Expense,Cuckoo Callay,Mike ross,Meals & Entertainment,12.37,56759909.68
12/23/2022,Expense,Superhuman,Mike ross,Credit Card - Ramp,30,56759939.68
12/23/2022,Expense,Super,,Tools & Subscription - G&A,12,56759951.68
12/23/2022,Expense,Superhuman,,Professional Service Charges,30,56759981.68
12/23/2022,Expense,Zoom,,Tools & Subscription - G&A,14.13,56759995.81
12/23/2022,Expense,Superhuman,Mike ross,Credit Card - Ramp,30,56760025.81
12/23/2022,Expense,Cuckoo Callay,Mike ross,Credit Card - Ramp,12.37,56760038.18
12/23/2022,Expense,Super,,Tools & Subscription - G&A,12,56760050.18
12/23/2022,Expense,Superhuman,,Professional Service Charges,30,56760080.18
12/23/2022,Expense,Zoom,,Tools & Subscription - G&A,14.13,56760094.31
12/23/2022,Expense,Superhuman,,Professional Service Charges,30,56760124.31
12/23/2022,Expense,Super,,Tools & Subscription - G&A,12,56760136.31
12/23/2022,Expense,Zoom,Amani Shariff,Credit Card - Ramp,14.13,56760150.44
12/23/2022,Expense,Cuckoo Callay,Mike ross,Meals & Entertainment,12.37,56760162.81
12/23/2022,Expense,Zoom,Amani Shariff,Credit Card - Ramp,14.13,56760176.94
12/23/2022,Expense,Cuckoo Callay,Mike ross,Meals & Entertainment,12.37,56760189.31
12/23/2022,Expense,Super,Harvey Spector,Credit Card - Ramp,12,56760201.31
12/23/2022,Expense,Cuckoo Callay,Mike ross,Meals & Entertainment,12.37,56760213.68
12/23/2022,Expense,Super,,Tools & Subscription - G&A,12,56760225.68
12/23/2022,Expense,Superhuman,,Professional Service Charges,30,56760255.68
12/23/2022,Expense,Cuckoo Callay,Mike ross,Credit Card - Ramp,12.37,56760268.05
12/23/2022,Expense,Super,Harvey Spector,Credit Card - Ramp,12,56760280.05
12/23/2022,Expense,Super,Harvey Spector,Credit Card - Ramp,12,56760292.05
12/23/2022,Expense,Cuckoo Callay,Mike ross,Credit Card - Ramp,12.37,56760304.42
12/23/2022,Expense,Superhuman,Mike ross,Credit Card - Ramp,30,56760334.42
12/23/2022,Expense,Superhuman,Mike ross,Credit Card - Ramp,30,56760364.42
12/23/2022,Expense,Zoom,,Tools & Subscription - G&A,14.13,56760378.55
12/23/2022,Expense,Cuckoo Callay,Mike ross,Credit Card - Ramp,12.37,56760390.92
12/23/2022,Expense,Zoom,,Tools & Subscription - G&A,14.13,56760405.05
12/23/2022,Expense,Zoom,Amani Shariff,Credit Card - Ramp,14.13,56760419.18
12/24/2022,Expense,Berkelouw Paddington,,General business expenses:Memberships & subscriptions,36.99,56760456.17
12/24/2022,Expense,Taxis On Booking,Harvey Spector,Credit Card - Ramp,41.25,56760497.42
12/24/2022,Expense,Berkelouw Paddington,Mike ross,Credit Card - Ramp,36.99,56760534.41
12/24/2022,Expense,Benedict Evans,Harvey Spector,Credit Card - Ramp,10,56760544.41
12/24/2022,Expense,Benedict Evans,Harvey Spector,Credit Card - Ramp,10,56760554.41
12/24/2022,Expense,Taxis On Booking,,Travelling Expenses,41.25,56760595.66
12/24/2022,Expense,Berkelouw Paddington,Mike ross,Credit Card - Ramp,36.99,56760632.65
12/24/2022,Expense,Ui.Dev,Anik Das,Credit Card - Ramp,78,56760710.65
12/24/2022,Expense,Ui.Dev,,Tools & Subscription - G&A,78,56760788.65
12/24/2022,Expense,Benedict Evans,Harvey Spector,Professional Service Charges,10,56760798.65
12/24/2022,Expense,CleanShot X,,Tools & Subscription - G&A,105.6,56760904.25
12/24/2022,Expense,Taxis On Booking,Harvey Spector,Credit Card - Ramp,41.25,56760945.5
12/24/2022,Expense,CleanShot X,Mike ross,Credit Card - Ramp,105.6,56761051.1
12/24/2022,Expense,Ui.Dev,,Tools & Subscription - G&A,78,56761129.1
12/24/2022,Expense,Taxis On Booking,,Travelling Expenses,41.25,56761170.35
12/24/2022,Expense,Ui.Dev,Anik Das,Credit Card - Ramp,78,56761248.35
12/24/2022,Expense,Berkelouw Paddington,,General business expenses:Memberships & subscriptions,36.99,56761285.34
12/24/2022,Expense,Berkelouw Paddington,,General business expenses:Memberships & subscriptions,36.99,56761322.33
12/24/2022,Expense,CleanShot X,,Tools & Subscription - G&A,105.6,56761427.93
12/24/2022,Expense,Berkelouw Paddington,Mike ross,Credit Card - Ramp,36.99,56761464.92
12/24/2022,Expense,Benedict Evans,Harvey Spector,Credit Card - Ramp,10,56761474.92
12/24/2022,Expense,CleanShot X,Mike ross,Credit Card - Ramp,105.6,56761580.52
12/24/2022,Expense,Ui.Dev,Anik Das,Credit Card - Ramp,78,56761658.52
12/24/2022,Expense,Berkelouw Paddington,Mike ross,Credit Card - Ramp,36.99,56761695.51
12/24/2022,Expense,CleanShot X,,Tools & Subscription - G&A,105.6,56761801.11
12/24/2022,Expense,Taxis On Booking,,Travelling Expenses,41.25,56761842.36
12/24/2022,Expense,Benedict Evans,Harvey Spector,Professional Service Charges,10,56761852.36
12/24/2022,Expense,Taxis On Booking,Harvey Spector,Credit Card - Ramp,41.25,56761893.61
12/24/2022,Expense,Ui.Dev,,Tools & Subscription - G&A,78,56761971.61
12/24/2022,Expense,Berkelouw Paddington,,General business expenses:Memberships & subscriptions,36.99,56762008.6
12/24/2022,Expense,Benedict Evans,Harvey Spector,Professional Service Charges,10,56762018.6
12/24/2022,Expense,Ui.Dev,,Tools & Subscription - G&A,78,56762096.6
12/24/2022,Expense,CleanShot X,,Tools & Subscription - G&A,105.6,56762202.2
12/24/2022,Expense,Benedict Evans,Harvey Spector,Professional Service Charges,10,56762212.2
12/24/2022,Expense,CleanShot X,Mike ross,Credit Card - Ramp,105.6,56762317.8
12/24/2022,Expense,Taxis On Booking,,Travelling Expenses,41.25,56762359.05
12/24/2022,Expense,Benedict Evans,Harvey Spector,Credit Card - Ramp,10,56762369.05
12/25/2022,Expense,Airalo,,Utilities:Internet & TV services,16.65,56762385.7
12/25/2022,Expense,Zoom,,Tools & Subscription - G&A,14.99,56762400.69
12/25/2022,Expense,The New York Times,,General business expenses:Memberships & subscriptions,1.35,56762402.04
12/25/2022,Expense,Bolt.Eu O 2201181557,Harvey Spector,Credit Card - Ramp,10.45,56762412.49
12/25/2022,Expense,The New York Times,Mike ross,Credit Card - Ramp,1.35,56762413.84
12/25/2022,Expense,Airalo,Harvey Spector,Credit Card - Ramp,16.65,56762430.49
12/25/2022,Expense,Uber,Mike ross,Credit Card - Ramp,14.47,56762444.96
12/25/2022,Expense,Airalo,Harvey Spector,Credit Card - Ramp,16.65,56762461.61
12/25/2022,Expense,Bolt.Eu O 2201181557,,Travelling Expenses,10.45,56762472.06
12/25/2022,Expense,Miro,Mike ross,Credit Card - Ramp,90,56762562.06
12/25/2022,Expense,Uber,,Travelling Expenses,14.47,56762576.53
12/25/2022,Expense,Miro,,Tools & Subscription - G&A,90,56762666.53
12/25/2022,Expense,Miro,,Tools & Subscription - G&A,90,56762756.53
12/25/2022,Expense,Bolt.Eu O 2201181557,,Travelling Expenses,10.45,56762766.98
12/25/2022,Expense,Airalo,,Utilities:Internet & TV services,16.65,56762783.63
12/25/2022,Expense,Zoom,,Tools & Subscription - G&A,14.99,56762798.62
12/25/2022,Expense,Zoom,Chad Blumenthal,Credit Card - Ramp,14.99,56762813.61
12/25/2022,Expense,The New York Times,,General business expenses:Memberships & subscriptions,1.35,56762814.96
12/25/2022,Expense,The New York Times,Mike ross,Credit Card - Ramp,1.35,56762816.31
12/25/2022,Expense,Bolt.Eu O 2201181557,Harvey Spector,Credit Card - Ramp,10.45,56762826.76
12/25/2022,Expense,Uber,Mike ross,Credit Card - Ramp,14.47,56762841.23
12/25/2022,Expense,Uber,Mike ross,Credit Card - Ramp,14.47,56762855.7
12/25/2022,Expense,Zoom,Chad Blumenthal,Credit Card - Ramp,14.99,56762870.69
12/25/2022,Expense,Bolt.Eu O 2201181557,,Travelling Expenses,10.45,56762881.14
12/25/2022,Expense,The New York Times,Mike ross,Credit Card - Ramp,1.35,56762882.49
12/25/2022,Expense,The New York Times,,General business expenses:Memberships & subscriptions,1.35,56762883.84
12/25/2022,Expense,Zoom,Chad Blumenthal,Credit Card - Ramp,14.99,56762898.83
12/25/2022,Expense,Uber,,Travelling Expenses,14.47,56762913.3
12/25/2022,Expense,Miro,,Tools & Subscription - G&A,90,56763003.3
12/25/2022,Expense,Uber,,Travelling Expenses,14.47,56763017.77
12/25/2022,Expense,Bolt.Eu O 2201181557,Harvey Spector,Credit Card - Ramp,10.45,56763028.22
12/25/2022,Expense,Bolt.Eu O 2201181557,,Travelling Expenses,10.45,56763038.67
12/25/2022,Expense,The New York Times,Mike ross,Credit Card - Ramp,1.35,56763040.02
12/25/2022,Expense,Zoom,,Tools & Subscription - G&A,14.99,56763055.01
12/25/2022,Expense,Zoom,,Tools & Subscription - G&A,14.99,56763070
12/25/2022,Expense,The New York Times,,General business expenses:Memberships & subscriptions,1.35,56763071.35
12/25/2022,Expense,Miro,Mike ross,Credit Card - Ramp,90,56763161.35
12/25/2022,Expense,Airalo,,Utilities:Internet & TV services,16.65,56763178
12/25/2022,Expense,Miro,,Tools & Subscription - G&A,90,56763268
12/25/2022,Expense,Uber,,Travelling Expenses,14.47,56763282.47
12/25/2022,Expense,Airalo,Harvey Spector,Credit Card - Ramp,16.65,56763299.12
12/25/2022,Expense,Miro,Mike ross,Credit Card - Ramp,90,56763389.12
12/25/2022,Expense,Airalo,,Utilities:Internet & TV services,16.65,56763405.77
12/26/2022,Expense,Aga's Restaurant & Catering,Harvey Spector,Credit Card - Ramp,55.9,56763461.67
12/26/2022,Expense,Bolt.Eu O 2201181557,Harvey Spector,Credit Card - Ramp,7.52,56763469.19
12/26/2022,Expense,Aga's Restaurant & Catering,Harvey Spector,Meals & Entertainment,55.9,56763525.09
12/26/2022,Expense,Aga's Restaurant & Catering,Harvey Spector,Credit Card - Ramp,55.9,56763580.99
12/26/2022,Expense,Bolt.Eu O 2201181557,,Travelling Expenses,7.52,56763588.51
12/26/2022,Expense,Bolt.Eu O 2201181557,Harvey Spector,Credit Card - Ramp,2.41,56763590.92
12/26/2022,Expense,Bolt.Eu O 2201181557,,Travelling Expenses,2.71,56763593.63
12/26/2022,Expense,Bolt.Eu O 2201181557,,Travelling Expenses,2.71,56763596.34
12/26/2022,Expense,"Educative, Inc.",Kajal Dalai,Credit Card - Ramp,163.17,56763759.51
12/26/2022,Expense,Bolt.Eu O 2201181557,,Travelling Expenses,2.41,56763761.92
12/26/2022,Expense,Aga's Restaurant & Catering,Harvey Spector,Meals & Entertainment,55.9,56763817.82
12/26/2022,Expense,Bolt.Eu O 2201181557,,Travelling Expenses,7.52,56763825.34
12/26/2022,Expense,Bolt.Eu O 2201181557,,Travelling Expenses,7.52,56763832.86
12/26/2022,Expense,Aga's Restaurant & Catering,Harvey Spector,Meals & Entertainment,55.9,56763888.76
12/26/2022,Expense,Bolt.Eu O 2201181557,Harvey Spector,Credit Card - Ramp,2.71,56763891.47
12/26/2022,Expense,Bolt.Eu O 2201181557,,Travelling Expenses,2.41,56763893.88
12/26/2022,Expense,"Educative, Inc.",,Tools & Subscription - G&A,163.17,56764057.05
12/26/2022,Expense,"Educative, Inc.",,Tools & Subscription - G&A,163.17,56764220.22
12/26/2022,Expense,"Educative, Inc.",,Tools & Subscription - G&A,163.17,56764383.39
12/26/2022,Expense,"Educative, Inc.",Kajal Dalai,Credit Card - Ramp,163.17,56764546.56
12/26/2022,Expense,Bolt.Eu O 2201181557,Harvey Spector,Credit Card - Ramp,7.52,56764554.08
12/26/2022,Expense,Bolt.Eu O 2201181557,,Travelling Expenses,2.71,56764556.79
12/26/2022,Expense,Aga's Restaurant & Catering,Harvey Spector,Credit Card - Ramp,55.9,56764612.69
12/26/2022,Expense,Bolt.Eu O 2201181557,Harvey Spector,Credit Card - Ramp,7.52,56764620.21
12/26/2022,Expense,"Educative, Inc.",Kajal Dalai,Credit Card - Ramp,163.17,56764783.38
12/26/2022,Expense,Bolt.Eu O 2201181557,,Travelling Expenses,2.71,56764786.09
12/26/2022,Expense,"Educative, Inc.",,Tools & Subscription - G&A,163.17,56764949.26
12/26/2022,Expense,Bolt.Eu O 2201181557,,Travelling Expenses,2.41,56764951.67
12/26/2022,Expense,Bolt.Eu O 2201181557,Harvey Spector,Credit Card - Ramp,2.41,56764954.08
12/26/2022,Expense,Bolt.Eu O 2201181557,,Travelling Expenses,7.52,56764961.6
12/26/2022,Expense,Bolt.Eu O 2201181557,Harvey Spector,Credit Card - Ramp,2.41,56764964.01
12/26/2022,Expense,Bolt.Eu O 2201181557,Harvey Spector,Credit Card - Ramp,2.71,56764966.72
12/26/2022,Expense,Bolt.Eu O 2201181557,Harvey Spector,Credit Card - Ramp,2.71,56764969.43
12/26/2022,Expense,Aga's Restaurant & Catering,Harvey Spector,Credit Card - Ramp,55.9,56765025.33
12/26/2022,Expense,Bolt.Eu O 2201181557,,Travelling Expenses,2.41,56765027.74
12/26/2022,Expense,Aga's Restaurant & Catering,Harvey Spector,Meals & Entertainment,55.9,56765083.64
12/27/2022,Expense,Sentry,Balapavan Tirumani,Credit Card - Ramp,29,56765112.64
12/27/2022,Expense,Sentry,,Tools & Subscription - G&A,29,56765141.64
12/27/2022,Expense,Sentry,Balapavan Tirumani,Credit Card - Ramp,29,56765170.64
12/27/2022,Expense,Sendinblue,,Tools & Subscription - G&A,55.78,56765226.42
12/27/2022,Expense,Sentry,,Tools & Subscription - G&A,29,56765255.42
12/27/2022,Expense,Sendinblue,Balapavan Tirumani,Credit Card - Ramp,55.78,56765311.2
12/27/2022,Expense,Sendinblue,Balapavan Tirumani,Credit Card - Ramp,55.78,56765366.98
12/27/2022,Expense,Sendinblue,,Tools & Subscription - G&A,55.78,56765422.76
12/27/2022,Expense,Splitbee,,Tools & Subscription - G&A,16.52,56765439.28
12/27/2022,Expense,Splitbee,Harris Jose,Credit Card - Ramp,16.52,56765455.8
12/27/2022,Expense,Bodbe Monastery,Harvey Spector,Meals & Entertainment,2.07,56765457.87
12/27/2022,Expense,Bodbe Monastery,Harvey Spector,Credit Card - Ramp,2.07,56765459.94
12/27/2022,Expense,Splitbee,,Tools & Subscription - G&A,16.52,56765476.46
12/27/2022,Expense,Bodbe Monastery,Harvey Spector,Credit Card - Ramp,2.07,56765478.53
12/27/2022,Expense,Sentry,,Tools & Subscription - G&A,29,56765507.53
12/27/2022,Expense,Sendinblue,Balapavan Tirumani,Credit Card - Ramp,55.78,56765563.31
12/27/2022,Expense,Sentry,Balapavan Tirumani,Credit Card - Ramp,29,56765592.31
12/27/2022,Expense,Bodbe Monastery,Harvey Spector,Credit Card - Ramp,2.07,56765594.38
12/27/2022,Expense,Sendinblue,,Tools & Subscription - G&A,55.78,56765650.16
12/27/2022,Expense,Splitbee,,Tools & Subscription - G&A,16.52,56765666.68
12/27/2022,Expense,Bodbe Monastery,Harvey Spector,Credit Card - Ramp,2.07,56765668.75
12/27/2022,Expense,Sentry,,Tools & Subscription - G&A,29,56765697.75
12/27/2022,Expense,Bodbe Monastery,Harvey Spector,Meals & Entertainment,2.07,56765699.82
12/27/2022,Expense,Sendinblue,,Tools & Subscription - G&A,55.78,56765755.6
12/27/2022,Expense,Splitbee,Harris Jose,Credit Card - Ramp,16.52,56765772.12
12/27/2022,Expense,Splitbee,,Tools & Subscription - G&A,16.52,56765788.64
12/27/2022,Expense,Bodbe Monastery,Harvey Spector,Meals & Entertainment,2.07,56765790.71
12/27/2022,Expense,Splitbee,Harris Jose,Credit Card - Ramp,16.52,56765807.23
12/27/2022,Expense,Bodbe Monastery,Harvey Spector,Meals & Entertainment,2.07,56765809.3
12/28/2022,Expense,Uber Eats,Mike ross,Meals & Entertainment,11.52,56765820.82
12/28/2022,Expense,Uber Eats,Mike ross,Meals & Entertainment,16.06,56765836.88
12/28/2022,Expense,Uber Eats,Mike ross,Credit Card - Ramp,16.06,56765852.94
12/28/2022,Expense,Uber Eats,Mike ross,Credit Card - Ramp,11.52,56765864.46
12/28/2022,Expense,Uber Eats,Mike ross,Meals & Entertainment,16.06,56765880.52
12/28/2022,Expense,Baraconi,,Travel:Hotels,201.16,56766081.68
12/28/2022,Expense,Google Domains,,Tools & Subscription - G&A,13.42,56766095.1
12/28/2022,Expense,Uber Eats,Mike ross,Meals & Entertainment,11.52,56766106.62
12/28/2022,Expense,Baraconi,,Travel:Hotels,201.16,56766307.78
12/28/2022,Expense,Google Domains,,Tools & Subscription - G&A,13.42,56766321.2
12/28/2022,Expense,Google Domains,Mike ross,Credit Card - Ramp,13.42,56766334.62
12/28/2022,Expense,Google Domains,,Tools & Subscription - G&A,13.42,56766348.04
12/28/2022,Expense,Uber Eats,Mike ross,Meals & Entertainment,16.06,56766364.1
12/28/2022,Expense,Baraconi,,Travel:Hotels,201.16,56766565.26
12/28/2022,Expense,Uber Eats,Mike ross,Credit Card - Ramp,11.52,56766576.78
12/28/2022,Expense,Uber Eats,Mike ross,Meals & Entertainment,11.52,56766588.3
12/28/2022,Expense,Uber Eats,Mike ross,Meals & Entertainment,11.52,56766599.82
12/28/2022,Expense,Google Domains,,Tools & Subscription - G&A,13.42,56766613.24
12/28/2022,Expense,Baraconi,,Travel:Hotels,201.16,56766814.4
12/28/2022,Expense,Uber Eats,Mike ross,Credit Card - Ramp,16.06,56766830.46
12/28/2022,Expense,Uber Eats,Mike ross,Credit Card - Ramp,16.06,56766846.52
12/28/2022,Expense,Uber Eats,Mike ross,Meals & Entertainment,16.06,56766862.58
12/28/2022,Expense,Uber Eats,Mike ross,Credit Card - Ramp,11.52,56766874.1
12/28/2022,Expense,Baraconi,Harvey Spector,Credit Card - Ramp,201.16,56767075.26
12/28/2022,Expense,Baraconi,Harvey Spector,Credit Card - Ramp,201.16,56767276.42
12/28/2022,Expense,Uber Eats,Mike ross,Credit Card - Ramp,11.52,56767287.94
12/28/2022,Expense,Uber Eats,Mike ross,Credit Card - Ramp,16.06,56767304
12/28/2022,Expense,Google Domains,Mike ross,Credit Card - Ramp,13.42,56767317.42
12/28/2022,Expense,Baraconi,Harvey Spector,Credit Card - Ramp,201.16,56767518.58
12/28/2022,Expense,Google Domains,Mike ross,Credit Card - Ramp,13.42,56767532
12/29/2022,Expense,Netlify,Balapavan Tirumani,Credit Card - Ramp,38,56767570
12/29/2022,Expense,Sheraton Grand Tbilisi Metechi Palace,,Travel:Hotels,380.23,56767950.23
12/29/2022,Expense,Bolt,Harvey Spector,Credit Card - Ramp,26.31,56767976.54
12/29/2022,Expense,Rolf's,Harvey Spector,Meals & Entertainment,6.6,56767983.14
12/29/2022,Expense,Sheraton Grand Tbilisi Metechi Palace,,Travel:Hotels,380.23,56768363.37
12/29/2022,Expense,Bolt,,Travelling Expenses,26.31,56768389.68
12/29/2022,Expense,Netlify,,Tools & Subscription - G&A,38,56768427.68
12/29/2022,Expense,Sheraton Grand Tbilisi Metechi Palace,Harvey Spector,Credit Card - Ramp,380.23,56768807.91
12/29/2022,Expense,Netlify,Balapavan Tirumani,Credit Card - Ramp,38,56768845.91
12/29/2022,Expense,Ktw Tours Llc,Harvey Spector,Credit Card - Ramp,23.64,56768869.55
12/29/2022,Expense,Sheraton Grand Tbilisi Metechi Palace,Harvey Spector,Credit Card - Ramp,380.23,56769249.78
12/29/2022,Expense,Ktw Tours Llc,,Travel:Hotels,23.64,56769273.42
12/29/2022,Expense,Ktw Tours Llc,Harvey Spector,Credit Card - Ramp,23.64,56769297.06
12/29/2022,Expense,Ktw Tours Llc,Harvey Spector,Credit Card - Ramp,23.64,56769320.7
12/29/2022,Expense,Rolf's,Harvey Spector,Credit Card - Ramp,6.6,56769327.3
12/29/2022,Expense,Bolt,,Travelling Expenses,26.31,56769353.61
12/29/2022,Expense,Rolf's,Harvey Spector,Meals & Entertainment,6.6,56769360.21
12/29/2022,Expense,Netlify,,Tools & Subscription - G&A,38,56769398.21
12/29/2022,Expense,Bolt,,Travelling Expenses,26.31,56769424.52
12/29/2022,Expense,Netlify,Balapavan Tirumani,Credit Card - Ramp,38,56769462.52
12/29/2022,Expense,Ktw Tours Llc,,Travel:Hotels,23.64,56769486.16
12/29/2022,Expense,Rolf's,Harvey Spector,Credit Card - Ramp,6.6,56769492.76
12/29/2022,Expense,Sheraton Grand Tbilisi Metechi Palace,,Travel:Hotels,380.23,56769872.99
12/29/2022,Expense,Bolt,Harvey Spector,Credit Card - Ramp,26.31,56769899.3
12/29/2022,Expense,Ktw Tours Llc,,Travel:Hotels,23.64,56769922.94
12/29/2022,Expense,Sheraton Grand Tbilisi Metechi Palace,,Travel:Hotels,380.23,56770303.17
12/29/2022,Expense,Rolf's,Harvey Spector,Meals & Entertainment,6.6,56770309.77
12/29/2022,Expense,Netlify,,Tools & Subscription - G&A,38,56770347.77
12/29/2022,Expense,Bolt,Harvey Spector,Credit Card - Ramp,26.31,56770374.08
12/29/2022,Expense,Rolf's,Harvey Spector,Credit Card - Ramp,6.6,56770380.68
12/29/2022,Expense,Bolt,,Travelling Expenses,26.31,56770406.99
12/29/2022,Expense,Rolf's,Harvey Spector,Meals & Entertainment,6.6,56770413.59
12/29/2022,Expense,Sheraton Grand Tbilisi Metechi Palace,Harvey Spector,Credit Card - Ramp,380.23,56770793.82
12/29/2022,Expense,Ktw Tours Llc,,Travel:Hotels,23.64,56770817.46
12/29/2022,Expense,Rolf's,Harvey Spector,Credit Card - Ramp,6.6,56770824.06
12/29/2022,Expense,Netlify,,Tools & Subscription - G&A,38,56770862.06
12/30/2022,Expense,Magti Ltd Restaurant,Harvey Spector,Meals & Entertainment,42.87,56770904.93
12/30/2022,Expense,Magti Ltd Restaurant,Harvey Spector,Meals & Entertainment,42.87,56770947.8
12/30/2022,Expense,Bolt.Eu O 2201181557,,Travelling Expenses,4.95,56770952.75
12/30/2022,Expense,Bolt.Eu O 2201181557,Harvey Spector,Credit Card - Ramp,3.23,56770955.98
12/30/2022,Expense,Bolt,Harvey Spector,Credit Card - Ramp,21.35,56770977.33
12/30/2022,Expense,Bolt.Eu O 2201181557,,Travelling Expenses,2.88,56770980.21
12/30/2022,Expense,Bolt.Eu O 2201181557,Harvey Spector,Credit Card - Ramp,2.88,56770983.09
12/30/2022,Expense,WIN Group,,Meals & Entertainment,2.25,56770985.34
12/30/2022,Expense,Zapier,,Tools & Subscription - G&A,29.99,56771015.33
12/30/2022,Expense,Bolt,,Travelling Expenses,21.35,56771036.68
12/30/2022,Expense,Bolt.Eu O 2201181557,,Travelling Expenses,4.95,56771041.63
12/30/2022,Expense,Bolt.Eu O 2201181557,Harvey Spector,Credit Card - Ramp,3.3,56771044.93
12/30/2022,Expense,WIN Group,,Meals & Entertainment,2.25,56771047.18
12/30/2022,Expense,WIN Group,,Meals & Entertainment,2.25,56771049.43
12/30/2022,Expense,Zapier,,Tools & Subscription - G&A,29.99,56771079.42
12/30/2022,Expense,Bolt,,Travelling Expenses,21.35,56771100.77
12/30/2022,Expense,Bolt.Eu O 2201181557,Harvey Spector,Credit Card - Ramp,4.95,56771105.72
12/30/2022,Expense,Bolt,,Travelling Expenses,21.35,56771127.07
12/30/2022,Expense,Bolt.Eu O 2201181557,Harvey Spector,Credit Card - Ramp,3.3,56771130.37
12/30/2022,Expense,Bolt.Eu O 2201181557,,Travelling Expenses,2.88,56771133.25
12/30/2022,Expense,Bolt.Eu O 2201181557,,Travelling Expenses,3.3,56771136.55
12/30/2022,Expense,Bolt.Eu O 2201181557,,Travelling Expenses,4.95,56771141.5
12/30/2022,Expense,Magti Ltd Restaurant,Harvey Spector,Meals & Entertainment,42.87,56771184.37
12/30/2022,Expense,Zapier,Chad Blumenthal,Credit Card - Ramp,29.99,56771214.36
12/30/2022,Expense,Zapier,Chad Blumenthal,Credit Card - Ramp,29.99,56771244.35
12/30/2022,Expense,Zapier,,Tools & Subscription - G&A,29.99,56771274.34
12/30/2022,Expense,Bolt.Eu O 2201181557,,Travelling Expenses,2.88,56771277.22
12/30/2022,Expense,Bolt.Eu O 2201181557,,Travelling Expenses,3.23,56771280.45
12/30/2022,Expense,Bolt.Eu O 2201181557,Harvey Spector,Credit Card - Ramp,4.95,56771285.4
12/30/2022,Expense,Bolt.Eu O 2201181557,,Travelling Expenses,3.3,56771288.7
12/30/2022,Expense,Bolt.Eu O 2201181557,,Travelling Expenses,3.23,56771291.93
12/30/2022,Expense,Magti Ltd Restaurant,Harvey Spector,Credit Card - Ramp,42.87,56771334.8
12/30/2022,Expense,Bolt.Eu O 2201181557,Harvey Spector,Credit Card - Ramp,3.3,56771338.1
12/30/2022,Expense,Bolt,Harvey Spector,Credit Card - Ramp,21.35,56771359.45
12/30/2022,Expense,Bolt.Eu O 2201181557,Harvey Spector,Credit Card - Ramp,3.23,56771362.68
12/30/2022,Expense,Magti Ltd Restaurant,Harvey Spector,Credit Card - Ramp,42.87,56771405.55
12/30/2022,Expense,WIN Group,Harvey Spector,Credit Card - Ramp,2.25,56771407.8
12/30/2022,Expense,WIN Group,Harvey Spector,Credit Card - Ramp,2.25,56771410.05
12/30/2022,Expense,Bolt.Eu O 2201181557,Harvey Spector,Credit Card - Ramp,2.88,56771412.93
12/30/2022,Expense,Bolt.Eu O 2201181557,,Travelling Expenses,3.23,56771416.16
12/30/2022,Expense,Bolt,,Travelling Expenses,21.35,56771437.51
12/30/2022,Expense,Zapier,,Tools & Subscription - G&A,29.99,56771467.5
12/30/2022,Expense,Bolt.Eu O 2201181557,,Travelling Expenses,2.88,56771470.38
12/30/2022,Expense,WIN Group,,Meals & Entertainment,2.25,56771472.63
12/30/2022,Expense,Magti Ltd Restaurant,Harvey Spector,Credit Card - Ramp,42.87,56771515.5
12/30/2022,Expense,Magti Ltd Restaurant,Harvey Spector,Meals & Entertainment,42.87,56771558.37
12/30/2022,Expense,Bolt.Eu O 2201181557,,Travelling Expenses,4.95,56771563.32
12/30/2022,Expense,Bolt,Harvey Spector,Credit Card - Ramp,21.35,56771584.67
12/30/2022,Expense,Bolt.Eu O 2201181557,,Travelling Expenses,3.3,56771587.97
12/30/2022,Expense,Bolt.Eu O 2201181557,Harvey Spector,Credit Card - Ramp,2.88,56771590.85
12/30/2022,Expense,Bolt.Eu O 2201181557,,Travelling Expenses,3.23,56771594.08
12/30/2022,Expense,Zapier,Chad Blumenthal,Credit Card - Ramp,29.99,56771624.07
12/30/2022,Expense,Bolt.Eu O 2201181557,Harvey Spector,Credit Card - Ramp,3.23,56771627.3
12/30/2022,Expense,Bolt.Eu O 2201181557,,Travelling Expenses,3.3,56771630.6
12/30/2022,Expense,WIN Group,Harvey Spector,Credit Card - Ramp,2.25,56771632.85
12/30/2022,Expense,Magti Ltd Restaurant,Harvey Spector,Credit Card - Ramp,42.87,56771675.72
12/30/2022,Expense,WIN Group,Harvey Spector,Credit Card - Ramp,2.25,56771677.97
12/30/2022,Expense,Bolt.Eu O 2201181557,Harvey Spector,Credit Card - Ramp,4.95,56771682.92
12/31/2022,Journal Entry,,Account transfer from invest to AP,-Split-,-269930,56501752.92
12/31/2022,Journal Entry,,De Franchise Tax for 2022,-Split-,3650,56505402.92
12/31/2022,Bill,Big Company ,,Outsources Services - India,43012.99,56548415.91
12/31/2022,Bill,Big Company ,,Outsources Services - India,8729,56557144.91
12/31/2022,Bill,EntityA,,outsources Services - Australia,90151.48,56647296.39
12/31/2022,Journal Entry,,Account transfer from invest to AP,-Split-,-269930,56377366.39
12/31/2022,Bill,EntityA,,outsources Services - Australia,90151.48,56467517.87
12/31/2022,Bill,Big Company ,,Outsources Services - India,43012.99,56510530.86
12/31/2022,Bill,Big Company ,,Outsources Services - India,8729,56519259.86
12/31/2022,Bill,Big Company ,,Outsources Services - India,8729,56527988.86
12/31/2022,Bill,Big Company ,,Outsources Services - India,43012.99,56571001.85
12/31/2022,Expense,Bolt.Eu O 2201181557,Harvey Spector,Credit Card - Ramp,11.14,56571012.99
12/31/2022,Journal Entry,,Account transfer from invest to AP,-Split-,-269930,56301082.99
12/31/2022,Journal Entry,,Account transfer from invest to AP,-Split-,-269930,56031152.99
12/31/2022,Expense,Careem,,Travelling Expenses,5.17,56031158.16
12/31/2022,Journal Entry,,Account transfer from invest to AP,-Split-,-269930,55761228.16
12/31/2022,Bill,Big Company ,,Outsources Services - India,8729,55769957.16
12/31/2022,Bill,Big Company ,,Outsources Services - India,43012.99,55812970.15
12/31/2022,Journal Entry,,Account transfer from invest to AP,-Split-,-269930,55543040.15
12/31/2022,Expense,Careem,Harvey Spector,Credit Card - Ramp,5.17,55543045.32
12/31/2022,Expense,Adobe,,Tools & Subscription - S&M,15.01,55543060.33
12/31/2022,Expense,Bolt.Eu O 2201181557,,Travelling Expenses,11.14,55543071.47
12/31/2022,Journal Entry,,Account transfer from invest to AP,-Split-,-269930,55273141.47
12/31/2022,Expense,Careem,Harvey Spector,Credit Card - Ramp,5.17,55273146.64
12/31/2022,Expense,Bolt.Eu O 2201181557,Harvey Spector,Credit Card - Ramp,11.14,55273157.78
12/31/2022,Expense,Careem,Harvey Spector,Credit Card - Ramp,5.17,55273162.95
12/31/2022,Expense,Bolt.Eu O 2201181557,Harvey Spector,Credit Card - Ramp,11.14,55273174.09
12/31/2022,Bill,EntityA,,outsources Services - Australia,90151.48,55363325.57
12/31/2022,Bill,EntityA,,outsources Services - Australia,90151.48,55453477.05
12/31/2022,Bill,Big Company ,"Service Expenses for the month of December 2022 
INR   35,60,881.85    @ 82.7862",Accounts Payable (A/P),43012.99,55496490.04
12/31/2022,Journal Entry,,De Franchise Tax for 2022,-Split-,3650,55500140.04
12/31/2022,Bill,EntityA,Dec2022 Quarter expenses incurred plus 10% mark up per the MSA,Account2,90151.48,55590291.52
12/31/2022,Bill,Big Company ,FY21-22 Unbilled cost,Accounts Payable (A/P),8729,55599020.52
12/31/2022,Expense,Careem,,Travelling Expenses,5.17,55599025.69
12/31/2022,Expense,Bolt.Eu O 2201181557,,Travelling Expenses,11.14,55599036.83
12/31/2022,Bill,Big Company ,"Service Expenses for the month of December 2022 
INR   35,60,881.85    @ 82.7862",Accounts Payable (A/P),43012.99,55642049.82
12/31/2022,Expense,Adobe,,Tools & Subscription - S&M,15.01,55642064.83
12/31/2022,Bill,Big Company ,FY21-22 Unbilled cost,Accounts Payable (A/P),8729,55650793.83
12/31/2022,Bill,EntityA,Dec2022 Quarter expenses incurred plus 10% mark up per the MSA,Account2,90151.48,55740945.31
12/31/2022,Bill,Big Company ,FY21-22 Unbilled cost,Accounts Payable (A/P),8729,55749674.31
12/31/2022,Expense,Careem,,Travelling Expenses,5.17,55749679.48
12/31/2022,Expense,Adobe,Mike ross,Credit Card - Ramp,15.01,55749694.49
12/31/2022,Expense,Adobe,Mike ross,Credit Card - Ramp,15.01,55749709.5
12/31/2022,Journal Entry,,De Franchise Tax for 2022,-Split-,3650,55753359.5
12/31/2022,Expense,Adobe,Mike ross,Credit Card - Ramp,15.01,55753374.51
12/31/2022,Bill,EntityA,Dec2022 Quarter expenses incurred plus 10% mark up per the MSA,Account2,90151.48,55843525.99
12/31/2022,Journal Entry,,De Franchise Tax for 2022,-Split-,3650,55847175.99
12/31/2022,Journal Entry,,De Franchise Tax for 2022,-Split-,3650,55850825.99
12/31/2022,Journal Entry,,De Franchise Tax for 2022,-Split-,3650,55854475.99
12/31/2022,Journal Entry,,Account transfer from invest to AP,-Split-,-269930,55584545.99
12/31/2022,Bill,Big Company ,"Service Expenses for the month of December 2022 
INR   35,60,881.85    @ 82.7862",Accounts Payable (A/P),43012.99,55627558.98
12/31/2022,Journal Entry,,De Franchise Tax for 2022,-Split-,3650,55631208.98
12/31/2022,Bill,EntityA,Dec2022 Quarter expenses incurred plus 10% mark up per the MSA,Account2,90151.48,55721360.46
12/31/2022,Expense,Careem,,Travelling Expenses,5.17,55721365.63
12/31/2022,Journal Entry,,De Franchise Tax for 2022,-Split-,3650,55725015.63
12/31/2022,Bill,Big Company ,FY21-22 Unbilled cost,Accounts Payable (A/P),8729,55733744.63
12/31/2022,Bill,Big Company ,"Service Expenses for the month of December 2022 
INR   35,60,881.85    @ 82.7862",Accounts Payable (A/P),43012.99,55776757.62
12/31/2022,Expense,Bolt.Eu O 2201181557,,Travelling Expenses,11.14,55776768.76
12/31/2022,Expense,Adobe,,Tools & Subscription - S&M,15.01,55776783.77
12/31/2022,Expense,Adobe,,Tools & Subscription - S&M,15.01,55776798.78
12/31/2022,Expense,Bolt.Eu O 2201181557,,Travelling Expenses,11.14,55776809.92
01/01/2023,Expense,Bourke Street Bakery,Mike ross,Meals & Entertainment,10.79,55776820.71
01/01/2023,Expense,Bourke Street Bakery,Mike ross,Credit Card - Ramp,10.79,55776831.5
01/01/2023,Expense,lime,,Travelling Expenses,7.69,55776839.19
01/01/2023,Expense,lime,,Travelling Expenses,7.69,55776846.88
01/01/2023,Expense,lime,,Travelling Expenses,7.69,55776854.57
01/01/2023,Expense,Google G Suite,,Tools & Subscription - G&A,113.5,55776968.07
01/01/2023,Expense,Bourke Street Bakery,Mike ross,Meals & Entertainment,10.79,55776978.86
01/01/2023,Expense,Google G Suite,,Tools & Subscription - G&A,113.5,55777092.36
01/01/2023,Expense,lime,Harvey Spector,Credit Card - Ramp,7.69,55777100.05
01/01/2023,Expense,Bourke Street Bakery,Mike ross,Meals & Entertainment,10.79,55777110.84
01/01/2023,Expense,Google G Suite,,Tools & Subscription - G&A,113.5,55777224.34
01/01/2023,Expense,Bourke Street Bakery,Mike ross,Credit Card - Ramp,10.79,55777235.13
01/01/2023,Expense,lime,Harvey Spector,Credit Card - Ramp,7.69,55777242.82
01/01/2023,Expense,lime,Harvey Spector,Credit Card - Ramp,7.69,55777250.51
01/01/2023,Expense,Bourke Street Bakery,Mike ross,Meals & Entertainment,10.79,55777261.3
01/01/2023,Expense,Google G Suite,Mike ross,Credit Card - Ramp,113.5,55777374.8
01/01/2023,Expense,Bourke Street Bakery,Mike ross,Credit Card - Ramp,10.79,55777385.59
01/01/2023,Expense,Google G Suite,Mike ross,Credit Card - Ramp,113.5,55777499.09
01/01/2023,Expense,Bourke Street Bakery,Mike ross,Credit Card - Ramp,10.79,55777509.88
01/01/2023,Expense,Google G Suite,,Tools & Subscription - G&A,113.5,55777623.38
01/01/2023,Expense,Google G Suite,Mike ross,Credit Card - Ramp,113.5,55777736.88
01/01/2023,Expense,lime,,Travelling Expenses,7.69,55777744.57
01/02/2023,Expense,Myfonts,Mike ross,Credit Card - Ramp,16.79,55777761.36
01/02/2023,Expense,Walled City Hotels Pri,,Travel:Hotels,684.96,55778446.32
01/02/2023,Expense,Myfonts,,Tools & Subscription - G&A,16.79,55778463.11
01/02/2023,Expense,Walled City Hotels Pri,Harvey Spector,Credit Card - Ramp,684.96,55779148.07
01/02/2023,Expense,Walled City Hotels Pri,Harvey Spector,Credit Card - Ramp,684.96,55779833.03
01/02/2023,Expense,Walled City Hotels Pri,,Travel:Hotels,684.96,55780517.99
01/02/2023,Expense,Walled City Hotels Pri,Harvey Spector,Credit Card - Ramp,684.96,55781202.95
01/02/2023,Expense,Myfonts,,Tools & Subscription - G&A,16.79,55781219.74
01/02/2023,Expense,Walled City Hotels Pri,,Travel:Hotels,684.96,55781904.7
01/02/2023,Expense,Myfonts,,Tools & Subscription - G&A,16.79,55781921.49
01/02/2023,Expense,Myfonts,,Tools & Subscription - G&A,16.79,55781938.28
01/02/2023,Expense,Myfonts,Mike ross,Credit Card - Ramp,16.79,55781955.07
01/02/2023,Expense,Myfonts,Mike ross,Credit Card - Ramp,16.79,55781971.86
01/02/2023,Expense,Walled City Hotels Pri,,Travel:Hotels,684.96,55782656.82
01/03/2023,Expense,La Panchina,Mike ross,Credit Card - Ramp,36.85,55782693.67
01/03/2023,Expense,La Panchina,Mike ross,Credit Card - Ramp,36.85,55782730.52
01/03/2023,Expense,Cuckoo Callay,Mike ross,Credit Card - Ramp,32.56,55782763.08
01/03/2023,Expense,Cuckoo Callay,Mike ross,Meals & Entertainment,32.56,55782795.64
01/03/2023,Expense,Cuckoo Callay,Mike ross,Meals & Entertainment,32.56,55782828.2
01/03/2023,Expense,La Panchina,Mike ross,Meals & Entertainment,36.85,55782865.05
01/03/2023,Expense,La Panchina,Mike ross,Meals & Entertainment,36.85,55782901.9
01/03/2023,Expense,Cuckoo Callay,Mike ross,Credit Card - Ramp,32.56,55782934.46
01/03/2023,Expense,Cuckoo Callay,Mike ross,Meals & Entertainment,32.56,55782967.02
01/03/2023,Expense,La Panchina,Mike ross,Meals & Entertainment,36.85,55783003.87
01/03/2023,Expense,Cuckoo Callay,Mike ross,Credit Card - Ramp,32.56,55783036.43
01/03/2023,Expense,Cuckoo Callay,Mike ross,Meals & Entertainment,32.56,55783068.99
01/03/2023,Expense,La Panchina,Mike ross,Credit Card - Ramp,36.85,55783105.84
01/03/2023,Expense,La Panchina,Mike ross,Credit Card - Ramp,36.85,55783142.69
01/03/2023,Expense,Cuckoo Callay,Mike ross,Credit Card - Ramp,32.56,55783175.25
01/03/2023,Expense,La Panchina,Mike ross,Meals & Entertainment,36.85,55783212.1
01/04/2023,Expense,lime,,Travelling Expenses,5.28,55783217.38
01/04/2023,Expense,Render,Balapavan Tirumani,Credit Card - Ramp,56,55783273.38
01/04/2023,Deposit,,Interest Accrual INTEREST,Interest Received,4.75,55783278.13
01/04/2023,Deposit,,Interest Accrual INTEREST,Savings (6977),4.75,55783282.88
01/04/2023,Deposit,,Interest Accrual INTEREST,Savings (6977),4.75,55783287.63
01/04/2023,Expense,lime,Harvey Spector,Credit Card - Ramp,5.28,55783292.91
01/04/2023,Deposit,,Interest Accrual INTEREST,Interest Received,4.75,55783297.66
01/04/2023,Deposit,,Interest Accrual INTEREST,Interest Received,4.75,55783302.41
01/04/2023,Expense,lime,Harvey Spector,Credit Card - Ramp,5.28,55783307.69
01/04/2023,Expense,Render,Balapavan Tirumani,Credit Card - Ramp,56,55783363.69
01/04/2023,Deposit,,Interest Accrual INTEREST,Interest Received,4.75,55783368.44
01/04/2023,Expense,Render,,Tools & Subscription - G&A,56,55783424.44
01/04/2023,Expense,lime,,Travelling Expenses,5.28,55783429.72
01/04/2023,Expense,Render,Balapavan Tirumani,Credit Card - Ramp,56,55783485.72
01/04/2023,Expense,lime,Harvey Spector,Credit Card - Ramp,5.28,55783491
01/04/2023,Expense,Render,,Tools & Subscription - G&A,56,55783547
01/04/2023,Expense,lime,,Travelling Expenses,5.28,55783552.28
01/04/2023,Expense,Render,,Tools & Subscription - G&A,56,55783608.28
01/04/2023,Expense,Render,,Tools & Subscription - G&A,56,55783664.28
01/04/2023,Expense,lime,,Travelling Expenses,5.28,55783669.56
01/04/2023,Deposit,,Interest Accrual INTEREST,Savings (6977),4.75,55783674.31
01/05/2023,Expense,Four Ate Five,Mike ross,Credit Card - Ramp,26.16,55783700.47
01/05/2023,Expense,Four Ate Five,Mike ross,Credit Card - Ramp,26.16,55783726.63
01/05/2023,Expense,Four Ate Five,Mike ross,Meals & Entertainment,26.16,55783752.79
01/05/2023,Expense,Four Ate Five,Mike ross,Credit Card - Ramp,26.16,55783778.95
01/05/2023,Expense,Four Ate Five,Mike ross,Meals & Entertainment,26.16,55783805.11
01/05/2023,Expense,Four Ate Five,Mike ross,Credit Card - Ramp,26.16,55783831.27
01/05/2023,Expense,Four Ate Five,Mike ross,Meals & Entertainment,26.16,55783857.43
01/05/2023,Expense,Four Ate Five,Mike ross,Meals & Entertainment,26.16,55783883.59
01/06/2023,Expense,Income Capitals ,Income Capitals ,Contract labor,-34.2,55783849.39
01/06/2023,Expense,Income Capitals ,Income Capitals ,Contract labor,-9920.89,55773928.5
01/06/2023,Expense,Taplio,Harvey Spector,Credit Card - Ramp,39,55773967.5
01/06/2023,Expense,Income Capitals ,Income Capitals ,Contract labor,-9920.89,55764046.61
01/06/2023,Expense,Income Capitals ,Income Capitals ,Contract labor,-1183,55762863.61
01/06/2023,Expense,Income Capitals ,Income Capitals ,Account1,9920.89,55772784.5
01/06/2023,Expense,Income Capitals ,Income Capitals ,Account1,1183,55773967.5
01/06/2023,Expense,Income Capitals ,Income Capitals ,Account1,34.2,55774001.7
01/06/2023,Expense,Income Capitals ,Income Capitals ,Contract labor,-9920.89,55764080.81
01/06/2023,Expense,Income Capitals ,Income Capitals ,Contract labor,-34.2,55764046.61
01/06/2023,Expense,Adobe,,Tools & Subscription - S&M,84.02,55764130.63
01/06/2023,Expense,Uber,Mike ross,Credit Card - Ramp,10.36,55764140.99
01/06/2023,Expense,Income Capitals ,Income Capitals ,Account1,1183,55765323.99
01/06/2023,Expense,Income Capitals ,Income Capitals ,Account1,9920.89,55775244.88
01/06/2023,Expense,Taplio,,Tools & Subscription - G&A,39,55775283.88
01/06/2023,Expense,Income Capitals ,Income Capitals ,Account1,9920.89,55785204.77
01/06/2023,Expense,Income Capitals ,Income Capitals ,Account1,1183,55786387.77
01/06/2023,Expense,Income Capitals ,Income Capitals ,Contract labor,-1183,55785204.77
01/06/2023,Expense,Uber,,Travelling Expenses,10.36,55785215.13
01/06/2023,Expense,Income Capitals ,Income Capitals ,Contract labor,-1183,55784032.13
01/06/2023,Expense,Income Capitals ,Income Capitals ,Account1,34.2,55784066.33
01/06/2023,Expense,Income Capitals ,Income Capitals ,Account1,34.2,55784100.53
01/06/2023,Expense,Income Capitals ,Income Capitals ,Contract labor,-34.2,55784066.33
01/06/2023,Expense,Taplio,Harvey Spector,Credit Card - Ramp,39,55784105.33
01/06/2023,Expense,Adobe,Mike ross,Credit Card - Ramp,84.02,55784189.35
01/06/2023,Expense,Uber,,Travelling Expenses,10.36,55784199.71
01/06/2023,Expense,Income Capitals ,Income Capitals ,Account1,34.2,55784233.91
01/06/2023,Expense,Taplio,,Tools & Subscription - G&A,39,55784272.91
01/06/2023,Expense,Adobe,Mike ross,Credit Card - Ramp,84.02,55784356.93
01/06/2023,Expense,Income Capitals ,Income Capitals ,Account1,1183,55785539.93
01/06/2023,Expense,Income Capitals ,Income Capitals ,Account1,9920.89,55795460.82
01/06/2023,Expense,Adobe,,Tools & Subscription - S&M,84.02,55795544.84
01/06/2023,Expense,Taplio,,Tools & Subscription - G&A,39,55795583.84
01/06/2023,Expense,Uber,,Travelling Expenses,10.36,55795594.2
01/06/2023,Expense,Uber,,Travelling Expenses,10.36,55795604.56
01/06/2023,Expense,Income Capitals ,Income Capitals ,Contract labor,-1183,55794421.56
01/06/2023,Expense,Adobe,,Tools & Subscription - S&M,84.02,55794505.58
01/06/2023,Expense,Uber,Mike ross,Credit Card - Ramp,10.36,55794515.94
01/06/2023,Expense,Uber,Mike ross,Credit Card - Ramp,10.36,55794526.3
01/06/2023,Expense,Adobe,Mike ross,Credit Card - Ramp,84.02,55794610.32
01/06/2023,Expense,Taplio,Harvey Spector,Credit Card - Ramp,39,55794649.32
01/06/2023,Expense,Adobe,,Tools & Subscription - S&M,84.02,55794733.34
01/06/2023,Expense,Income Capitals ,Income Capitals ,Contract labor,-34.2,55794699.14
01/06/2023,Expense,Income Capitals ,Income Capitals ,Contract labor,-9920.89,55784778.25
01/06/2023,Expense,Taplio,,Tools & Subscription - G&A,39,55784817.25
01/07/2023,Expense,Eat Well Restaurant,Harvey Spector,Meals & Entertainment,16.88,55784834.13
01/07/2023,Expense,Mailchimp,,Tools & Subscription - G&A,22,55784856.13
01/07/2023,Expense,Mailchimp,Mike ross,Credit Card - Ramp,22,55784878.13
01/07/2023,Expense,Eat Well Restaurant,Harvey Spector,Credit Card - Ramp,16.88,55784895.01
01/07/2023,Expense,Eat Well Restaurant,Harvey Spector,Meals & Entertainment,16.88,55784911.89
01/07/2023,Expense,Eat Well Restaurant,Harvey Spector,Credit Card - Ramp,16.88,55784928.77
01/07/2023,Expense,Mailchimp,,Tools & Subscription - G&A,22,55784950.77
01/07/2023,Expense,Mailchimp,,Tools & Subscription - G&A,22,55784972.77
01/07/2023,Expense,Mailchimp,,Tools & Subscription - G&A,22,55784994.77
01/07/2023,Expense,Eat Well Restaurant,Harvey Spector,Meals & Entertainment,16.88,55785011.65
01/07/2023,Expense,Mailchimp,Mike ross,Credit Card - Ramp,22,55785033.65
01/07/2023,Expense,Mailchimp,Mike ross,Credit Card - Ramp,22,55785055.65
01/07/2023,Expense,Eat Well Restaurant,Harvey Spector,Credit Card - Ramp,16.88,55785072.53
01/07/2023,Expense,Eat Well Restaurant,Harvey Spector,Credit Card - Ramp,16.88,55785089.41
01/07/2023,Expense,Eat Well Restaurant,Harvey Spector,Meals & Entertainment,16.88,55785106.29
01/08/2023,Expense,Muji,Mike ross,Meals & Entertainment,9.44,55785115.73
01/08/2023,Expense,Careem,,Travelling Expenses,13.55,55785129.28
01/08/2023,Expense,Artificer,,Meals & Entertainment,3.79,55785133.07
01/08/2023,Expense,Careem,,Travelling Expenses,13.55,55785146.62
01/08/2023,Expense,Artificer,,Meals & Entertainment,3.79,55785150.41
01/08/2023,Expense,Careem,,Travelling Expenses,14.92,55785165.33
01/08/2023,Expense,Careem,,Travelling Expenses,14.92,55785180.25
01/08/2023,Expense,Careem,Harvey Spector,Credit Card - Ramp,13.55,55785193.8
01/08/2023,Expense,Careem,,Travelling Expenses,14.92,55785208.72
01/08/2023,Expense,Muji,Mike ross,Meals & Entertainment,9.44,55785218.16
01/08/2023,Expense,Careem,Harvey Spector,Credit Card - Ramp,14.92,55785233.08
01/08/2023,Expense,Muji,Mike ross,Meals & Entertainment,9.44,55785242.52
01/08/2023,Expense,Muji,Mike ross,Credit Card - Ramp,9.44,55785251.96
01/08/2023,Expense,Artificer,Mike ross,Credit Card - Ramp,3.79,55785255.75
01/08/2023,Expense,Muji,Mike ross,Credit Card - Ramp,9.44,55785265.19
01/08/2023,Expense,Careem,,Travelling Expenses,13.55,55785278.74
01/08/2023,Expense,Careem,Harvey Spector,Credit Card - Ramp,13.55,55785292.29
01/08/2023,Expense,Careem,Harvey Spector,Credit Card - Ramp,14.92,55785307.21
01/08/2023,Expense,Careem,Harvey Spector,Credit Card - Ramp,13.55,55785320.76
01/08/2023,Expense,Careem,Harvey Spector,Credit Card - Ramp,14.92,55785335.68
01/08/2023,Expense,Artificer,,Meals & Entertainment,3.79,55785339.47
01/08/2023,Expense,Artificer,Mike ross,Credit Card - Ramp,3.79,55785343.26
01/08/2023,Expense,Muji,Mike ross,Meals & Entertainment,9.44,55785352.7
01/08/2023,Expense,Careem,,Travelling Expenses,14.92,55785367.62
01/08/2023,Expense,Muji,Mike ross,Credit Card - Ramp,9.44,55785377.06
01/08/2023,Expense,Artificer,,Meals & Entertainment,3.79,55785380.85
01/08/2023,Expense,Artificer,Mike ross,Credit Card - Ramp,3.79,55785384.64
01/08/2023,Expense,Muji,Mike ross,Credit Card - Ramp,9.44,55785394.08
01/08/2023,Expense,Artificer,Mike ross,Credit Card - Ramp,3.79,55785397.87
01/08/2023,Expense,Careem,,Travelling Expenses,13.55,55785411.42
01/09/2023,Expense,Usersnap,Harris Jose,Credit Card - Ramp,19,55785430.42
01/09/2023,Expense,Taplio,Harvey Spector,Credit Card - Ramp,39.39,55785469.81
01/09/2023,Expense,Studio 2am,Mike ross,Credit Card - Ramp,15,55785484.81
01/09/2023,Expense,Taplio,Harvey Spector,Credit Card - Ramp,39.39,55785524.2
01/09/2023,Expense,Usersnap,Harris Jose,Credit Card - Ramp,19,55785543.2
01/09/2023,Expense,Heroku,Balapavan Tirumani,Credit Card - Ramp,85.09,55785628.29
01/09/2023,Expense,Taplio,,Tools & Subscription - G&A,39.39,55785667.68
01/09/2023,Expense,Studio 2am,Mike ross,Credit Card - Ramp,15,55785682.68
01/09/2023,Expense,Heroku,Balapavan Tirumani,Tools & Subscription - S&M,85.09,55785767.77
01/09/2023,Expense,Heroku,Balapavan Tirumani,Credit Card - Ramp,85.09,55785852.86
01/09/2023,Expense,Heroku,Balapavan Tirumani,Credit Card - Ramp,85.09,55785937.95
01/09/2023,Expense,Usersnap,,Tools & Subscription - G&A,19,55785956.95
01/09/2023,Expense,Studio 2am,,Tools & Subscription - G&A,15,55785971.95
01/09/2023,Expense,Studio 2am,Mike ross,Credit Card - Ramp,15,55785986.95
01/09/2023,Expense,Usersnap,,Tools & Subscription - G&A,19,55786005.95
01/09/2023,Expense,Usersnap,,Tools & Subscription - G&A,19,55786024.95
01/09/2023,Expense,Taplio,,Tools & Subscription - G&A,39.39,55786064.34
01/09/2023,Expense,Studio 2am,,Tools & Subscription - G&A,15,55786079.34
01/09/2023,Expense,Taplio,,Tools & Subscription - G&A,39.39,55786118.73
01/09/2023,Expense,Taplio,Harvey Spector,Credit Card - Ramp,39.39,55786158.12
01/09/2023,Expense,Usersnap,Harris Jose,Credit Card - Ramp,19,55786177.12
01/09/2023,Expense,Heroku,Balapavan Tirumani,Tools & Subscription - S&M,85.09,55786262.21
01/09/2023,Expense,Taplio,,Tools & Subscription - G&A,39.39,55786301.6
01/09/2023,Expense,Studio 2am,,Tools & Subscription - G&A,15,55786316.6
01/09/2023,Expense,Usersnap,,Tools & Subscription - G&A,19,55786335.6
01/09/2023,Expense,Heroku,Balapavan Tirumani,Tools & Subscription - S&M,85.09,55786420.69
01/09/2023,Expense,Heroku,Balapavan Tirumani,Tools & Subscription - S&M,85.09,55786505.78
01/09/2023,Expense,Studio 2am,,Tools & Subscription - G&A,15,55786520.78
01/10/2023,Expense,Careem,,Travelling Expenses,5.43,55786526.21
01/10/2023,Expense,La Panchina,Mike ross,Credit Card - Ramp,52.84,55786579.05
01/10/2023,Expense,Pause Cafe,Harvey Spector,Credit Card - Ramp,14,55786593.05
01/10/2023,Expense,Pause Cafe,Harvey Spector,Meals & Entertainment,14,55786607.05
01/10/2023,Expense,Pause Cafe,Harvey Spector,Meals & Entertainment,14,55786621.05
01/10/2023,Expense,La Panchina,Mike ross,Credit Card - Ramp,52.84,55786673.89
01/10/2023,Expense,OpenAI,Balapavan Tirumani,Credit Card - Ramp,12.69,55786686.58
01/10/2023,Expense,Pause Cafe,Harvey Spector,Meals & Entertainment,14,55786700.58
01/10/2023,Expense,OpenAI,Balapavan Tirumani,Credit Card - Ramp,12.69,55786713.27
01/10/2023,Expense,Pause Cafe,Harvey Spector,Credit Card - Ramp,14,55786727.27
01/10/2023,Expense,La Panchina,Mike ross,Credit Card - Ramp,52.84,55786780.11
01/10/2023,Expense,Pause Cafe,Harvey Spector,Meals & Entertainment,14,55786794.11
01/10/2023,Expense,La Panchina,Mike ross,Meals & Entertainment,52.84,55786846.95
01/10/2023,Expense,La Panchina,Mike ross,Meals & Entertainment,52.84,55786899.79
01/10/2023,Expense,OpenAI,,Tools & Subscription - G&A,12.69,55786912.48
01/10/2023,Expense,Careem,Harvey Spector,Credit Card - Ramp,5.43,55786917.91
01/10/2023,Expense,Careem,,Travelling Expenses,5.43,55786923.34
01/10/2023,Expense,Careem,Harvey Spector,Credit Card - Ramp,5.43,55786928.77
01/10/2023,Expense,OpenAI,,Tools & Subscription - G&A,12.69,55786941.46
01/10/2023,Expense,Careem,,Travelling Expenses,5.43,55786946.89
01/10/2023,Expense,Careem,Harvey Spector,Credit Card - Ramp,5.43,55786952.32
01/10/2023,Expense,Pause Cafe,Harvey Spector,Credit Card - Ramp,14,55786966.32
01/10/2023,Expense,OpenAI,,Tools & Subscription - G&A,12.69,55786979.01
01/10/2023,Expense,La Panchina,Mike ross,Meals & Entertainment,52.84,55787031.85
01/10/2023,Expense,OpenAI,,Tools & Subscription - G&A,12.69,55787044.54
01/10/2023,Expense,La Panchina,Mike ross,Meals & Entertainment,52.84,55787097.38
01/10/2023,Expense,OpenAI,Balapavan Tirumani,Credit Card - Ramp,12.69,55787110.07
01/10/2023,Expense,La Panchina,Mike ross,Credit Card - Ramp,52.84,55787162.91
01/10/2023,Expense,Pause Cafe,Harvey Spector,Credit Card - Ramp,14,55787176.91
01/10/2023,Expense,Careem,,Travelling Expenses,5.43,55787182.34
01/12/2023,Expense,WordPress,Harris Jose,Credit Card - Ramp,15.45,55787197.79
01/12/2023,Expense,Careem,Harvey Spector,Credit Card - Ramp,9.62,55787207.41
01/12/2023,Expense,WordPress,,Tools & Subscription - G&A,15.45,55787222.86
01/12/2023,Expense,Datadog,,Tools & Subscription - G&A,4.59,55787227.45
01/12/2023,Expense,Cuckoo Callay,Mike ross,Credit Card - Ramp,34.46,55787261.91
01/12/2023,Expense,Datadog,Balapavan Tirumani,Credit Card - Ramp,4.59,55787266.5
01/12/2023,Expense,Careem,,Travelling Expenses,9.62,55787276.12
01/12/2023,Expense,Datadog,,Tools & Subscription - G&A,4.59,55787280.71
01/12/2023,Expense,Cuckoo Callay,Mike ross,Meals & Entertainment,34.46,55787315.17
01/12/2023,Expense,WordPress,,Tools & Subscription - G&A,15.45,55787330.62
01/12/2023,Expense,Careem,Harvey Spector,Credit Card - Ramp,9.62,55787340.24
01/12/2023,Expense,Careem,Harvey Spector,Credit Card - Ramp,9.62,55787349.86
01/12/2023,Expense,Careem,,Travelling Expenses,9.62,55787359.48
01/12/2023,Expense,WordPress,,Tools & Subscription - G&A,15.45,55787374.93
01/12/2023,Expense,Datadog,,Tools & Subscription - G&A,4.59,55787379.52
01/12/2023,Expense,Cuckoo Callay,Mike ross,Credit Card - Ramp,34.46,55787413.98
01/12/2023,Expense,Cuckoo Callay,Mike ross,Meals & Entertainment,34.46,55787448.44
01/12/2023,Expense,Cuckoo Callay,Mike ross,Meals & Entertainment,34.46,55787482.9
01/12/2023,Expense,Datadog,,Tools & Subscription - G&A,4.59,55787487.49
01/12/2023,Expense,Cuckoo Callay,Mike ross,Credit Card - Ramp,34.46,55787521.95
01/12/2023,Expense,Datadog,Balapavan Tirumani,Credit Card - Ramp,4.59,55787526.54
01/12/2023,Expense,WordPress,Harris Jose,Credit Card - Ramp,15.45,55787541.99
01/12/2023,Expense,Careem,,Travelling Expenses,9.62,55787551.61
01/12/2023,Expense,WordPress,,Tools & Subscription - G&A,15.45,55787567.06
01/12/2023,Expense,Careem,,Travelling Expenses,9.62,55787576.68
01/12/2023,Expense,Cuckoo Callay,Mike ross,Meals & Entertainment,34.46,55787611.14
01/12/2023,Expense,Cuckoo Callay,Mike ross,Credit Card - Ramp,34.46,55787645.6
01/12/2023,Expense,Datadog,Balapavan Tirumani,Credit Card - Ramp,4.59,55787650.19
01/12/2023,Expense,WordPress,Harris Jose,Credit Card - Ramp,15.45,55787665.64
01/13/2023,Expense,Sticker Mule,Mike ross,Tools & Subscription - G&A,148.69,55787814.33
01/13/2023,Expense,Figma,,Tools & Subscription - G&A,160,55787974.33
01/13/2023,Expense,Framer,,Tools & Subscription - G&A,9.99,55787984.32
01/13/2023,Expense,Intercom,,Tools & Subscription - G&A,176,55788160.32
01/13/2023,Expense,Intercom,,Tools & Subscription - G&A,176,55788336.32
01/13/2023,Expense,Intercom,,Tools & Subscription - G&A,176,55788512.32
01/13/2023,Expense,Vercel,Harris Jose,Credit Card - Ramp,140,55788652.32
01/13/2023,Expense,Envato,Harris Jose,Advertising & marketing,62,55788714.32
01/13/2023,Expense,Figma,,Tools & Subscription - G&A,160,55788874.32
01/13/2023,Expense,Framer,Harvey Spector,Credit Card - Ramp,9.99,55788884.31
01/13/2023,Expense,Sticker Mule,Mike ross,Tools & Subscription - G&A,148.69,55789033
01/13/2023,Expense,Envato,Harris Jose,Credit Card - Ramp,62,55789095
01/13/2023,Expense,Figma,Mike ross,Credit Card - Ramp,160,55789255
01/13/2023,Expense,Intercom,Balapavan Tirumani,Credit Card - Ramp,176,55789431
01/13/2023,Expense,Vercel,,Tools & Subscription - G&A,140,55789571
01/13/2023,Expense,Vercel,Harris Jose,Credit Card - Ramp,140,55789711
01/13/2023,Expense,Framer,Harvey Spector,Credit Card - Ramp,9.99,55789720.99
01/13/2023,Expense,Sticker Mule,Mike ross,Credit Card - Ramp,148.69,55789869.68
01/13/2023,Expense,Framer,,Tools & Subscription - G&A,9.99,55789879.67
01/13/2023,Expense,Envato,Harris Jose,Advertising & marketing,62,55789941.67
01/13/2023,Expense,Envato,Harris Jose,Advertising & marketing,62,55790003.67
01/13/2023,Expense,Vercel,,Tools & Subscription - G&A,140,55790143.67
01/13/2023,Expense,Framer,,Tools & Subscription - G&A,9.99,55790153.66
01/13/2023,Expense,Sticker Mule,Mike ross,Tools & Subscription - G&A,148.69,55790302.35
01/13/2023,Expense,Figma,,Tools & Subscription - G&A,160,55790462.35
01/13/2023,Expense,Framer,,Tools & Subscription - G&A,9.99,55790472.34
01/13/2023,Expense,Sticker Mule,Mike ross,Credit Card - Ramp,148.69,55790621.03
01/13/2023,Expense,Intercom,Balapavan Tirumani,Credit Card - Ramp,176,55790797.03
01/13/2023,Expense,Vercel,,Tools & Subscription - G&A,140,55790937.03
01/13/2023,Expense,Vercel,Harris Jose,Credit Card - Ramp,140,55791077.03
01/13/2023,Expense,Sticker Mule,Mike ross,Credit Card - Ramp,148.69,55791225.72
01/13/2023,Expense,Figma,Mike ross,Credit Card - Ramp,160,55791385.72
01/13/2023,Expense,Intercom,Balapavan Tirumani,Credit Card - Ramp,176,55791561.72
01/13/2023,Expense,Figma,Mike ross,Credit Card - Ramp,160,55791721.72
01/13/2023,Expense,Envato,Harris Jose,Credit Card - Ramp,62,55791783.72
01/13/2023,Expense,Framer,Harvey Spector,Credit Card - Ramp,9.99,55791793.71
01/13/2023,Expense,Intercom,,Tools & Subscription - G&A,176,55791969.71
01/13/2023,Expense,Envato,Harris Jose,Advertising & marketing,62,55792031.71
01/13/2023,Expense,Vercel,,Tools & Subscription - G&A,140,55792171.71
01/13/2023,Expense,Envato,Harris Jose,Credit Card - Ramp,62,55792233.71
01/13/2023,Expense,Figma,,Tools & Subscription - G&A,160,55792393.71
01/13/2023,Expense,Sticker Mule,Mike ross,Tools & Subscription - G&A,148.69,55792542.4
01/13/2023,Expense,Envato,Harris Jose,Credit Card - Ramp,62,55792604.4
01/14/2023,Expense,National Taxi,,Travelling Expenses,3.05,55792607.45
01/14/2023,Expense,Arabia Taxi,,Travelling Expenses,6.13,55792613.58
01/14/2023,Expense,National Taxi,,Travelling Expenses,3.05,55792616.63
01/14/2023,Expense,Intuit,Harvey Spector,Credit Card - Ramp,55,55792671.63
01/14/2023,Expense,Uber,,Travelling Expenses,8.95,55792680.58
01/14/2023,Expense,National Taxi,Harvey Spector,Credit Card - Ramp,3.05,55792683.63
01/14/2023,Expense,Careem,,Travelling Expenses,10.85,55792694.48
01/14/2023,Expense,Intuit,,Tools & Subscription - G&A,55,55792749.48
01/14/2023,Expense,Careem,,Travelling Expenses,6.93,55792756.41
01/14/2023,Expense,Careem,Harvey Spector,Credit Card - Ramp,10.85,55792767.26
01/14/2023,Expense,Careem,,Travelling Expenses,10.85,55792778.11
01/14/2023,Expense,Intuit,,Tools & Subscription - G&A,55,55792833.11
01/14/2023,Expense,Intuit,,Tools & Subscription - G&A,55,55792888.11
01/14/2023,Expense,National Taxi,,Travelling Expenses,3.05,55792891.16
01/14/2023,Expense,Careem,,Travelling Expenses,10.85,55792902.01
01/14/2023,Expense,Intuit,Harvey Spector,Credit Card - Ramp,55,55792957.01
01/14/2023,Expense,Uber,,Travelling Expenses,39.85,55792996.86
01/14/2023,Expense,Careem,,Travelling Expenses,6.93,55793003.79
01/14/2023,Expense,Arabia Taxi,,Travelling Expenses,6.13,55793009.92
01/14/2023,Expense,National Taxi,,Travelling Expenses,3.05,55793012.97
01/14/2023,Expense,Uber,,Travelling Expenses,8.95,55793021.92
01/14/2023,Expense,Careem,,Travelling Expenses,6.93,55793028.85
01/14/2023,Expense,Uber,,Travelling Expenses,8.95,55793037.8
01/14/2023,Expense,Uber,Mike ross,Credit Card - Ramp,39.85,55793077.65
01/14/2023,Expense,Arabia Taxi,,Travelling Expenses,6.13,55793083.78
01/14/2023,Expense,Uber,,Travelling Expenses,39.85,55793123.63
01/14/2023,Expense,Uber,,Travelling Expenses,39.85,55793163.48
01/14/2023,Expense,Arabia Taxi,Harvey Spector,Credit Card - Ramp,6.13,55793169.61
01/14/2023,Expense,Intuit,Harvey Spector,Credit Card - Ramp,55,55793224.61
01/14/2023,Expense,National Taxi,Harvey Spector,Credit Card - Ramp,3.05,55793227.66
01/14/2023,Expense,Careem,Harvey Spector,Credit Card - Ramp,10.85,55793238.51
01/14/2023,Expense,Arabia Taxi,,Travelling Expenses,6.13,55793244.64
01/14/2023,Expense,Careem,Harvey Spector,Credit Card - Ramp,6.93,55793251.57
01/14/2023,Expense,Careem,Harvey Spector,Credit Card - Ramp,10.85,55793262.42
01/14/2023,Expense,Careem,Harvey Spector,Credit Card - Ramp,6.93,55793269.35
01/14/2023,Expense,Uber,Mike ross,Credit Card - Ramp,39.85,55793309.2
01/14/2023,Expense,Arabia Taxi,Harvey Spector,Credit Card - Ramp,6.13,55793315.33
01/14/2023,Expense,Uber,Mike ross,Credit Card - Ramp,8.95,55793324.28
01/14/2023,Expense,Arabia Taxi,Harvey Spector,Credit Card - Ramp,6.13,55793330.41
01/14/2023,Expense,Uber,Mike ross,Credit Card - Ramp,39.85,55793370.26
01/14/2023,Expense,Careem,,Travelling Expenses,10.85,55793381.11
01/14/2023,Expense,Uber,,Travelling Expenses,8.95,55793390.06
01/14/2023,Expense,Uber,,Travelling Expenses,39.85,55793429.91
01/14/2023,Expense,Careem,,Travelling Expenses,6.93,55793436.84
01/14/2023,Expense,Intuit,,Tools & Subscription - G&A,55,55793491.84
01/14/2023,Expense,Careem,Harvey Spector,Credit Card - Ramp,6.93,55793498.77
01/14/2023,Expense,Uber,Mike ross,Credit Card - Ramp,8.95,55793507.72
01/14/2023,Expense,Uber,Mike ross,Credit Card - Ramp,8.95,55793516.67
01/14/2023,Expense,National Taxi,Harvey Spector,Credit Card - Ramp,3.05,55793519.72
01/15/2023,Expense,Uber,,Travelling Expenses,16.97,55793536.69
01/15/2023,Expense,Careem,,Travelling Expenses,11.46,55793548.15
01/15/2023,Expense,Careem,,Travelling Expenses,11.46,55793559.61
01/15/2023,Expense,Uber,Mike ross,Credit Card - Ramp,16.97,55793576.58
01/15/2023,Expense,Careem,Harvey Spector,Credit Card - Ramp,11.46,55793588.04
01/15/2023,Expense,Uber,,Travelling Expenses,16.97,55793605.01
01/15/2023,Expense,National Taxi,,Travelling Expenses,4.22,55793609.23
01/15/2023,Expense,National Taxi,Harvey Spector,Credit Card - Ramp,4.22,55793613.45
01/15/2023,Expense,National Taxi,Harvey Spector,Credit Card - Ramp,4.22,55793617.67
01/15/2023,Expense,InstaShop,Harvey Spector,Credit Card - Ramp,7.9,55793625.57
01/15/2023,Expense,InstaShop,Harvey Spector,Credit Card - Ramp,7.9,55793633.47
01/15/2023,Expense,InstaShop,Harvey Spector,Credit Card - Ramp,7.9,55793641.37
01/15/2023,Expense,InstaShop,,Meals & Entertainment,7.9,55793649.27
01/15/2023,Expense,Uber,,Travelling Expenses,16.97,55793666.24
01/15/2023,Expense,Uber,,Travelling Expenses,16.97,55793683.21
01/15/2023,Expense,Careem,Harvey Spector,Credit Card - Ramp,11.46,55793694.67
01/15/2023,Expense,Careem,,Travelling Expenses,11.46,55793706.13
01/15/2023,Expense,InstaShop,,Meals & Entertainment,7.9,55793714.03
01/15/2023,Expense,Uber,Mike ross,Credit Card - Ramp,16.97,55793731
01/15/2023,Expense,Uber,Mike ross,Credit Card - Ramp,16.97,55793747.97
01/15/2023,Expense,Careem,Harvey Spector,Credit Card - Ramp,11.46,55793759.43
01/15/2023,Expense,Careem,,Travelling Expenses,11.46,55793770.89
01/15/2023,Expense,National Taxi,,Travelling Expenses,4.22,55793775.11
01/15/2023,Expense,National Taxi,Harvey Spector,Credit Card - Ramp,4.22,55793779.33
01/15/2023,Expense,InstaShop,,Meals & Entertainment,7.9,55793787.23
01/15/2023,Expense,InstaShop,,Meals & Entertainment,7.9,55793795.13
01/15/2023,Expense,National Taxi,,Travelling Expenses,4.22,55793799.35
01/15/2023,Expense,InstaShop,Harvey Spector,Credit Card - Ramp,7.9,55793807.25
01/15/2023,Expense,National Taxi,,Travelling Expenses,4.22,55793811.47
01/16/2023,Expense,Dabang,Mike ross,Meals & Entertainment,8.43,55793819.9
01/16/2023,Expense,Linear,Chad Blumenthal,Credit Card - Ramp,160,55793979.9
01/16/2023,Expense,Zapier,Harvey Spector,Credit Card - Ramp,29.99,55794009.89
01/16/2023,Expense,Notion Labs,,Tools & Subscription - G&A,150,55794159.89
01/16/2023,Expense,Dabang,Mike ross,Credit Card - Ramp,8.43,55794168.32
01/16/2023,Expense,Linear,,Tools & Subscription - G&A,160,55794328.32
01/16/2023,Expense,Linear,,Tools & Subscription - G&A,160,55794488.32
01/16/2023,Expense,Zapier,Harvey Spector,Credit Card - Ramp,29.99,55794518.31
01/16/2023,Expense,Dabang,Mike ross,Meals & Entertainment,8.43,55794526.74
01/16/2023,Expense,Linear,Chad Blumenthal,Credit Card - Ramp,160,55794686.74
01/16/2023,Expense,Notion Labs,Mike ross,Credit Card - Ramp,150,55794836.74
01/16/2023,Expense,Dabang,Mike ross,Credit Card - Ramp,8.43,55794845.17
01/16/2023,Expense,Dabang,Mike ross,Credit Card - Ramp,8.43,55794853.6
01/16/2023,Expense,Zapier,,Tools & Subscription - G&A,29.99,55794883.59
01/16/2023,Expense,Zapier,,Tools & Subscription - G&A,29.99,55794913.58
01/16/2023,Expense,Notion Labs,,Tools & Subscription - G&A,150,55795063.58
01/16/2023,Expense,Notion Labs,Mike ross,Credit Card - Ramp,150,55795213.58
01/16/2023,Expense,Linear,,Tools & Subscription - G&A,160,55795373.58
01/16/2023,Expense,Dabang,Mike ross,Credit Card - Ramp,8.43,55795382.01
01/16/2023,Expense,Zapier,Harvey Spector,Credit Card - Ramp,29.99,55795412
01/16/2023,Expense,Linear,,Tools & Subscription - G&A,160,55795572
01/16/2023,Expense,Linear,Chad Blumenthal,Credit Card - Ramp,160,55795732
01/16/2023,Expense,Notion Labs,Mike ross,Credit Card - Ramp,150,55795882
01/16/2023,Expense,Notion Labs,,Tools & Subscription - G&A,150,55796032
01/16/2023,Expense,Dabang,Mike ross,Meals & Entertainment,8.43,55796040.43
01/16/2023,Expense,Notion Labs,,Tools & Subscription - G&A,150,55796190.43
01/16/2023,Expense,Zapier,,Tools & Subscription - G&A,29.99,55796220.42
01/16/2023,Expense,Dabang,Mike ross,Meals & Entertainment,8.43,55796228.85
01/16/2023,Expense,Zapier,,Tools & Subscription - G&A,29.99,55796258.84
01/17/2023,Expense,Reuben Hills,Mike ross,Meals & Entertainment,13.29,55796272.13
01/17/2023,Expense,Reuben Hills,Mike ross,Meals & Entertainment,13.29,55796285.42
01/17/2023,Expense,Reuben Hills,Mike ross,Credit Card - Ramp,13.29,55796298.71
01/17/2023,Expense,Uber,,Travelling Expenses,54.96,55796353.67
01/17/2023,Expense,Careem,,Travelling Expenses,7.94,55796361.61
01/17/2023,Expense,Reuben Hills,Mike ross,Credit Card - Ramp,13.29,55796374.9
01/17/2023,Expense,Reuben Hills,Mike ross,Credit Card - Ramp,13.29,55796388.19
01/17/2023,Expense,Careem,Harvey Spector,Credit Card - Ramp,7.94,55796396.13
01/17/2023,Expense,Uber,Mike ross,Credit Card - Ramp,54.96,55796451.09
01/17/2023,Expense,Uber,Mike ross,Credit Card - Ramp,54.96,55796506.05
01/17/2023,Expense,Careem,Harvey Spector,Credit Card - Ramp,7.94,55796513.99
01/17/2023,Expense,Careem,,Travelling Expenses,7.94,55796521.93
01/17/2023,Expense,Dnesscarkey,Mike ross,Credit Card - Ramp,9.99,55796531.92
01/17/2023,Expense,Reuben Hills,Mike ross,Credit Card - Ramp,13.29,55796545.21
01/17/2023,Expense,Dnesscarkey,,Tools & Subscription - G&A,9.99,55796555.2
01/17/2023,Expense,Dnesscarkey,,Tools & Subscription - G&A,9.99,55796565.19
01/17/2023,Expense,Careem,,Travelling Expenses,7.94,55796573.13
01/17/2023,Expense,Uber,,Travelling Expenses,54.96,55796628.09
01/17/2023,Expense,Dnesscarkey,Mike ross,Credit Card - Ramp,9.99,55796638.08
01/17/2023,Expense,Careem,,Travelling Expenses,7.94,55796646.02
01/17/2023,Expense,Dnesscarkey,,Tools & Subscription - G&A,9.99,55796656.01
01/17/2023,Expense,Reuben Hills,Mike ross,Meals & Entertainment,13.29,55796669.3
01/17/2023,Expense,Dnesscarkey,,Tools & Subscription - G&A,9.99,55796679.29
01/17/2023,Expense,Uber,Mike ross,Credit Card - Ramp,54.96,55796734.25
01/17/2023,Expense,Careem,Harvey Spector,Credit Card - Ramp,7.94,55796742.19
01/17/2023,Expense,Uber,,Travelling Expenses,54.96,55796797.15
01/17/2023,Expense,Reuben Hills,Mike ross,Meals & Entertainment,13.29,55796810.44
01/17/2023,Expense,Dnesscarkey,Mike ross,Credit Card - Ramp,9.99,55796820.43
01/17/2023,Expense,Uber,,Travelling Expenses,54.96,55796875.39
01/18/2023,Expense,LinkedIn,Mike ross,Credit Card - Ramp,156.41,55797031.8
01/18/2023,Expense,LinkedIn,,Tools & Subscription - G&A,156.41,55797188.21
01/18/2023,Expense,National Taxi,,Travelling Expenses,8.21,55797196.42
01/18/2023,Expense,Uber,Harvey Spector,Credit Card - Ramp,0.32,55797196.74
01/18/2023,Expense,Gum Co Cc Symbolicons,,General business expenses:Memberships & subscriptions,132,55797328.74
01/18/2023,Expense,Superhuman,Harvey Spector,Credit Card - Ramp,30,55797358.74
01/18/2023,Expense,Gum Co Cc Symbolicons,Mike ross,Credit Card - Ramp,132,55797490.74
01/18/2023,Expense,National Taxi,,Travelling Expenses,8.21,55797498.95
01/18/2023,Expense,National Taxi,Harvey Spector,Credit Card - Ramp,8.21,55797507.16
01/18/2023,Expense,Gum Co Cc Symbolicons,,General business expenses:Memberships & subscriptions,132,55797639.16
01/18/2023,Expense,Superhuman,Harvey Spector,Credit Card - Ramp,30,55797669.16
01/18/2023,Expense,Superhuman,,Professional Service Charges,30,55797699.16
01/18/2023,Expense,Gum Co Cc Symbolicons,Mike ross,Credit Card - Ramp,132,55797831.16
01/18/2023,Expense,LinkedIn,Mike ross,Credit Card - Ramp,156.41,55797987.57
01/18/2023,Expense,Uber,Harvey Spector,Credit Card - Ramp,0.32,55797987.89
01/18/2023,Expense,Superhuman,,Professional Service Charges,30,55798017.89
01/18/2023,Expense,Uber,,Travelling Expenses,0.32,55798018.21
01/18/2023,Expense,LinkedIn,,Tools & Subscription - G&A,156.41,55798174.62
01/18/2023,Expense,National Taxi,Harvey Spector,Credit Card - Ramp,8.21,55798182.83
01/18/2023,Expense,Gum Co Cc Symbolicons,,General business expenses:Memberships & subscriptions,132,55798314.83
01/18/2023,Expense,Uber,,Travelling Expenses,0.32,55798315.15
01/18/2023,Expense,Uber,,Travelling Expenses,0.32,55798315.47
01/18/2023,Expense,Uber,,Travelling Expenses,0.32,55798315.79
01/18/2023,Expense,National Taxi,,Travelling Expenses,8.21,55798324
01/18/2023,Expense,National Taxi,,Travelling Expenses,8.21,55798332.21
01/18/2023,Expense,LinkedIn,Mike ross,Credit Card - Ramp,156.41,55798488.62
01/18/2023,Expense,Superhuman,,Professional Service Charges,30,55798518.62
01/18/2023,Expense,LinkedIn,,Tools & Subscription - G&A,156.41,55798675.03
01/18/2023,Expense,LinkedIn,,Tools & Subscription - G&A,156.41,55798831.44
01/18/2023,Expense,Superhuman,,Professional Service Charges,30,55798861.44
01/18/2023,Expense,Superhuman,Harvey Spector,Credit Card - Ramp,30,55798891.44
01/18/2023,Expense,Gum Co Cc Symbolicons,Mike ross,Credit Card - Ramp,132,55799023.44
01/18/2023,Expense,Superhuman,Harvey Spector,Credit Card - Ramp,30,55799053.44
01/18/2023,Expense,National Taxi,Harvey Spector,Credit Card - Ramp,8.21,55799061.65
01/18/2023,Expense,Uber,Harvey Spector,Credit Card - Ramp,0.32,55799061.97
01/18/2023,Expense,Gum Co Cc Symbolicons,Mike ross,Credit Card - Ramp,132,55799193.97
01/18/2023,Expense,Gum Co Cc Symbolicons,,General business expenses:Memberships & subscriptions,132,55799325.97
01/19/2023,Expense,LinkedIn,,Tools & Subscription - G&A,26.12,55799352.09
01/19/2023,Expense,Mtw,,Tools & Subscription - G&A,31.9,55799383.99
01/19/2023,Expense,The Carrington,Mike ross,Credit Card - Ramp,22.84,55799406.83
01/19/2023,Expense,LinkedIn,,Tools & Subscription - G&A,26.12,55799432.95
01/19/2023,Expense,Mtw,Mike ross,Credit Card - Ramp,31.9,55799464.85
01/19/2023,Expense,Mtw,,Tools & Subscription - G&A,31.9,55799496.75
01/19/2023,Expense,The Carrington,,Meals & Entertainment,22.84,55799519.59
01/19/2023,Expense,The Carrington,,Meals & Entertainment,22.84,55799542.43
01/19/2023,Expense,LinkedIn,Harvey Spector,Credit Card - Ramp,26.12,55799568.55
01/19/2023,Expense,LinkedIn,,Tools & Subscription - G&A,26.12,55799594.67
01/19/2023,Expense,The Carrington,,Meals & Entertainment,22.84,55799617.51
01/19/2023,Expense,The Carrington,Mike ross,Credit Card - Ramp,22.84,55799640.35
01/19/2023,Expense,Mtw,Mike ross,Credit Card - Ramp,31.9,55799672.25
01/19/2023,Expense,LinkedIn,Harvey Spector,Credit Card - Ramp,26.12,55799698.37
01/19/2023,Expense,Mtw,,Tools & Subscription - G&A,31.9,55799730.27
01/19/2023,Expense,The Carrington,,Meals & Entertainment,22.84,55799753.11
01/19/2023,Expense,The Carrington,Mike ross,Credit Card - Ramp,22.84,55799775.95
01/19/2023,Expense,LinkedIn,,Tools & Subscription - G&A,26.12,55799802.07
01/19/2023,Expense,The Carrington,Mike ross,Credit Card - Ramp,22.84,55799824.91
01/19/2023,Expense,Mtw,Mike ross,Credit Card - Ramp,31.9,55799856.81
01/19/2023,Expense,LinkedIn,Harvey Spector,Credit Card - Ramp,26.12,55799882.93
01/19/2023,Expense,Mtw,,Tools & Subscription - G&A,31.9,55799914.83
01/20/2023,Credit Card Payment,,RAMP STATEMENT,Account1,-5265.27,55794649.56
01/20/2023,Expense,Surtees Studios,,Tools & Subscription - G&A,19.95,55794669.51
01/20/2023,Expense,LinkedIn,Niteesha Ravela,Credit Card - Ramp,122.26,55794791.77
01/20/2023,Expense,Creative Market,Mike ross,Credit Card - Ramp,50.56,55794842.33
01/20/2023,Expense,LinkedIn,Niteesha Ravela,Credit Card - Ramp,122.26,55794964.59
01/20/2023,Expense,Suzuya Restaurant,Mike ross,Credit Card - Ramp,38.1,55795002.69
01/20/2023,Expense,Uber Eats,Mike ross,Meals & Entertainment,20.47,55795023.16
01/20/2023,Expense,Surtees Studios,,Tools & Subscription - G&A,19.95,55795043.11
01/20/2023,Credit Card Payment,,RAMP STATEMENT,Credit Card - Ramp,-5265.27,55789777.84
01/20/2023,Expense,Zoom,,Tools & Subscription - G&A,149.9,55789927.74
01/20/2023,Expense,Uber Eats,Mike ross,Credit Card - Ramp,20.47,55789948.21
01/20/2023,Expense,Creative Market,Mike ross,Advertising & marketing,50.56,55789998.77
01/20/2023,Expense,Creative Market,Mike ross,Credit Card - Ramp,50.56,55790049.33
01/20/2023,Expense,LinkedIn,,Tools & Subscription - G&A,122.26,55790171.59
01/20/2023,Expense,Suzuya Restaurant,Mike ross,Meals & Entertainment,38.1,55790209.69
01/20/2023,Expense,Uber Eats,Mike ross,Meals & Entertainment,20.47,55790230.16
01/20/2023,Expense,Uber Eats,Mike ross,Credit Card - Ramp,20.47,55790250.63
01/20/2023,Expense,Uber Eats,Mike ross,Credit Card - Ramp,20.47,55790271.1
01/20/2023,Expense,Suzuya Restaurant,Mike ross,Credit Card - Ramp,38.1,55790309.2
01/20/2023,Expense,Surtees Studios,,Tools & Subscription - G&A,19.95,55790329.15
01/20/2023,Credit Card Payment,,RAMP STATEMENT,Credit Card - Ramp,-5265.27,55785063.88
01/20/2023,Expense,Creative Market,Mike ross,Advertising & marketing,50.56,55785114.44
01/20/2023,Credit Card Payment,,RAMP STATEMENT,Account1,-5265.27,55779849.17
01/20/2023,Expense,Creative Market,Mike ross,Advertising & marketing,50.56,55779899.73
01/20/2023,Credit Card Payment,,RAMP STATEMENT,Account1,-5265.27,55774634.46
01/20/2023,Expense,Zoom,Harvey Spector,Credit Card - Ramp,149.9,55774784.36
01/20/2023,Credit Card Payment,,RAMP STATEMENT,Credit Card - Ramp,-5265.27,55769519.09
01/20/2023,Expense,LinkedIn,,Tools & Subscription - G&A,122.26,55769641.35
01/20/2023,Expense,Uber Eats,Mike ross,Meals & Entertainment,20.47,55769661.82
01/20/2023,Expense,Uber Eats,Mike ross,Meals & Entertainment,20.47,55769682.29
01/20/2023,Expense,Suzuya Restaurant,Mike ross,Meals & Entertainment,38.1,55769720.39
01/20/2023,Expense,Surtees Studios,Harvey Spector,Credit Card - Ramp,19.95,55769740.34
01/20/2023,Expense,Zoom,Harvey Spector,Credit Card - Ramp,149.9,55769890.24
01/20/2023,Expense,LinkedIn,Niteesha Ravela,Credit Card - Ramp,122.26,55770012.5
01/20/2023,Expense,Creative Market,Mike ross,Credit Card - Ramp,50.56,55770063.06
01/20/2023,Expense,Zoom,,Tools & Subscription - G&A,149.9,55770212.96
01/20/2023,Credit Card Payment,,RAMP STATEMENT,Credit Card - Ramp,-5265.27,55764947.69
01/20/2023,Expense,Zoom,,Tools & Subscription - G&A,149.9,55765097.59
01/20/2023,Expense,Zoom,,Tools & Subscription - G&A,149.9,55765247.49
01/20/2023,Expense,Suzuya Restaurant,Mike ross,Credit Card - Ramp,38.1,55765285.59
01/20/2023,Expense,LinkedIn,,Tools & Subscription - G&A,122.26,55765407.85
01/20/2023,Expense,Surtees Studios,,Tools & Subscription - G&A,19.95,55765427.8
01/20/2023,Expense,Surtees Studios,Harvey Spector,Credit Card - Ramp,19.95,55765447.75
01/20/2023,Expense,Surtees Studios,Harvey Spector,Credit Card - Ramp,19.95,55765467.7
01/20/2023,Expense,Zoom,Harvey Spector,Credit Card - Ramp,149.9,55765617.6
01/20/2023,Credit Card Payment,,RAMP STATEMENT,Account1,-5265.27,55760352.33
01/20/2023,Expense,Uber Eats,Mike ross,Credit Card - Ramp,20.47,55760372.8
01/20/2023,Expense,Suzuya Restaurant,Mike ross,Credit Card - Ramp,38.1,55760410.9
01/20/2023,Expense,Creative Market,Mike ross,Credit Card - Ramp,50.56,55760461.46
01/20/2023,Expense,Creative Market,Mike ross,Advertising & marketing,50.56,55760512.02
01/20/2023,Expense,Suzuya Restaurant,Mike ross,Meals & Entertainment,38.1,55760550.12
01/20/2023,Expense,LinkedIn,,Tools & Subscription - G&A,122.26,55760672.38
01/20/2023,Expense,Suzuya Restaurant,Mike ross,Meals & Entertainment,38.1,55760710.48
01/22/2023,Expense,The New York Times,,General business expenses:Memberships & subscriptions,1.4,55760711.88
01/22/2023,Expense,The New York Times,,General business expenses:Memberships & subscriptions,1.4,55760713.28
01/22/2023,Expense,Dovetail,,Tools & Subscription - G&A,70,55760783.28
01/22/2023,Expense,Vimcal,,Tools & Subscription - G&A,15,55760798.28
01/22/2023,Expense,The New York Times,,General business expenses:Memberships & subscriptions,1.4,55760799.68
01/22/2023,Expense,The New York Times,Mike ross,Credit Card - Ramp,1.4,55760801.08
01/22/2023,Expense,Uber Eats,Mike ross,Meals & Entertainment,19.38,55760820.46
01/22/2023,Expense,Vimcal,,Tools & Subscription - G&A,15,55760835.46
01/22/2023,Expense,Uber Eats,Mike ross,Meals & Entertainment,19.38,55760854.84
01/22/2023,Expense,Dovetail,,Tools & Subscription - G&A,70,55760924.84
01/22/2023,Expense,The New York Times,Mike ross,Credit Card - Ramp,1.4,55760926.24
01/22/2023,Expense,Vimcal,Harvey Spector,Credit Card - Ramp,15,55760941.24
01/22/2023,Expense,Uber Eats,Mike ross,Credit Card - Ramp,19.38,55760960.62
01/22/2023,Expense,Dovetail,,Tools & Subscription - G&A,70,55761030.62
01/22/2023,Expense,Uber Eats,Mike ross,Meals & Entertainment,19.38,55761050
01/22/2023,Expense,Uber Eats,Mike ross,Credit Card - Ramp,19.38,55761069.38
01/22/2023,Expense,The New York Times,Mike ross,Credit Card - Ramp,1.4,55761070.78
01/22/2023,Expense,Dovetail,Harvey Spector,Credit Card - Ramp,70,55761140.78
01/22/2023,Expense,Dovetail,,Tools & Subscription - G&A,70,55761210.78
01/22/2023,Expense,Dovetail,Harvey Spector,Credit Card - Ramp,70,55761280.78
01/22/2023,Expense,Uber Eats,Mike ross,Meals & Entertainment,19.38,55761300.16
01/22/2023,Expense,Vimcal,,Tools & Subscription - G&A,15,55761315.16
01/22/2023,Expense,Vimcal,Harvey Spector,Credit Card - Ramp,15,55761330.16
01/22/2023,Expense,The New York Times,,General business expenses:Memberships & subscriptions,1.4,55761331.56
01/22/2023,Expense,Vimcal,,Tools & Subscription - G&A,15,55761346.56
01/22/2023,Expense,Uber Eats,Mike ross,Credit Card - Ramp,19.38,55761365.94
01/22/2023,Expense,Vimcal,Harvey Spector,Credit Card - Ramp,15,55761380.94
01/22/2023,Expense,Dovetail,Harvey Spector,Credit Card - Ramp,70,55761450.94
01/22/2023,Expense,Uber Eats,Mike ross,Credit Card - Ramp,19.38,55761470.32
01/22/2023,Expense,The New York Times,Mike ross,Credit Card - Ramp,1.4,55761471.72
01/23/2023,Expense,Superhuman,Mike ross,Credit Card - Ramp,30,55761501.72
01/23/2023,Expense,Superhuman,,Professional Service Charges,30,55761531.72
01/23/2023,Deposit,,CSC,Account1,-193.05,55761338.67
01/23/2023,Expense,,CSC,Account1,193.05,55761531.72
01/23/2023,Deposit,,CSC,Account1,-193.05,55761338.67
01/23/2023,Expense,,CSC,Account1,193.05,55761531.72
01/23/2023,Expense,Superhuman,Mike ross,Credit Card - Ramp,30,55761561.72
01/23/2023,Deposit,,CSC,Advertising & marketing,193.05,55761754.77
01/23/2023,Expense,,CSC,Advertising & marketing,-193.05,55761561.72
01/23/2023,Expense,bills,Mike ross,Meals & Entertainment,26.43,55761588.15
01/23/2023,Deposit,,CSC,Advertising & marketing,193.05,55761781.2
01/23/2023,Expense,Super,,Tools & Subscription - G&A,12,55761793.2
01/23/2023,Expense,,CSC,Advertising & marketing,-193.05,55761600.15
01/23/2023,Expense,Super,Harvey Spector,Credit Card - Ramp,12,55761612.15
01/23/2023,Expense,,CSC,Advertising & marketing,-193.05,55761419.1
01/23/2023,Expense,Rocket Sports Internet,Harvey Spector,Credit Card - Ramp,5,55761424.1
01/23/2023,Expense,Rocket Sports Internet,Harvey Spector,Office expenses:Office supplies,5,55761429.1
01/23/2023,Expense,bills,Mike ross,Credit Card - Ramp,26.43,55761455.53
01/23/2023,Expense,Super,Harvey Spector,Credit Card - Ramp,12,55761467.53
01/23/2023,Expense,bills,Mike ross,Credit Card - Ramp,26.43,55761493.96
01/23/2023,Deposit,,CSC,Advertising & marketing,193.05,55761687.01
01/23/2023,Expense,Rocket Sports Internet,Harvey Spector,Office expenses:Office supplies,5,55761692.01
01/23/2023,Expense,bills,Mike ross,Meals & Entertainment,26.43,55761718.44
01/23/2023,Expense,bills,Mike ross,Credit Card - Ramp,26.43,55761744.87
01/23/2023,Expense,,CSC,Account1,193.05,55761937.92
01/23/2023,Expense,Superhuman,,Professional Service Charges,30,55761967.92
01/23/2023,Expense,bills,Mike ross,Meals & Entertainment,26.43,55761994.35
01/23/2023,Expense,Superhuman,,Professional Service Charges,30,55762024.35
01/23/2023,Deposit,,CSC,Account1,-193.05,55761831.3
01/23/2023,Expense,bills,Mike ross,Meals & Entertainment,26.43,55761857.73
01/23/2023,Expense,Super,,Tools & Subscription - G&A,12,55761869.73
01/23/2023,Expense,Rocket Sports Internet,Harvey Spector,Office expenses:Office supplies,5,55761874.73
01/23/2023,Expense,Superhuman,,Professional Service Charges,30,55761904.73
01/23/2023,Expense,,CSC,Account1,193.05,55762097.78
01/23/2023,Deposit,,CSC,Account1,-193.05,55761904.73
01/23/2023,Expense,Rocket Sports Internet,Harvey Spector,Office expenses:Office supplies,5,55761909.73
01/23/2023,Expense,Super,Harvey Spector,Credit Card - Ramp,12,55761921.73
01/23/2023,Expense,Rocket Sports Internet,Harvey Spector,Credit Card - Ramp,5,55761926.73
01/23/2023,Expense,Super,,Tools & Subscription - G&A,12,55761938.73
01/23/2023,Expense,Superhuman,Mike ross,Credit Card - Ramp,30,55761968.73
01/23/2023,Deposit,,CSC,Advertising & marketing,193.05,55762161.78
01/23/2023,Expense,,CSC,Advertising & marketing,-193.05,55761968.73
01/23/2023,Expense,Rocket Sports Internet,Harvey Spector,Credit Card - Ramp,5,55761973.73
01/23/2023,Expense,bills,Mike ross,Credit Card - Ramp,26.43,55762000.16
01/23/2023,Expense,Superhuman,Mike ross,Credit Card - Ramp,30,55762030.16
01/23/2023,Expense,Super,,Tools & Subscription - G&A,12,55762042.16
01/23/2023,Expense,Rocket Sports Internet,Harvey Spector,Credit Card - Ramp,5,55762047.16
01/24/2023,Expense,Corporation Service Co,Mike ross,Credit Card - Ramp,193.05,55762240.21
01/24/2023,Expense,Benedict Evans,Harvey Spector,Credit Card - Ramp,10,55762250.21
01/24/2023,Expense,Benedict Evans,Harvey Spector,Professional Service Charges,10,55762260.21
01/24/2023,Expense,Corporation Service Co,Mike ross,Advertising & marketing,193.05,55762453.26
01/24/2023,Expense,Corporation Service Co,Mike ross,Advertising & marketing,193.05,55762646.31
01/24/2023,Expense,Benedict Evans,Harvey Spector,Professional Service Charges,10,55762656.31
01/24/2023,Expense,Benedict Evans,Harvey Spector,Professional Service Charges,10,55762666.31
01/24/2023,Expense,Benedict Evans,Harvey Spector,Credit Card - Ramp,10,55762676.31
01/24/2023,Expense,Benedict Evans,Harvey Spector,Credit Card - Ramp,10,55762686.31
01/24/2023,Expense,Benedict Evans,Harvey Spector,Credit Card - Ramp,10,55762696.31
01/24/2023,Expense,Benedict Evans,Harvey Spector,Professional Service Charges,10,55762706.31
01/24/2023,Expense,Corporation Service Co,Mike ross,Advertising & marketing,193.05,55762899.36
01/24/2023,Expense,Corporation Service Co,Mike ross,Advertising & marketing,193.05,55763092.41
01/24/2023,Expense,Corporation Service Co,Mike ross,Credit Card - Ramp,193.05,55763285.46
01/24/2023,Expense,Corporation Service Co,Mike ross,Credit Card - Ramp,193.05,55763478.51
01/24/2023,Expense,Corporation Service Co,Mike ross,Credit Card - Ramp,193.05,55763671.56
01/25/2023,Expense,GitKraken,Ahielan Ravichandran,Credit Card - Ramp,59.4,55763730.96
01/25/2023,Expense,GitKraken,,Tools & Subscription - G&A,59.4,55763790.36
01/25/2023,Expense,Creative Market,Mike ross,Advertising & marketing,7.66,55763798.02
01/25/2023,Expense,Miro,,Tools & Subscription - G&A,90,55763888.02
01/25/2023,Expense,Creative Market,Mike ross,Advertising & marketing,7.66,55763895.68
01/25/2023,Expense,GitKraken,Ahielan Ravichandran,Credit Card - Ramp,59.4,55763955.08
01/25/2023,Expense,Miro,Mike ross,Credit Card - Ramp,90,55764045.08
01/25/2023,Expense,Miro,,Tools & Subscription - G&A,90,55764135.08
01/25/2023,Expense,GitKraken,,Tools & Subscription - G&A,59.4,55764194.48
01/25/2023,Expense,Creative Market,Mike ross,Credit Card - Ramp,7.66,55764202.14
01/25/2023,Expense,GitKraken,,Tools & Subscription - G&A,59.4,55764261.54
01/25/2023,Expense,Miro,Mike ross,Credit Card - Ramp,90,55764351.54
01/25/2023,Expense,Creative Market,Mike ross,Credit Card - Ramp,7.66,55764359.2
01/25/2023,Expense,GitKraken,Ahielan Ravichandran,Credit Card - Ramp,59.4,55764418.6
01/25/2023,Expense,Creative Market,Mike ross,Credit Card - Ramp,7.66,55764426.26
01/25/2023,Expense,Miro,,Tools & Subscription - G&A,90,55764516.26
01/25/2023,Expense,Miro,,Tools & Subscription - G&A,90,55764606.26
01/25/2023,Expense,Creative Market,Mike ross,Advertising & marketing,7.66,55764613.92
01/25/2023,Expense,GitKraken,,Tools & Subscription - G&A,59.4,55764673.32
01/25/2023,Expense,Creative Market,Mike ross,Credit Card - Ramp,7.66,55764680.98
01/25/2023,Expense,Miro,Mike ross,Credit Card - Ramp,90,55764770.98
01/25/2023,Expense,Creative Market,Mike ross,Advertising & marketing,7.66,55764778.64
01/26/2023,Expense,Pa.Ra.Mi Restaurant,Mike ross,Meals & Entertainment,9.55,55764788.19
01/26/2023,Expense,Pa.Ra.Mi Restaurant,Mike ross,Credit Card - Ramp,9.55,55764797.74
01/26/2023,Expense,Zoom,,Tools & Subscription - G&A,14.99,55764812.73
01/26/2023,Expense,Zoom,Chad Blumenthal,Credit Card - Ramp,14.99,55764827.72
01/26/2023,Expense,Pa.Ra.Mi Restaurant,Mike ross,Credit Card - Ramp,9.55,55764837.27
01/26/2023,Expense,Pa.Ra.Mi Restaurant,Mike ross,Credit Card - Ramp,9.55,55764846.82
01/26/2023,Expense,Zoom,,Tools & Subscription - G&A,14.99,55764861.81
01/26/2023,Expense,Pa.Ra.Mi Restaurant,Mike ross,Meals & Entertainment,9.55,55764871.36
01/26/2023,Expense,Pa.Ra.Mi Restaurant,Mike ross,Meals & Entertainment,9.55,55764880.91
01/26/2023,Expense,Zoom,,Tools & Subscription - G&A,14.99,55764895.9
01/26/2023,Expense,Zoom,,Tools & Subscription - G&A,14.99,55764910.89
01/26/2023,Expense,Pa.Ra.Mi Restaurant,Mike ross,Meals & Entertainment,9.55,55764920.44
01/26/2023,Expense,Zoom,Chad Blumenthal,Credit Card - Ramp,14.99,55764935.43
01/26/2023,Expense,Pa.Ra.Mi Restaurant,Mike ross,Credit Card - Ramp,9.55,55764944.98
01/26/2023,Expense,Zoom,Chad Blumenthal,Credit Card - Ramp,14.99,55764959.97
01/27/2023,Expense,Sendinblue,Balapavan Tirumani,Credit Card - Ramp,56.59,55765016.56
01/27/2023,Expense,Splitbee,,Tools & Subscription - G&A,16.52,55765033.08
01/27/2023,Expense,Sentry,,Tools & Subscription - G&A,29,55765062.08
01/27/2023,Expense,Sentry,Balapavan Tirumani,Credit Card - Ramp,29,55765091.08
01/27/2023,Expense,Sendinblue,,Tools & Subscription - G&A,56.59,55765147.67
01/27/2023,Expense,Sentry,,Tools & Subscription - G&A,29,55765176.67
01/27/2023,Expense,Sendinblue,,Tools & Subscription - G&A,56.59,55765233.26
01/27/2023,Expense,Splitbee,,Tools & Subscription - G&A,16.52,55765249.78
01/27/2023,Expense,Sentry,Balapavan Tirumani,Credit Card - Ramp,29,55765278.78
01/27/2023,Expense,Sentry,,Tools & Subscription - G&A,29,55765307.78
01/27/2023,Expense,Sendinblue,Balapavan Tirumani,Credit Card - Ramp,56.59,55765364.37
01/27/2023,Expense,Splitbee,,Tools & Subscription - G&A,16.52,55765380.89
01/27/2023,Expense,Sendinblue,,Tools & Subscription - G&A,56.59,55765437.48
01/27/2023,Expense,Sentry,,Tools & Subscription - G&A,29,55765466.48
01/27/2023,Expense,Splitbee,,Tools & Subscription - G&A,16.52,55765483
01/27/2023,Expense,Sendinblue,,Tools & Subscription - G&A,56.59,55765539.59
01/27/2023,Expense,Splitbee,Harris Jose,Credit Card - Ramp,16.52,55765556.11
01/27/2023,Expense,Sentry,Balapavan Tirumani,Credit Card - Ramp,29,55765585.11
01/27/2023,Expense,Splitbee,Harris Jose,Credit Card - Ramp,16.52,55765601.63
01/27/2023,Expense,Splitbee,Harris Jose,Credit Card - Ramp,16.52,55765618.15
01/27/2023,Expense,Sendinblue,Balapavan Tirumani,Credit Card - Ramp,56.59,55765674.74
01/28/2023,Expense,The Century Bar,,Meals & Entertainment,14.51,55765689.25
01/28/2023,Expense,The Century Bar,,Meals & Entertainment,14.51,55765703.76
01/28/2023,Expense,The Century Bar,Mike ross,Credit Card - Ramp,14.51,55765718.27
01/28/2023,Expense,The Century Bar,,Meals & Entertainment,14.51,55765732.78
01/28/2023,Expense,The Century Bar,Mike ross,Credit Card - Ramp,14.51,55765747.29
01/28/2023,Expense,The Century Bar,Mike ross,Credit Card - Ramp,14.51,55765761.8
01/28/2023,Expense,The Century Bar,,Meals & Entertainment,14.51,55765776.31
01/28/2023,Expense,The Century Bar,Mike ross,Credit Card - Ramp,14.51,55765790.82
01/29/2023,Expense,Netlify,,Tools & Subscription - G&A,19,55765809.82
01/29/2023,Expense,Netlify,,Tools & Subscription - G&A,19,55765828.82
01/29/2023,Expense,Netlify,,Tools & Subscription - G&A,19,55765847.82
01/29/2023,Expense,Netlify,Balapavan Tirumani,Credit Card - Ramp,19,55765866.82
01/29/2023,Expense,Netlify,Balapavan Tirumani,Credit Card - Ramp,19,55765885.82
01/29/2023,Expense,Netlify,,Tools & Subscription - G&A,19,55765904.82
01/29/2023,Expense,Netlify,Balapavan Tirumani,Credit Card - Ramp,19,55765923.82
01/30/2023,Expense,Zeus Street Greek,Mike ross,Meals & Entertainment,9.63,55765933.45
01/30/2023,Expense,iStock,Mike ross,Credit Card - Ramp,10.2,55765943.65
01/30/2023,Expense,Dabang,Mike ross,Meals & Entertainment,5.71,55765949.36
01/30/2023,Expense,Zapier,Chad Blumenthal,Credit Card - Ramp,29.99,55765979.35
01/30/2023,Expense,iStock,Mike ross,Credit Card - Ramp,10.2,55765989.55
01/30/2023,Expense,Zapier,,Tools & Subscription - G&A,29.99,55766019.54
01/30/2023,Expense,Dabang,Mike ross,Credit Card - Ramp,5.71,55766025.25
01/30/2023,Expense,iStock,Mike ross,General business expenses,10.2,55766035.45
01/30/2023,Expense,Zapier,Chad Blumenthal,Credit Card - Ramp,29.99,55766065.44
01/30/2023,Expense,Zeus Street Greek,Mike ross,Meals & Entertainment,9.63,55766075.07
01/30/2023,Expense,Dabang,Mike ross,Meals & Entertainment,5.71,55766080.78
01/30/2023,Expense,iStock,Mike ross,General business expenses,10.2,55766090.98
01/30/2023,Expense,Dabang,Mike ross,Credit Card - Ramp,5.71,55766096.69
01/30/2023,Expense,Zeus Street Greek,Mike ross,Credit Card - Ramp,9.63,55766106.32
01/30/2023,Expense,Zapier,,Tools & Subscription - G&A,29.99,55766136.31
01/30/2023,Expense,iStock,Mike ross,Credit Card - Ramp,10.2,55766146.51
01/30/2023,Expense,Zapier,,Tools & Subscription - G&A,29.99,55766176.5
01/30/2023,Expense,Zeus Street Greek,Mike ross,Credit Card - Ramp,9.63,55766186.13
01/30/2023,Expense,Zapier,Chad Blumenthal,Credit Card - Ramp,29.99,55766216.12
01/30/2023,Expense,iStock,Mike ross,General business expenses,10.2,55766226.32
01/30/2023,Expense,Zeus Street Greek,Mike ross,Meals & Entertainment,9.63,55766235.95
01/30/2023,Expense,Dabang,Mike ross,Meals & Entertainment,5.71,55766241.66
01/30/2023,Expense,iStock,Mike ross,General business expenses,10.2,55766251.86
01/30/2023,Expense,iStock,Mike ross,Credit Card - Ramp,10.2,55766262.06
01/30/2023,Expense,Dabang,Mike ross,Credit Card - Ramp,5.71,55766267.77
01/30/2023,Expense,Dabang,Mike ross,Credit Card - Ramp,5.71,55766273.48
01/30/2023,Expense,Zeus Street Greek,Mike ross,Credit Card - Ramp,9.63,55766283.11
01/30/2023,Expense,Zapier,,Tools & Subscription - G&A,29.99,55766313.1
01/30/2023,Expense,Zeus Street Greek,Mike ross,Meals & Entertainment,9.63,55766322.73
01/30/2023,Expense,Dabang,Mike ross,Meals & Entertainment,5.71,55766328.44
01/30/2023,Expense,Zeus Street Greek,Mike ross,Credit Card - Ramp,9.63,55766338.07
01/31/2023,Bill,Big Company ,"Service Expenses for the month of January 2023 
INR   31,67,381.75    @ 81.7387",Accounts Payable (A/P),38750.09,55805088.16
01/31/2023,Expense,Adobe,,Tools & Subscription - S&M,15.72,55805103.88
01/31/2023,Expense,Adobe,Mike ross,Credit Card - Ramp,15.72,55805119.6
01/31/2023,Bill,Big Company ,,Outsources Services - India,38750.09,55843869.69
01/31/2023,Expense,Zeus Street Greek,Mike ross,Meals & Entertainment,9.62,55843879.31
01/31/2023,Expense,Zeus Street Greek,Mike ross,Meals & Entertainment,9.62,55843888.93
01/31/2023,Expense,Adobe,,Tools & Subscription - S&M,15.72,55843904.65
01/31/2023,Expense,Zeus Street Greek,Mike ross,Credit Card - Ramp,9.62,55843914.27
01/31/2023,Expense,Zeus Street Greek,Mike ross,Credit Card - Ramp,9.62,55843923.89
01/31/2023,Expense,Adobe,,Tools & Subscription - S&M,15.72,55843939.61
01/31/2023,Bill,Big Company ,,Outsources Services - India,38750.09,55882689.7
01/31/2023,Expense,Zeus Street Greek,Mike ross,Meals & Entertainment,9.62,55882699.32
01/31/2023,Bill,Big Company ,"Service Expenses for the month of January 2023 
INR   31,67,381.75    @ 81.7387",Accounts Payable (A/P),38750.09,55921449.41
01/31/2023,Bill,Big Company ,"Service Expenses for the month of January 2023 
INR   31,67,381.75    @ 81.7387",Accounts Payable (A/P),38750.09,55960199.5
01/31/2023,Expense,Adobe,,Tools & Subscription - S&M,15.72,55960215.22
01/31/2023,Expense,Zeus Street Greek,Mike ross,Meals & Entertainment,9.62,55960224.84
01/31/2023,Expense,Zeus Street Greek,Mike ross,Credit Card - Ramp,9.62,55960234.46
01/31/2023,Expense,Adobe,Mike ross,Credit Card - Ramp,15.72,55960250.18
01/31/2023,Bill,Big Company ,,Outsources Services - India,38750.09,55999000.27
01/31/2023,Expense,Adobe,Mike ross,Credit Card - Ramp,15.72,55999015.99
01/31/2023,Expense,Zeus Street Greek,Mike ross,Credit Card - Ramp,9.62,55999025.61
01/31/2023,Bill,Big Company ,"Service Expenses for the month of January 2023 
INR   31,67,381.75    @ 81.7387",Accounts Payable (A/P),38750.09,56037775.7
01/31/2023,Bill,Big Company ,,Outsources Services - India,38750.09,56076525.79
02/01/2023,Expense,Uber,,Travelling Expenses,16.78,56076542.57
02/01/2023,Expense,Google G Suite,Mike ross,Credit Card - Ramp,119.08,56076661.65
02/01/2023,Expense,Jane Surry Hills Restaurant,Mike ross,Credit Card - Ramp,61.29,56076722.94
02/01/2023,Expense,Google G Suite,,Tools & Subscription - G&A,119.08,56076842.02
02/01/2023,Expense,Uber,,Travelling Expenses,16.78,56076858.8
02/01/2023,Expense,Jane Surry Hills Restaurant,Mike ross,Credit Card - Ramp,61.29,56076920.09
02/01/2023,Expense,Google G Suite,,Tools & Subscription - G&A,119.08,56077039.17
02/01/2023,Expense,Uber,Mike ross,Credit Card - Ramp,16.78,56077055.95
02/01/2023,Expense,Jane Surry Hills Restaurant,,Meals & Entertainment,61.29,56077117.24
02/01/2023,Expense,Google G Suite,Mike ross,Credit Card - Ramp,119.08,56077236.32
02/01/2023,Expense,Uber,Mike ross,Credit Card - Ramp,16.78,56077253.1
02/01/2023,Expense,Google G Suite,,Tools & Subscription - G&A,119.08,56077372.18
02/01/2023,Expense,Google G Suite,,Tools & Subscription - G&A,119.08,56077491.26
02/01/2023,Expense,Uber,,Travelling Expenses,16.78,56077508.04
02/01/2023,Expense,Uber,Mike ross,Credit Card - Ramp,16.78,56077524.82
02/01/2023,Expense,Jane Surry Hills Restaurant,,Meals & Entertainment,61.29,56077586.11
02/01/2023,Expense,Jane Surry Hills Restaurant,Mike ross,Credit Card - Ramp,61.29,56077647.4
02/01/2023,Expense,Jane Surry Hills Restaurant,,Meals & Entertainment,61.29,56077708.69
02/01/2023,Expense,Uber,,Travelling Expenses,16.78,56077725.47
02/01/2023,Expense,Jane Surry Hills Restaurant,,Meals & Entertainment,61.29,56077786.76
02/01/2023,Expense,Google G Suite,Mike ross,Credit Card - Ramp,119.08,56077905.84
02/01/2023,Expense,Jane Surry Hills Restaurant,Mike ross,Credit Card - Ramp,61.29,56077967.13
02/02/2023,Expense,The Carrington,,Meals & Entertainment,8.66,56077975.79
02/02/2023,Expense,Dabang,Mike ross,Credit Card - Ramp,4.3,56077980.09
02/02/2023,Expense,Income Capitals ,Income Capitals ,Contract labor,-21958.57,56056021.52
02/02/2023,Expense,Income Capitals ,Income Capitals ,Account1,21958.57,56077980.09
02/02/2023,Expense,Maloneys Grocer,Mike ross,Credit Card - Ramp,25.71,56078005.8
02/02/2023,Deposit,,Interest Accrual INTEREST,Interest Received,4.74,56078010.54
02/02/2023,Expense,Fadel.Io,,Tools & Subscription - G&A,10.84,56078021.38
02/02/2023,Expense,Maloneys Grocer,,Meals & Entertainment,25.71,56078047.09
02/02/2023,Expense,Render,,Tools & Subscription - G&A,189,56078236.09
02/02/2023,Expense,Render,Balapavan Tirumani,Credit Card - Ramp,189,56078425.09
02/02/2023,Deposit,,Interest Accrual INTEREST,Savings (6977),4.74,56078429.83
02/02/2023,Expense,Fadel.Io,,Tools & Subscription - G&A,10.84,56078440.67
02/02/2023,Expense,Income Capitals ,Income Capitals ,Contract labor,-21958.57,56056482.1
02/02/2023,Expense,Income Capitals ,Income Capitals ,Account1,21958.57,56078440.67
02/02/2023,Expense,Income Capitals ,Income Capitals ,Account1,21958.57,56100399.24
02/02/2023,Expense,The Carrington,,Meals & Entertainment,8.66,56100407.9
02/02/2023,Expense,Dabang,Mike ross,Meals & Entertainment,4.3,56100412.2
02/02/2023,Expense,Render,,Tools & Subscription - G&A,189,56100601.2
02/02/2023,Expense,Maloneys Grocer,,Meals & Entertainment,25.71,56100626.91
02/02/2023,Expense,Income Capitals ,Income Capitals ,Contract labor,-21958.57,56078668.34
02/02/2023,Deposit,,Interest Accrual INTEREST,Savings (6977),4.74,56078673.08
02/02/2023,Expense,Dabang,Mike ross,Meals & Entertainment,4.3,56078677.38
02/02/2023,Deposit,,Interest Accrual INTEREST,Savings (6977),4.74,56078682.12
02/02/2023,Expense,Fadel.Io,Harvey Spector,Credit Card - Ramp,10.84,56078692.96
02/02/2023,Expense,The Carrington,Mike ross,Credit Card - Ramp,8.66,56078701.62
02/02/2023,Expense,Maloneys Grocer,,Meals & Entertainment,25.71,56078727.33
02/02/2023,Expense,The Carrington,,Meals & Entertainment,8.66,56078735.99
02/02/2023,Expense,Dabang,Mike ross,Meals & Entertainment,4.3,56078740.29
02/02/2023,Expense,Fadel.Io,,Tools & Subscription - G&A,10.84,56078751.13
02/02/2023,Expense,Fadel.Io,Harvey Spector,Credit Card - Ramp,10.84,56078761.97
02/02/2023,Expense,Dabang,Mike ross,Credit Card - Ramp,4.3,56078766.27
02/02/2023,Expense,The Carrington,Mike ross,Credit Card - Ramp,8.66,56078774.93
02/02/2023,Deposit,,Interest Accrual INTEREST,Interest Received,4.74,56078779.67
02/02/2023,Expense,Maloneys Grocer,,Meals & Entertainment,25.71,56078805.38
02/02/2023,Expense,Maloneys Grocer,Mike ross,Credit Card - Ramp,25.71,56078831.09
02/02/2023,Expense,Fadel.Io,,Tools & Subscription - G&A,10.84,56078841.93
02/02/2023,Expense,Dabang,Mike ross,Meals & Entertainment,4.3,56078846.23
02/02/2023,Expense,The Carrington,Mike ross,Credit Card - Ramp,8.66,56078854.89
02/02/2023,Expense,Render,,Tools & Subscription - G&A,189,56079043.89
02/02/2023,Deposit,,Interest Accrual INTEREST,Interest Received,4.74,56079048.63
02/02/2023,Expense,Dabang,Mike ross,Credit Card - Ramp,4.3,56079052.93
02/02/2023,Expense,The Carrington,,Meals & Entertainment,8.66,56079061.59
02/02/2023,Expense,Income Capitals ,Income Capitals ,Contract labor,-21958.57,56057103.02
02/02/2023,Expense,The Carrington,Mike ross,Credit Card - Ramp,8.66,56057111.68
02/02/2023,Expense,Render,,Tools & Subscription - G&A,189,56057300.68
02/02/2023,Expense,Fadel.Io,Harvey Spector,Credit Card - Ramp,10.84,56057311.52
02/02/2023,Expense,Render,Balapavan Tirumani,Credit Card - Ramp,189,56057500.52
02/02/2023,Expense,Maloneys Grocer,Mike ross,Credit Card - Ramp,25.71,56057526.23
02/02/2023,Expense,Dabang,Mike ross,Credit Card - Ramp,4.3,56057530.53
02/02/2023,Expense,Maloneys Grocer,Mike ross,Credit Card - Ramp,25.71,56057556.24
02/02/2023,Expense,Income Capitals ,Income Capitals ,Account1,21958.57,56079514.81
02/02/2023,Deposit,,Interest Accrual INTEREST,Interest Received,4.74,56079519.55
02/02/2023,Expense,Render,Balapavan Tirumani,Credit Card - Ramp,189,56079708.55
02/03/2023,Expense,Suzuya Restaurant,Mike ross,Meals & Entertainment,36.55,56079745.1
02/03/2023,Expense,Suzuya Restaurant,Mike ross,Meals & Entertainment,36.55,56079781.65
02/03/2023,Expense,PDF Expert,Harvey Spector,Tools & Subscription,152.96,56079934.61
02/03/2023,Expense,PDF Expert,Harvey Spector,Credit Card - Ramp,152.96,56080087.57
02/03/2023,Expense,Suzuya Restaurant,Mike ross,Credit Card - Ramp,36.55,56080124.12
02/03/2023,Expense,Suzuya Restaurant,Mike ross,Meals & Entertainment,36.55,56080160.67
02/03/2023,Expense,PDF Expert,Harvey Spector,Tools & Subscription,152.96,56080313.63
02/03/2023,Expense,PDF Expert,Harvey Spector,Credit Card - Ramp,152.96,56080466.59
02/03/2023,Expense,Suzuya Restaurant,Mike ross,Credit Card - Ramp,36.55,56080503.14
02/03/2023,Expense,Suzuya Restaurant,Mike ross,Credit Card - Ramp,36.55,56080539.69
02/03/2023,Expense,Suzuya Restaurant,Mike ross,Credit Card - Ramp,36.55,56080576.24
02/03/2023,Expense,PDF Expert,Harvey Spector,Credit Card - Ramp,152.96,56080729.2
02/03/2023,Expense,PDF Expert,Harvey Spector,Tools & Subscription,152.96,56080882.16
02/03/2023,Expense,Suzuya Restaurant,Mike ross,Meals & Entertainment,36.55,56080918.71
02/03/2023,Expense,PDF Expert,Harvey Spector,Tools & Subscription,152.96,56081071.67
02/05/2023,Expense,Uber Eats,Mike ross,Credit Card - Ramp,21.95,56081093.62
02/05/2023,Expense,Uber,Mike ross,Credit Card - Ramp,44.01,56081137.63
02/05/2023,Expense,Uber Eats,Mike ross,Credit Card - Ramp,21.95,56081159.58
02/05/2023,Expense,Uber Eats,Mike ross,Meals & Entertainment,21.95,56081181.53
02/05/2023,Expense,Uber,Mike ross,Credit Card - Ramp,44.01,56081225.54
02/05/2023,Expense,Uber,Mike ross,Credit Card - Ramp,44.01,56081269.55
02/05/2023,Expense,Uber,,Travelling Expenses,44.01,56081313.56
02/05/2023,Expense,Uber Eats,Mike ross,Meals & Entertainment,21.95,56081335.51
02/05/2023,Expense,Uber Eats,Mike ross,Credit Card - Ramp,21.95,56081357.46
02/05/2023,Expense,Uber Eats,Mike ross,Meals & Entertainment,21.95,56081379.41
02/05/2023,Expense,Uber,,Travelling Expenses,44.01,56081423.42
02/05/2023,Expense,Uber Eats,Mike ross,Credit Card - Ramp,21.95,56081445.37
02/05/2023,Expense,Uber Eats,Mike ross,Meals & Entertainment,21.95,56081467.32
02/05/2023,Expense,Uber,,Travelling Expenses,44.01,56081511.33
02/05/2023,Expense,Uber,,Travelling Expenses,44.01,56081555.34
02/06/2023,Expense,Uber,Mike ross,Credit Card - Ramp,12.62,56081567.96
02/06/2023,Expense,Taplio,,Tools & Subscription - G&A,39,56081606.96
02/06/2023,Expense,Artificer,,Meals & Entertainment,3.19,56081610.15
02/06/2023,Expense,Artificer,Mike ross,Credit Card - Ramp,3.19,56081613.34
02/06/2023,Expense,Artificer,,Meals & Entertainment,2.48,56081615.82
02/06/2023,Transfer,,PaymentServiceB Checking **7257,Account1,-170000,55911615.82
02/06/2023,Expense,Big Company ,Big Company ,Accounts Payable (A/P),-150000,55761615.82
02/06/2023,Expense,Taplio,,Tools & Subscription - G&A,39,55761654.82
02/06/2023,Transfer,,PaymentServiceB Checking **7257,Account1,-170000,55591654.82
02/06/2023,Expense,Uber,,Travelling Expenses,12.62,55591667.44
02/06/2023,Expense,Adobe,,Tools & Subscription - S&M,85.27,55591752.71
02/06/2023,Expense,Uber,,Travelling Expenses,12.62,55591765.33
02/06/2023,Expense,Artificer,Mike ross,Credit Card - Ramp,3.19,55591768.52
02/06/2023,Expense,Big Company ,Big Company ,Account1,-150000,55441768.52
02/06/2023,Expense,Artificer,,Meals & Entertainment,3.19,55441771.71
02/06/2023,Expense,Artificer,,Meals & Entertainment,2.48,55441774.19
02/06/2023,Expense,Adobe,,Tools & Subscription - S&M,85.27,55441859.46
02/06/2023,Expense,Adobe,,Tools & Subscription - S&M,85.27,55441944.73
02/06/2023,Expense,Artificer,,Meals & Entertainment,2.48,55441947.21
02/06/2023,Expense,Uber,,Travelling Expenses,12.62,55441959.83
02/06/2023,Expense,Artificer,,Meals & Entertainment,3.19,55441963.02
02/06/2023,Expense,Taplio,,Tools & Subscription - G&A,39,55442002.02
02/06/2023,Transfer,,PaymentServiceB Checking **7257,Savings (6977),170000,55612002.02
02/06/2023,Expense,Artificer,Mike ross,Credit Card - Ramp,3.19,55612005.21
02/06/2023,Expense,Taplio,,Tools & Subscription - G&A,39,55612044.21
02/06/2023,Expense,Artificer,Mike ross,Credit Card - Ramp,2.48,55612046.69
02/06/2023,Expense,Taplio,Harvey Spector,Credit Card - Ramp,39,55612085.69
02/06/2023,Expense,Uber,Mike ross,Credit Card - Ramp,12.62,55612098.31
02/06/2023,Transfer,,PaymentServiceB Checking **7257,Savings (6977),170000,55782098.31
02/06/2023,Expense,Taplio,Harvey Spector,Credit Card - Ramp,39,55782137.31
02/06/2023,Expense,Artificer,Mike ross,Credit Card - Ramp,2.48,55782139.79
02/06/2023,Expense,Big Company ,Big Company ,Accounts Payable (A/P),-150000,55632139.79
02/06/2023,Expense,Big Company ,Big Company ,Account1,-150000,55482139.79
02/06/2023,Expense,Artificer,Mike ross,Credit Card - Ramp,3.19,55482142.98
02/06/2023,Expense,Big Company ,Big Company ,Accounts Payable (A/P),-150000,55332142.98
02/06/2023,Transfer,,PaymentServiceB Checking **7257,Savings (6977),170000,55502142.98
02/06/2023,Expense,Adobe,Mike ross,Credit Card - Ramp,85.27,55502228.25
02/06/2023,Transfer,,PaymentServiceB Checking **7257,Account1,-170000,55332228.25
02/06/2023,Expense,Taplio,Harvey Spector,Credit Card - Ramp,39,55332267.25
02/06/2023,Expense,Artificer,Mike ross,Credit Card - Ramp,2.48,55332269.73
02/06/2023,Expense,Adobe,Mike ross,Credit Card - Ramp,85.27,55332355
02/06/2023,Expense,Artificer,Mike ross,Credit Card - Ramp,2.48,55332357.48
02/06/2023,Expense,Adobe,Mike ross,Credit Card - Ramp,85.27,55332442.75
02/06/2023,Expense,Uber,Mike ross,Credit Card - Ramp,12.62,55332455.37
02/06/2023,Expense,Big Company ,Big Company ,Account1,-150000,55182455.37
02/06/2023,Transfer,,PaymentServiceB Checking **7257,Account1,-170000,55012455.37
02/06/2023,Expense,Big Company ,Big Company ,Accounts Payable (A/P),-150000,54862455.37
02/06/2023,Expense,Big Company ,Big Company ,Account1,-150000,54712455.37
02/06/2023,Expense,Uber,,Travelling Expenses,12.62,54712467.99
02/06/2023,Expense,Adobe,,Tools & Subscription - S&M,85.27,54712553.26
02/06/2023,Expense,Artificer,,Meals & Entertainment,2.48,54712555.74
02/06/2023,Expense,Artificer,,Meals & Entertainment,3.19,54712558.93
02/06/2023,Transfer,,PaymentServiceB Checking **7257,Savings (6977),170000,54882558.93
02/07/2023,Expense,OpenAI,Balapavan Tirumani,Credit Card - Ramp,1.24,54882560.17
02/07/2023,Expense,Mailchimp,,Tools & Subscription - G&A,22,54882582.17
02/07/2023,Expense,Mailchimp,Mike ross,Credit Card - Ramp,22,54882604.17
02/07/2023,Expense,1Password,Mike ross,Credit Card - Ramp,59.85,54882664.02
02/07/2023,Expense,1Password,,Tools & Subscription - G&A,59.85,54882723.87
02/07/2023,Expense,1Password,,Tools & Subscription - G&A,59.85,54882783.72
02/07/2023,Expense,Mailchimp,Mike ross,Credit Card - Ramp,22,54882805.72
02/07/2023,Expense,1Password,Mike ross,Credit Card - Ramp,59.85,54882865.57
02/07/2023,Expense,OpenAI,Balapavan Tirumani,Credit Card - Ramp,1.24,54882866.81
02/07/2023,Expense,Mailchimp,,Tools & Subscription - G&A,22,54882888.81
02/07/2023,Expense,OpenAI,,Tools & Subscription - G&A,1.24,54882890.05
02/07/2023,Expense,1Password,,Tools & Subscription - G&A,59.85,54882949.9
02/07/2023,Expense,OpenAI,,Tools & Subscription - G&A,1.24,54882951.14
02/07/2023,Expense,Mailchimp,,Tools & Subscription - G&A,22,54882973.14
02/07/2023,Expense,OpenAI,,Tools & Subscription - G&A,1.24,54882974.38
02/07/2023,Expense,Mailchimp,,Tools & Subscription - G&A,22,54882996.38
02/07/2023,Expense,1Password,Mike ross,Credit Card - Ramp,59.85,54883056.23
02/07/2023,Expense,Mailchimp,Mike ross,Credit Card - Ramp,22,54883078.23
02/07/2023,Expense,OpenAI,,Tools & Subscription - G&A,1.24,54883079.47
02/07/2023,Expense,OpenAI,Balapavan Tirumani,Credit Card - Ramp,1.24,54883080.71
02/07/2023,Expense,1Password,,Tools & Subscription - G&A,59.85,54883140.56
02/08/2023,Expense,Jino Joseph & Associates,JINO JOSEPH & AS,Account1,60,54883200.56
02/08/2023,Expense,Jino Joseph & Associates,JINO JOSEPH & AS,Professional Service Charges,-60,54883140.56
02/08/2023,Expense,Heroku,Balapavan Tirumani,Tools & Subscription - S&M,85,54883225.56
02/08/2023,Expense,Heroku,Balapavan Tirumani,Credit Card - Ramp,85,54883310.56
02/08/2023,Expense,Jino Joseph & Associates,JINO JOSEPH & AS,Account1,60,54883370.56
02/08/2023,Expense,Heroku,Balapavan Tirumani,Credit Card - Ramp,85,54883455.56
02/08/2023,Expense,Heroku,Balapavan Tirumani,Credit Card - Ramp,85,54883540.56
02/08/2023,Expense,Jino Joseph & Associates,JINO JOSEPH & AS,Professional Service Charges,-60,54883480.56
02/08/2023,Expense,Heroku,Balapavan Tirumani,Tools & Subscription - S&M,85,54883565.56
02/08/2023,Expense,Jino Joseph & Associates,JINO JOSEPH & AS,Professional Service Charges,-60,54883505.56
02/08/2023,Expense,Heroku,Balapavan Tirumani,Tools & Subscription - S&M,85,54883590.56
02/08/2023,Expense,Jino Joseph & Associates,JINO JOSEPH & AS,Professional Service Charges,-60,54883530.56
02/08/2023,Expense,Heroku,Balapavan Tirumani,Tools & Subscription - S&M,85,54883615.56
02/08/2023,Expense,Jino Joseph & Associates,JINO JOSEPH & AS,Account1,60,54883675.56
02/08/2023,Expense,Jino Joseph & Associates,JINO JOSEPH & AS,Account1,60,54883735.56
02/09/2023,Expense,Uber,Mike ross,Credit Card - Ramp,10.64,54883746.2
02/09/2023,Expense,Datadog,Balapavan Tirumani,Credit Card - Ramp,4.01,54883750.21
02/09/2023,Expense,Datadog,Balapavan Tirumani,Credit Card - Ramp,4.01,54883754.22
02/09/2023,Expense,Taplio,Harvey Spector,Credit Card - Ramp,39,54883793.22
02/09/2023,Expense,Taplio,Harvey Spector,Credit Card - Ramp,39,54883832.22
02/09/2023,Expense,Usersnap,Harris Jose,Credit Card - Ramp,19,54883851.22
02/09/2023,Expense,Datadog,Balapavan Tirumani,Credit Card - Ramp,4.01,54883855.23
02/09/2023,Expense,Usersnap,Harris Jose,Credit Card - Ramp,19,54883874.23
02/09/2023,Expense,Taplio,Harvey Spector,Credit Card - Ramp,39,54883913.23
02/09/2023,Expense,Usersnap,,Tools & Subscription - G&A,19,54883932.23
02/09/2023,Expense,Uber,,Travelling Expenses,7.98,54883940.21
02/09/2023,Expense,LottieFiles,,Tools & Subscription - G&A,239.88,54884180.09
02/09/2023,Expense,Datadog,,Tools & Subscription - G&A,4.01,54884184.1
02/09/2023,Expense,LottieFiles,Balapavan Tirumani,Credit Card - Ramp,239.88,54884423.98
02/09/2023,Expense,Uber,,Travelling Expenses,10.64,54884434.62
02/09/2023,Expense,Uber,Mike ross,Credit Card - Ramp,7.98,54884442.6
02/09/2023,Expense,Uber,Mike ross,Credit Card - Ramp,10.64,54884453.24
02/09/2023,Expense,LottieFiles,Balapavan Tirumani,Credit Card - Ramp,239.88,54884693.12
02/09/2023,Expense,Uber,,Travelling Expenses,7.98,54884701.1
02/09/2023,Expense,Taplio,,Tools & Subscription - G&A,39,54884740.1
02/09/2023,Expense,LottieFiles,,Tools & Subscription - G&A,239.88,54884979.98
02/09/2023,Expense,Taplio,,Tools & Subscription - G&A,39,54885018.98
02/09/2023,Expense,Uber,,Travelling Expenses,10.64,54885029.62
02/09/2023,Expense,Uber,,Travelling Expenses,10.64,54885040.26
02/09/2023,Expense,Datadog,,Tools & Subscription - G&A,4.01,54885044.27
02/09/2023,Expense,LottieFiles,,Tools & Subscription - G&A,239.88,54885284.15
02/09/2023,Expense,LottieFiles,Balapavan Tirumani,Credit Card - Ramp,239.88,54885524.03
02/09/2023,Expense,Uber,Mike ross,Credit Card - Ramp,10.64,54885534.67
02/09/2023,Expense,Uber,Mike ross,Credit Card - Ramp,7.98,54885542.65
02/09/2023,Expense,Uber,,Travelling Expenses,7.98,54885550.63
02/09/2023,Expense,Usersnap,,Tools & Subscription - G&A,19,54885569.63
02/09/2023,Expense,Usersnap,Harris Jose,Credit Card - Ramp,19,54885588.63
02/09/2023,Expense,Datadog,,Tools & Subscription - G&A,4.01,54885592.64
02/09/2023,Expense,Usersnap,,Tools & Subscription - G&A,19,54885611.64
02/09/2023,Expense,Taplio,,Tools & Subscription - G&A,39,54885650.64
02/09/2023,Expense,Usersnap,,Tools & Subscription - G&A,19,54885669.64
02/09/2023,Expense,Taplio,,Tools & Subscription - G&A,39,54885708.64
02/09/2023,Expense,Uber,,Travelling Expenses,7.98,54885716.62
02/09/2023,Expense,LottieFiles,,Tools & Subscription - G&A,239.88,54885956.5
02/09/2023,Expense,Datadog,,Tools & Subscription - G&A,4.01,54885960.51
02/09/2023,Expense,Uber,,Travelling Expenses,10.64,54885971.15
02/09/2023,Expense,Uber,Mike ross,Credit Card - Ramp,7.98,54885979.13
02/10/2023,Expense,Pause Cafe,Harvey Spector,Credit Card - Ramp,14,54885993.13
02/10/2023,Expense,HCC Medical Insurance Services,,Insurance,16.1,54886009.23
02/10/2023,Expense,Pause Cafe,Harvey Spector,Credit Card - Ramp,14,54886023.23
02/10/2023,Expense,Pause Cafe,Harvey Spector,Credit Card - Ramp,14,54886037.23
02/10/2023,Expense,HCC Medical Insurance Services,,Insurance,16.1,54886053.33
02/10/2023,Expense,Pause Cafe,Harvey Spector,Credit Card - Ramp,14,54886067.33
02/10/2023,Expense,Pause Cafe,Harvey Spector,Meals & Entertainment,14,54886081.33
02/10/2023,Expense,HCC Medical Insurance Services,Harvey Spector,Credit Card - Ramp,16.1,54886097.43
02/10/2023,Expense,HCC Medical Insurance Services,Harvey Spector,Credit Card - Ramp,16.1,54886113.53
02/10/2023,Expense,Pause Cafe,Harvey Spector,Meals & Entertainment,14,54886127.53
02/10/2023,Expense,HCC Medical Insurance Services,Harvey Spector,Credit Card - Ramp,16.1,54886143.63
02/10/2023,Expense,HCC Medical Insurance Services,Harvey Spector,Credit Card - Ramp,16.1,54886159.73
02/10/2023,Expense,HCC Medical Insurance Services,,Insurance,16.1,54886175.83
02/10/2023,Expense,HCC Medical Insurance Services,,Insurance,16.1,54886191.93
02/10/2023,Expense,Pause Cafe,Harvey Spector,Meals & Entertainment,14,54886205.93
02/10/2023,Expense,Pause Cafe,Harvey Spector,Meals & Entertainment,14,54886219.93
02/11/2023,Expense,Msw Mumbai Airport Loun Restaurant,Harvey Spector,Meals & Entertainment,46.15,54886266.08
02/11/2023,Expense,Msw Mumbai Airport Loun Restaurant,Harvey Spector,Credit Card - Ramp,46.15,54886312.23
02/11/2023,Expense,Msw Mumbai Airport Loun Restaurant,Harvey Spector,Credit Card - Ramp,46.15,54886358.38
02/11/2023,Expense,Msw Mumbai Airport Loun Restaurant,Harvey Spector,Credit Card - Ramp,46.15,54886404.53
02/11/2023,Expense,Msw Mumbai Airport Loun Restaurant,Harvey Spector,Credit Card - Ramp,46.15,54886450.68
02/11/2023,Expense,Msw Mumbai Airport Loun Restaurant,Harvey Spector,Meals & Entertainment,46.15,54886496.83
02/11/2023,Expense,Msw Mumbai Airport Loun Restaurant,Harvey Spector,Meals & Entertainment,46.15,54886542.98
02/11/2023,Expense,Msw Mumbai Airport Loun Restaurant,Harvey Spector,Meals & Entertainment,46.15,54886589.13
02/12/2023,Expense,WordPress,Harris Jose,Credit Card - Ramp,15.3,54886604.43
02/12/2023,Expense,WordPress,Harris Jose,Credit Card - Ramp,15.3,54886619.73
02/12/2023,Expense,WordPress,,Tools & Subscription - G&A,15.3,54886635.03
02/12/2023,Expense,WordPress,,Tools & Subscription - G&A,15.3,54886650.33
02/12/2023,Expense,WordPress,,Tools & Subscription - G&A,15.3,54886665.63
02/12/2023,Expense,WordPress,,Tools & Subscription - G&A,15.3,54886680.93
02/12/2023,Expense,WordPress,Harris Jose,Credit Card - Ramp,15.3,54886696.23
02/13/2023,Expense,Figma,Mike ross,Credit Card - Ramp,180,54886876.23
02/13/2023,Expense,Bourke Street Bakery,Mike ross,Meals & Entertainment,11.61,54886887.84
02/13/2023,Expense,Cuckoo Callay,Mike ross,Meals & Entertainment,20.5,54886908.34
02/13/2023,Expense,Cuckoo Callay,Mike ross,Credit Card - Ramp,20.5,54886928.84
02/13/2023,Expense,Figma,,Tools & Subscription - G&A,180,54887108.84
02/13/2023,Expense,Uber Eats,Mike ross,Credit Card - Ramp,21.77,54887130.61
02/13/2023,Expense,Vercel,,Tools & Subscription - G&A,260,54887390.61
02/13/2023,Expense,Bourke Street Bakery,Mike ross,Credit Card - Ramp,11.61,54887402.22
02/13/2023,Expense,Vercel,,Tools & Subscription - G&A,260,54887662.22
02/13/2023,Expense,Intercom,,Tools & Subscription - G&A,176,54887838.22
02/13/2023,Expense,Interact32,Harvey Spector,Tools & Subscription - G&A,9.89,54887848.11
02/13/2023,Expense,Uber Eats,Mike ross,Meals & Entertainment,21.77,54887869.88
02/13/2023,Expense,Circle Smile Cafe,Harvey Spector,Credit Card - Ramp,3.2,54887873.08
02/13/2023,Expense,Circle Smile Cafe,Harvey Spector,Meals & Entertainment,3.2,54887876.28
02/13/2023,Expense,Intercom,Balapavan Tirumani,Credit Card - Ramp,176,54888052.28
02/13/2023,Expense,Intercom,,Tools & Subscription - G&A,176,54888228.28
02/13/2023,Expense,Uber Eats,Mike ross,Meals & Entertainment,21.77,54888250.05
02/13/2023,Expense,Interact32,Harvey Spector,Tools & Subscription - G&A,9.89,54888259.94
02/13/2023,Expense,Cuckoo Callay,Mike ross,Meals & Entertainment,20.5,54888280.44
02/13/2023,Expense,Interact32,Harvey Spector,Credit Card - Ramp,9.89,54888290.33
02/13/2023,Expense,Cuckoo Callay,Mike ross,Meals & Entertainment,20.5,54888310.83
02/13/2023,Expense,Interact32,Harvey Spector,Tools & Subscription - G&A,9.89,54888320.72
02/13/2023,Expense,Circle Smile Cafe,Harvey Spector,Meals & Entertainment,3.2,54888323.92
02/13/2023,Expense,Bourke Street Bakery,Mike ross,Meals & Entertainment,11.61,54888335.53
02/13/2023,Expense,Uber Eats,Mike ross,Meals & Entertainment,21.77,54888357.3
02/13/2023,Expense,Intercom,,Tools & Subscription - G&A,176,54888533.3
02/13/2023,Expense,Vercel,,Tools & Subscription - G&A,260,54888793.3
02/13/2023,Expense,Figma,,Tools & Subscription - G&A,180,54888973.3
02/13/2023,Expense,Bourke Street Bakery,Mike ross,Meals & Entertainment,11.61,54888984.91
02/13/2023,Expense,Circle Smile Cafe,Harvey Spector,Meals & Entertainment,3.2,54888988.11
02/13/2023,Expense,Uber Eats,Mike ross,Credit Card - Ramp,21.77,54889009.88
02/13/2023,Expense,Figma,,Tools & Subscription - G&A,180,54889189.88
02/13/2023,Expense,Bourke Street Bakery,Mike ross,Credit Card - Ramp,11.61,54889201.49
02/13/2023,Expense,Circle Smile Cafe,Harvey Spector,Credit Card - Ramp,3.2,54889204.69
02/13/2023,Expense,Cuckoo Callay,Mike ross,Credit Card - Ramp,20.5,54889225.19
02/13/2023,Expense,Uber Eats,Mike ross,Credit Card - Ramp,21.77,54889246.96
02/13/2023,Expense,Vercel,Harris Jose,Credit Card - Ramp,260,54889506.96
02/13/2023,Expense,Cuckoo Callay,Mike ross,Credit Card - Ramp,20.5,54889527.46
02/13/2023,Expense,Interact32,Harvey Spector,Credit Card - Ramp,9.89,54889537.35
02/13/2023,Expense,Intercom,Balapavan Tirumani,Credit Card - Ramp,176,54889713.35
02/13/2023,Expense,Uber Eats,Mike ross,Credit Card - Ramp,21.77,54889735.12
02/13/2023,Expense,Circle Smile Cafe,Harvey Spector,Credit Card - Ramp,3.2,54889738.32
02/13/2023,Expense,Bourke Street Bakery,Mike ross,Credit Card - Ramp,11.61,54889749.93
02/13/2023,Expense,Figma,Mike ross,Credit Card - Ramp,180,54889929.93
02/13/2023,Expense,Interact32,Harvey Spector,Credit Card - Ramp,9.89,54889939.82
02/13/2023,Expense,Cuckoo Callay,Mike ross,Credit Card - Ramp,20.5,54889960.32
02/13/2023,Expense,Circle Smile Cafe,Harvey Spector,Credit Card - Ramp,3.2,54889963.52
02/13/2023,Expense,Bourke Street Bakery,Mike ross,Credit Card - Ramp,11.61,54889975.13
02/13/2023,Expense,Vercel,Harris Jose,Credit Card - Ramp,260,54890235.13
02/13/2023,Expense,Intercom,Balapavan Tirumani,Credit Card - Ramp,176,54890411.13
02/13/2023,Expense,Figma,Mike ross,Credit Card - Ramp,180,54890591.13
02/13/2023,Expense,Vercel,,Tools & Subscription - G&A,260,54890851.13
02/13/2023,Expense,Intercom,,Tools & Subscription - G&A,176,54891027.13
02/13/2023,Expense,Vercel,Harris Jose,Credit Card - Ramp,260,54891287.13
02/13/2023,Expense,Bourke Street Bakery,Mike ross,Meals & Entertainment,11.61,54891298.74
02/13/2023,Expense,Circle Smile Cafe,Harvey Spector,Meals & Entertainment,3.2,54891301.94
02/13/2023,Expense,Interact32,Harvey Spector,Tools & Subscription - G&A,9.89,54891311.83
02/13/2023,Expense,Cuckoo Callay,Mike ross,Meals & Entertainment,20.5,54891332.33
02/13/2023,Expense,Figma,,Tools & Subscription - G&A,180,54891512.33
02/13/2023,Expense,Uber Eats,Mike ross,Meals & Entertainment,21.77,54891534.1
02/14/2023,Expense,Suzuya Restaurant,Mike ross,Meals & Entertainment,106.24,54891640.34
02/14/2023,Expense,Intuit,,Tools & Subscription - G&A,55,54891695.34
02/14/2023,Expense,Suzuya Restaurant,Mike ross,Meals & Entertainment,106.24,54891801.58
02/14/2023,Expense,Intuit,,Tools & Subscription - G&A,55,54891856.58
02/14/2023,Expense,Starter Story,,Tools & Subscription - G&A,99,54891955.58
02/14/2023,Expense,MALAYSIA,Harvey Spector,Meals & Entertainment,13.79,54891969.37
02/14/2023,Expense,St Judes Coffee Co Pl Restaurant,Mike ross,Meals & Entertainment,32.08,54892001.45
02/14/2023,Expense,Suzuya Restaurant,Mike ross,Credit Card - Ramp,106.24,54892107.69
02/14/2023,Expense,MALAYSIA,Harvey Spector,Meals & Entertainment,13.79,54892121.48
02/14/2023,Expense,St Judes Coffee Co Pl Restaurant,Mike ross,Meals & Entertainment,32.08,54892153.56
02/14/2023,Expense,MALAYSIA,Harvey Spector,Meals & Entertainment,13.79,54892167.35
02/14/2023,Expense,Starter Story,,Tools & Subscription - G&A,99,54892266.35
02/14/2023,Expense,MALAYSIA,Harvey Spector,Credit Card - Ramp,13.79,54892280.14
02/14/2023,Expense,Starter Story,,Tools & Subscription - G&A,99,54892379.14
02/14/2023,Expense,St Judes Coffee Co Pl Restaurant,Mike ross,Credit Card - Ramp,32.08,54892411.22
02/14/2023,Expense,St Judes Coffee Co Pl Restaurant,Mike ross,Meals & Entertainment,32.08,54892443.3
02/14/2023,Expense,Intuit,Harvey Spector,Credit Card - Ramp,55,54892498.3
02/14/2023,Expense,MALAYSIA,Harvey Spector,Credit Card - Ramp,13.79,54892512.09
02/14/2023,Expense,St Judes Coffee Co Pl Restaurant,Mike ross,Credit Card - Ramp,32.08,54892544.17
02/14/2023,Expense,Intuit,,Tools & Subscription - G&A,55,54892599.17
02/14/2023,Expense,Intuit,,Tools & Subscription - G&A,55,54892654.17
02/14/2023,Expense,Starter Story,Harvey Spector,Credit Card - Ramp,99,54892753.17
02/14/2023,Expense,Suzuya Restaurant,Mike ross,Meals & Entertainment,106.24,54892859.41
02/14/2023,Expense,St Judes Coffee Co Pl Restaurant,Mike ross,Credit Card - Ramp,32.08,54892891.49
02/14/2023,Expense,MALAYSIA,Harvey Spector,Meals & Entertainment,13.79,54892905.28
02/14/2023,Expense,Starter Story,,Tools & Subscription - G&A,99,54893004.28
02/14/2023,Expense,Starter Story,Harvey Spector,Credit Card - Ramp,99,54893103.28
02/14/2023,Expense,Intuit,Harvey Spector,Credit Card - Ramp,55,54893158.28
02/14/2023,Expense,Suzuya Restaurant,Mike ross,Credit Card - Ramp,106.24,54893264.52
02/14/2023,Expense,St Judes Coffee Co Pl Restaurant,Mike ross,Meals & Entertainment,32.08,54893296.6
02/14/2023,Expense,Intuit,Harvey Spector,Credit Card - Ramp,55,54893351.6
02/14/2023,Expense,Starter Story,Harvey Spector,Credit Card - Ramp,99,54893450.6
02/14/2023,Expense,Suzuya Restaurant,Mike ross,Credit Card - Ramp,106.24,54893556.84
02/14/2023,Expense,MALAYSIA,Harvey Spector,Credit Card - Ramp,13.79,54893570.63
02/14/2023,Expense,Suzuya Restaurant,Mike ross,Meals & Entertainment,106.24,54893676.87
02/14/2023,Expense,MALAYSIA,Harvey Spector,Credit Card - Ramp,13.79,54893690.66
02/14/2023,Expense,Suzuya Restaurant,Mike ross,Credit Card - Ramp,106.24,54893796.9
02/14/2023,Expense,St Judes Coffee Co Pl Restaurant,Mike ross,Credit Card - Ramp,32.08,54893828.98
02/15/2023,Expense,Reuben Hills,Mike ross,Credit Card - Ramp,20.99,54893849.97
02/15/2023,Expense,Envato,Mike ross,Credit Card - Ramp,34.1,54893884.07
02/15/2023,Expense,Reuben Hills,Mike ross,Credit Card - Ramp,9.82,54893893.89
02/15/2023,Expense,Reuben Hills,Mike ross,Credit Card - Ramp,20.99,54893914.88
02/15/2023,Expense,Beam Mobility Malaysia,,Travelling Expenses,3.44,54893918.32
02/15/2023,Expense,Reuben Hills,Mike ross,Meals & Entertainment,20.99,54893939.31
02/15/2023,Expense,Envato,Mike ross,Credit Card - Ramp,20.9,54893960.21
02/15/2023,Expense,Envato,Mike ross,Credit Card - Ramp,20.9,54893981.11
02/15/2023,Expense,Reuben Hills,Mike ross,Meals & Entertainment,9.82,54893990.93
02/15/2023,Expense,Uber,,Travelling Expenses,14.75,54894005.68
02/15/2023,Expense,Envato,Mike ross,Advertising & marketing,34.1,54894039.78
02/15/2023,Expense,Beam Mobility Malaysia,,Travelling Expenses,3.44,54894043.22
02/15/2023,Expense,Reuben Hills,Mike ross,Meals & Entertainment,20.99,54894064.21
02/15/2023,Expense,Envato,Mike ross,Advertising & marketing,20.9,54894085.11
02/15/2023,Expense,Banyan Tree,,Tools & Subscription - G&A,284.28,54894369.39
02/15/2023,Expense,Reuben Hills,Mike ross,Meals & Entertainment,9.82,54894379.21
02/15/2023,Expense,Reuben Hills,Mike ross,Credit Card - Ramp,9.82,54894389.03
02/15/2023,Expense,Beam Mobility Malaysia,Harvey Spector,Credit Card - Ramp,3.44,54894392.47
02/15/2023,Expense,Reuben Hills,Mike ross,Credit Card - Ramp,20.99,54894413.46
02/15/2023,Expense,Reuben Hills,Mike ross,Credit Card - Ramp,9.82,54894423.28
02/15/2023,Expense,Banyan Tree,,Tools & Subscription - G&A,284.28,54894707.56
02/15/2023,Expense,Envato,Mike ross,Advertising & marketing,34.1,54894741.66
02/15/2023,Expense,Uber,,Travelling Expenses,14.75,54894756.41
02/15/2023,Expense,Banyan Tree,Harvey Spector,Credit Card - Ramp,284.28,54895040.69
02/15/2023,Expense,Banyan Tree,Harvey Spector,Credit Card - Ramp,284.28,54895324.97
02/15/2023,Expense,Envato,Mike ross,Credit Card - Ramp,20.9,54895345.87
02/15/2023,Expense,Envato,Mike ross,Credit Card - Ramp,34.1,54895379.97
02/15/2023,Expense,Reuben Hills,Mike ross,Meals & Entertainment,20.99,54895400.96
02/15/2023,Expense,Envato,Mike ross,Advertising & marketing,34.1,54895435.06
02/15/2023,Expense,Envato,Mike ross,Advertising & marketing,20.9,54895455.96
02/15/2023,Expense,Beam Mobility Malaysia,Harvey Spector,Credit Card - Ramp,3.44,54895459.4
02/15/2023,Expense,Uber,,Travelling Expenses,14.75,54895474.15
02/15/2023,Expense,Envato,Mike ross,Advertising & marketing,20.9,54895495.05
02/15/2023,Expense,Banyan Tree,,Tools & Subscription - G&A,284.28,54895779.33
02/15/2023,Expense,Reuben Hills,Mike ross,Meals & Entertainment,9.82,54895789.15
02/15/2023,Expense,Envato,Mike ross,Advertising & marketing,34.1,54895823.25
02/15/2023,Expense,Banyan Tree,,Tools & Subscription - G&A,284.28,54896107.53
02/15/2023,Expense,Reuben Hills,Mike ross,Meals & Entertainment,9.82,54896117.35
02/15/2023,Expense,Uber,Mike ross,Credit Card - Ramp,14.75,54896132.1
02/15/2023,Expense,Beam Mobility Malaysia,,Travelling Expenses,3.44,54896135.54
02/15/2023,Expense,Reuben Hills,Mike ross,Meals & Entertainment,20.99,54896156.53
02/15/2023,Expense,Uber,,Travelling Expenses,14.75,54896171.28
02/15/2023,Expense,Envato,Mike ross,Advertising & marketing,20.9,54896192.18
02/15/2023,Expense,Beam Mobility Malaysia,,Travelling Expenses,3.44,54896195.62
02/15/2023,Expense,Banyan Tree,Harvey Spector,Credit Card - Ramp,284.28,54896479.9
02/15/2023,Expense,Reuben Hills,Mike ross,Credit Card - Ramp,9.82,54896489.72
02/15/2023,Expense,Envato,Mike ross,Credit Card - Ramp,34.1,54896523.82
02/15/2023,Expense,Reuben Hills,Mike ross,Credit Card - Ramp,20.99,54896544.81
02/15/2023,Expense,Envato,Mike ross,Credit Card - Ramp,34.1,54896578.91
02/15/2023,Expense,Beam Mobility Malaysia,Harvey Spector,Credit Card - Ramp,3.44,54896582.35
02/15/2023,Expense,Uber,Mike ross,Credit Card - Ramp,14.75,54896597.1
02/15/2023,Expense,Uber,Mike ross,Credit Card - Ramp,14.75,54896611.85
02/15/2023,Expense,Envato,Mike ross,Credit Card - Ramp,20.9,54896632.75
02/16/2023,Expense,LS Graphics,,Tools & Subscription - G&A,35.2,54896667.95
02/16/2023,Expense,LS Graphics,,Tools & Subscription - G&A,35.2,54896703.15
02/16/2023,Expense,Uber,,Travelling Expenses,8.97,54896712.12
02/16/2023,Expense,Uber,,Travelling Expenses,8.97,54896721.09
02/16/2023,Expense,Uber Eats,Mike ross,Meals & Entertainment,50.15,54896771.24
02/16/2023,Expense,LS Graphics,Mike ross,Credit Card - Ramp,35.2,54896806.44
02/16/2023,Expense,LS Graphics,Mike ross,Credit Card - Ramp,35.2,54896841.64
02/16/2023,Expense,Zapier,Harvey Spector,Credit Card - Ramp,29.99,54896871.63
02/16/2023,Expense,Notion Labs,Mike ross,Credit Card - Ramp,150,54897021.63
02/16/2023,Expense,Zapier,Harvey Spector,Credit Card - Ramp,29.99,54897051.62
02/16/2023,Expense,Uber,Mike ross,Credit Card - Ramp,15.42,54897067.04
02/16/2023,Expense,Linear,,Tools & Subscription - G&A,160,54897227.04
02/16/2023,Expense,Uber,Mike ross,Credit Card - Ramp,15.42,54897242.46
02/16/2023,Expense,Uber Eats,Mike ross,Credit Card - Ramp,50.15,54897292.61
02/16/2023,Expense,Zapier,,Tools & Subscription - G&A,29.99,54897322.6
02/16/2023,Expense,Uber Eats,Mike ross,Meals & Entertainment,50.15,54897372.75
02/16/2023,Expense,Notion Labs,,Tools & Subscription - G&A,150,54897522.75
02/16/2023,Expense,Reuben Hills,Mike ross,Credit Card - Ramp,35.75,54897558.5
02/16/2023,Expense,Uber Eats,Mike ross,Credit Card - Ramp,50.15,54897608.65
02/16/2023,Expense,Reuben Hills,Mike ross,Meals & Entertainment,35.75,54897644.4
02/16/2023,Expense,Linear,,Tools & Subscription - G&A,160,54897804.4
02/16/2023,Expense,Uber,,Travelling Expenses,15.42,54897819.82
02/16/2023,Expense,Uber,Mike ross,Credit Card - Ramp,8.97,54897828.79
02/16/2023,Expense,Zapier,,Tools & Subscription - G&A,29.99,54897858.78
02/16/2023,Expense,LS Graphics,,Tools & Subscription - G&A,35.2,54897893.98
02/16/2023,Expense,Reuben Hills,Mike ross,Credit Card - Ramp,35.75,54897929.73
02/16/2023,Expense,Uber,,Travelling Expenses,15.42,54897945.15
02/16/2023,Expense,Uber,Mike ross,Credit Card - Ramp,8.97,54897954.12
02/16/2023,Expense,Reuben Hills,Mike ross,Meals & Entertainment,35.75,54897989.87
02/16/2023,Expense,Uber,,Travelling Expenses,15.42,54898005.29
02/16/2023,Expense,Notion Labs,,Tools & Subscription - G&A,150,54898155.29
02/16/2023,Expense,Linear,,Tools & Subscription - G&A,160,54898315.29
02/16/2023,Expense,Reuben Hills,Mike ross,Meals & Entertainment,35.75,54898351.04
02/16/2023,Expense,Linear,Chad Blumenthal,Credit Card - Ramp,160,54898511.04
02/16/2023,Expense,Linear,Chad Blumenthal,Credit Card - Ramp,160,54898671.04
02/16/2023,Expense,Notion Labs,Mike ross,Credit Card - Ramp,150,54898821.04
02/16/2023,Expense,Uber Eats,Mike ross,Credit Card - Ramp,50.15,54898871.19
02/16/2023,Expense,Uber,,Travelling Expenses,15.42,54898886.61
02/16/2023,Expense,Linear,,Tools & Subscription - G&A,160,54899046.61
02/16/2023,Expense,Reuben Hills,Mike ross,Meals & Entertainment,35.75,54899082.36
02/16/2023,Expense,Notion Labs,,Tools & Subscription - G&A,150,54899232.36
02/16/2023,Expense,Uber Eats,Mike ross,Meals & Entertainment,50.15,54899282.51
02/16/2023,Expense,LS Graphics,,Tools & Subscription - G&A,35.2,54899317.71
02/16/2023,Expense,Uber,,Travelling Expenses,8.97,54899326.68
02/16/2023,Expense,Reuben Hills,Mike ross,Credit Card - Ramp,35.75,54899362.43
02/16/2023,Expense,Uber,Mike ross,Credit Card - Ramp,15.42,54899377.85
02/16/2023,Expense,Uber,Mike ross,Credit Card - Ramp,8.97,54899386.82
02/16/2023,Expense,Uber Eats,Mike ross,Credit Card - Ramp,50.15,54899436.97
02/16/2023,Expense,Reuben Hills,Mike ross,Credit Card - Ramp,35.75,54899472.72
02/16/2023,Expense,Notion Labs,,Tools & Subscription - G&A,150,54899622.72
02/16/2023,Expense,Notion Labs,Mike ross,Credit Card - Ramp,150,54899772.72
02/16/2023,Expense,Linear,Chad Blumenthal,Credit Card - Ramp,160,54899932.72
02/16/2023,Expense,LS Graphics,Mike ross,Credit Card - Ramp,35.2,54899967.92
02/16/2023,Expense,Zapier,Harvey Spector,Credit Card - Ramp,29.99,54899997.91
02/16/2023,Expense,Zapier,,Tools & Subscription - G&A,29.99,54900027.9
02/16/2023,Expense,Uber,,Travelling Expenses,8.97,54900036.87
02/16/2023,Expense,Uber Eats,Mike ross,Meals & Entertainment,50.15,54900087.02
02/16/2023,Expense,Zapier,,Tools & Subscription - G&A,29.99,54900117.01
02/17/2023,Expense,Banyan Tree,Harvey Spector,Credit Card - Ramp,33.59,54900150.6
02/17/2023,Expense,Banyan Tree,,Tools & Subscription - G&A,33.59,54900184.19
02/17/2023,Expense,Banyan Tree,,Tools & Subscription - G&A,33.59,54900217.78
02/17/2023,Expense,Banyan Tree,Harvey Spector,Credit Card - Ramp,33.59,54900251.37
02/17/2023,Expense,Banyan Tree,,Tools & Subscription - G&A,33.59,54900284.96
02/17/2023,Expense,Banyan Tree,,Tools & Subscription - G&A,33.59,54900318.55
02/17/2023,Expense,Banyan Tree,Harvey Spector,Credit Card - Ramp,33.59,54900352.14
02/18/2023,Expense,Uber,,Travelling Expenses,22.66,54900374.8
02/18/2023,Expense,LinkedIn,Mike ross,Credit Card - Ramp,154.93,54900529.73
02/18/2023,Expense,Uber,,Travelling Expenses,22.66,54900552.39
02/18/2023,Expense,Superhuman,,Professional Service Charges,30,54900582.39
02/18/2023,Expense,LinkedIn,,Tools & Subscription - G&A,154.93,54900737.32
02/18/2023,Expense,LinkedIn,Mike ross,Credit Card - Ramp,154.93,54900892.25
02/18/2023,Expense,LinkedIn,,Tools & Subscription - G&A,154.93,54901047.18
02/18/2023,Expense,Superhuman,Harvey Spector,Credit Card - Ramp,30,54901077.18
02/18/2023,Expense,Superhuman,,Professional Service Charges,30,54901107.18
02/18/2023,Expense,Superhuman,Harvey Spector,Credit Card - Ramp,30,54901137.18
02/18/2023,Expense,Superhuman,Harvey Spector,Credit Card - Ramp,30,54901167.18
02/18/2023,Expense,Uber,,Travelling Expenses,22.66,54901189.84
02/18/2023,Expense,Superhuman,Harvey Spector,Credit Card - Ramp,30,54901219.84
02/18/2023,Expense,Uber,Mike ross,Credit Card - Ramp,22.66,54901242.5
02/18/2023,Expense,Uber,,Travelling Expenses,22.66,54901265.16
02/18/2023,Expense,Uber,Mike ross,Credit Card - Ramp,22.66,54901287.82
02/18/2023,Expense,Uber,Mike ross,Credit Card - Ramp,22.66,54901310.48
02/18/2023,Expense,Superhuman,,Professional Service Charges,30,54901340.48
02/18/2023,Expense,LinkedIn,Mike ross,Credit Card - Ramp,154.93,54901495.41
02/18/2023,Expense,LinkedIn,,Tools & Subscription - G&A,154.93,54901650.34
02/18/2023,Expense,Superhuman,,Professional Service Charges,30,54901680.34
02/18/2023,Expense,LinkedIn,,Tools & Subscription - G&A,154.93,54901835.27
02/19/2023,Expense,Twitter,Harvey Spector,Credit Card - Ramp,7.86,54901843.13
02/19/2023,Expense,LinkedIn,Harvey Spector,Credit Card - Ramp,25.63,54901868.76
02/19/2023,Expense,LinkedIn,Harvey Spector,Credit Card - Ramp,25.63,54901894.39
02/19/2023,Expense,The New York Times,,General business expenses:Memberships & subscriptions,8.26,54901902.65
02/19/2023,Expense,Twitter,,Tools & Subscription - G&A,7.86,54901910.51
02/19/2023,Expense,The New York Times,,General business expenses:Memberships & subscriptions,8.26,54901918.77
02/19/2023,Expense,Uber Eats,Mike ross,Credit Card - Ramp,30.27,54901949.04
02/19/2023,Expense,The New York Times,Mike ross,Credit Card - Ramp,8.26,54901957.3
02/19/2023,Expense,LinkedIn,,Tools & Subscription - G&A,25.63,54901982.93
02/19/2023,Expense,Uber Eats,Mike ross,Credit Card - Ramp,30.27,54902013.2
02/19/2023,Expense,The New York Times,Mike ross,Credit Card - Ramp,8.26,54902021.46
02/19/2023,Expense,Uber Eats,Mike ross,Meals & Entertainment,30.27,54902051.73
02/19/2023,Expense,LinkedIn,Harvey Spector,Credit Card - Ramp,25.63,54902077.36
02/19/2023,Expense,Uber Eats,Mike ross,Credit Card - Ramp,30.27,54902107.63
02/19/2023,Expense,Twitter,,Tools & Subscription - G&A,7.86,54902115.49
02/19/2023,Expense,Uber Eats,Mike ross,Credit Card - Ramp,30.27,54902145.76
02/19/2023,Expense,The New York Times,Mike ross,Credit Card - Ramp,8.26,54902154.02
02/19/2023,Expense,Uber Eats,Mike ross,Meals & Entertainment,30.27,54902184.29
02/19/2023,Expense,Uber Eats,Mike ross,Meals & Entertainment,30.27,54902214.56
02/19/2023,Expense,The New York Times,Mike ross,Credit Card - Ramp,8.26,54902222.82
02/19/2023,Expense,Uber Eats,Mike ross,Meals & Entertainment,30.27,54902253.09
02/19/2023,Expense,The New York Times,,General business expenses:Memberships & subscriptions,8.26,54902261.35
02/19/2023,Expense,LinkedIn,,Tools & Subscription - G&A,25.63,54902286.98
02/19/2023,Expense,Twitter,Harvey Spector,Credit Card - Ramp,7.86,54902294.84
02/19/2023,Expense,Twitter,,Tools & Subscription - G&A,7.86,54902302.7
02/19/2023,Expense,Twitter,,Tools & Subscription - G&A,7.86,54902310.56
02/19/2023,Expense,LinkedIn,,Tools & Subscription - G&A,25.63,54902336.19
02/19/2023,Expense,Twitter,Harvey Spector,Credit Card - Ramp,7.86,54902344.05
02/19/2023,Expense,LinkedIn,,Tools & Subscription - G&A,25.63,54902369.68
02/19/2023,Expense,The New York Times,,General business expenses:Memberships & subscriptions,8.26,54902377.94
02/20/2023,Expense,LinkedIn,,Tools & Subscription - G&A,119.97,54902497.91
02/20/2023,Expense,Industry Beans York St,Mike ross,Meals & Entertainment,3.58,54902501.49
02/20/2023,Expense,Australia,Mike ross,Office expenses:Office supplies,1204.36,54903705.85
02/20/2023,Expense,Maloneys Grocer,,Meals & Entertainment,31.71,54903737.56
02/20/2023,Expense,Australia,Mike ross,Office expenses:Office supplies,122.57,54903860.13
02/20/2023,Expense,Australia,Mike ross,Office expenses:Office supplies,37.84,54903897.97
02/20/2023,Expense,LinkedIn,,Tools & Subscription - G&A,119.97,54904017.94
02/20/2023,Expense,Maloneys Grocer,Mike ross,Credit Card - Ramp,31.71,54904049.65
02/20/2023,Expense,Industry Beans York St,Mike ross,Credit Card - Ramp,3.58,54904053.23
02/20/2023,Expense,Industry Beans York St,Mike ross,Meals & Entertainment,3.58,54904056.81
02/20/2023,Expense,Uber,,Travelling Expenses,15.37,54904072.18
02/20/2023,Expense,Australia,Mike ross,Office expenses:Office supplies,1204.36,54905276.54
02/20/2023,Expense,Australia,Mike ross,Office expenses:Office supplies,122.57,54905399.11
02/20/2023,Expense,Uber,,Travelling Expenses,15.37,54905414.48
02/20/2023,Expense,Maloneys Grocer,Mike ross,Credit Card - Ramp,31.71,54905446.19
02/20/2023,Expense,Australia,Mike ross,Office expenses:Office supplies,37.84,54905484.03
02/20/2023,Expense,Industry Beans York St,Mike ross,Credit Card - Ramp,3.58,54905487.61
02/20/2023,Expense,Maloneys Grocer,,Meals & Entertainment,31.71,54905519.32
02/20/2023,Expense,Uber,,Travelling Expenses,15.37,54905534.69
02/20/2023,Expense,Australia,Mike ross,Office expenses:Office supplies,37.84,54905572.53
02/20/2023,Expense,Australia,Mike ross,Office expenses:Office supplies,122.57,54905695.1
02/20/2023,Expense,Maloneys Grocer,Mike ross,Credit Card - Ramp,31.71,54905726.81
02/20/2023,Expense,Uber,,Travelling Expenses,15.37,54905742.18
02/20/2023,Expense,Australia,Mike ross,Office expenses:Office supplies,37.84,54905780.02
02/20/2023,Expense,Maloneys Grocer,,Meals & Entertainment,31.71,54905811.73
02/20/2023,Expense,Australia,Mike ross,Credit Card - Ramp,1204.36,54907016.09
02/20/2023,Expense,LinkedIn,,Tools & Subscription - G&A,119.97,54907136.06
02/20/2023,Expense,Industry Beans York St,Mike ross,Credit Card - Ramp,3.58,54907139.64
02/20/2023,Expense,Uber,Mike ross,Credit Card - Ramp,15.37,54907155.01
02/20/2023,Expense,Industry Beans York St,Mike ross,Credit Card - Ramp,3.58,54907158.59
02/20/2023,Expense,Australia,Mike ross,Office expenses:Office supplies,1204.36,54908362.95
02/20/2023,Expense,Uber,Mike ross,Credit Card - Ramp,15.37,54908378.32
02/20/2023,Expense,LinkedIn,Niteesha Ravela,Credit Card - Ramp,119.97,54908498.29
02/20/2023,Expense,LinkedIn,Niteesha Ravela,Credit Card - Ramp,119.97,54908618.26
02/20/2023,Expense,Industry Beans York St,Mike ross,Meals & Entertainment,3.58,54908621.84
02/20/2023,Expense,LinkedIn,,Tools & Subscription - G&A,119.97,54908741.81
02/20/2023,Expense,Maloneys Grocer,,Meals & Entertainment,31.71,54908773.52
02/20/2023,Expense,Uber,Mike ross,Credit Card - Ramp,15.37,54908788.89
02/20/2023,Expense,Maloneys Grocer,Mike ross,Credit Card - Ramp,31.71,54908820.6
02/20/2023,Expense,Industry Beans York St,Mike ross,Meals & Entertainment,3.58,54908824.18
02/20/2023,Expense,Australia,Mike ross,Office expenses:Office supplies,1204.36,54910028.54
02/20/2023,Expense,Australia,Mike ross,Credit Card - Ramp,122.57,54910151.11
02/20/2023,Expense,Australia,Mike ross,Credit Card - Ramp,1204.36,54911355.47
02/20/2023,Expense,LinkedIn,Niteesha Ravela,Credit Card - Ramp,119.97,54911475.44
02/20/2023,Expense,Australia,Mike ross,Credit Card - Ramp,37.84,54911513.28
02/20/2023,Expense,Australia,Mike ross,Credit Card - Ramp,37.84,54911551.12
02/20/2023,Expense,Australia,Mike ross,Credit Card - Ramp,1204.36,54912755.48
02/20/2023,Expense,Australia,Mike ross,Credit Card - Ramp,122.57,54912878.05
02/20/2023,Expense,Australia,Mike ross,Credit Card - Ramp,122.57,54913000.62
02/20/2023,Expense,Australia,Mike ross,Credit Card - Ramp,37.84,54913038.46
02/20/2023,Expense,Australia,Mike ross,Credit Card - Ramp,122.57,54913161.03
02/20/2023,Expense,Australia,Mike ross,Credit Card - Ramp,1204.36,54914365.39
02/20/2023,Expense,Australia,Mike ross,Credit Card - Ramp,37.84,54914403.23
02/20/2023,Expense,Australia,Mike ross,Office expenses:Office supplies,122.57,54914525.8
02/21/2023,Expense,Reuben Hills,Mike ross,Meals & Entertainment,22.28,54914548.08
02/21/2023,Expense,FDC,,General business expenses:Memberships & subscriptions,6.99,54914555.07
02/21/2023,Expense,Reuben Hills,Mike ross,Meals & Entertainment,22.28,54914577.35
02/21/2023,Expense,Artificer,,Meals & Entertainment,6.92,54914584.27
02/21/2023,Expense,FDC,Harvey Spector,Credit Card - Ramp,6.99,54914591.26
02/21/2023,Expense,Bourke Street Bakery,Mike ross,Meals & Entertainment,21.33,54914612.59
02/21/2023,Expense,Bourke Street Bakery,Mike ross,Credit Card - Ramp,21.33,54914633.92
02/21/2023,Expense,Reuben Hills,Mike ross,Meals & Entertainment,22.28,54914656.2
02/21/2023,Expense,Artificer,Mike ross,Credit Card - Ramp,6.92,54914663.12
02/21/2023,Expense,FDC,Harvey Spector,Credit Card - Ramp,6.99,54914670.11
02/21/2023,Expense,Bourke Street Bakery,Mike ross,Meals & Entertainment,21.33,54914691.44
02/21/2023,Expense,Reuben Hills,Mike ross,Credit Card - Ramp,22.28,54914713.72
02/21/2023,Expense,Artificer,,Meals & Entertainment,6.92,54914720.64
02/21/2023,Expense,Artificer,,Meals & Entertainment,6.92,54914727.56
02/21/2023,Expense,Bourke Street Bakery,Mike ross,Credit Card - Ramp,21.33,54914748.89
02/21/2023,Expense,FDC,,General business expenses:Memberships & subscriptions,6.99,54914755.88
02/21/2023,Expense,Reuben Hills,Mike ross,Meals & Entertainment,22.28,54914778.16
02/21/2023,Expense,Bourke Street Bakery,Mike ross,Meals & Entertainment,21.33,54914799.49
02/21/2023,Expense,Bourke Street Bakery,Mike ross,Meals & Entertainment,21.33,54914820.82
02/21/2023,Expense,Artificer,Mike ross,Credit Card - Ramp,6.92,54914827.74
02/21/2023,Expense,Reuben Hills,Mike ross,Credit Card - Ramp,22.28,54914850.02
02/21/2023,Expense,Reuben Hills,Mike ross,Credit Card - Ramp,22.28,54914872.3
02/21/2023,Expense,FDC,,General business expenses:Memberships & subscriptions,6.99,54914879.29
02/21/2023,Expense,Bourke Street Bakery,Mike ross,Credit Card - Ramp,21.33,54914900.62
02/21/2023,Expense,FDC,Harvey Spector,Credit Card - Ramp,6.99,54914907.61
02/21/2023,Expense,Reuben Hills,Mike ross,Credit Card - Ramp,22.28,54914929.89
02/21/2023,Expense,Artificer,Mike ross,Credit Card - Ramp,6.92,54914936.81
02/21/2023,Expense,Bourke Street Bakery,Mike ross,Credit Card - Ramp,21.33,54914958.14
02/21/2023,Expense,FDC,,General business expenses:Memberships & subscriptions,6.99,54914965.13
02/21/2023,Expense,Artificer,Mike ross,Credit Card - Ramp,6.92,54914972.05
02/21/2023,Expense,Artificer,,Meals & Entertainment,6.92,54914978.97
02/21/2023,Expense,FDC,Harvey Spector,Credit Card - Ramp,6.99,54914985.96
02/22/2023,Expense,Dovetail,,Tools & Subscription - G&A,70,54915055.96
02/22/2023,Expense,Bar Conte,Mike ross,Meals & Entertainment,14.54,54915070.5
02/22/2023,Expense,Vimcal,,Tools & Subscription - G&A,15,54915085.5
02/22/2023,Credit Card Payment,,RAMP STATEMENT,Account1,-4447.56,54910637.94
02/22/2023,Expense,Uber,,Travelling Expenses,11.33,54910649.27
02/22/2023,Expense,Uber,Mike ross,Credit Card - Ramp,11.33,54910660.6
02/22/2023,Credit Card Payment,,RAMP STATEMENT,Credit Card - Ramp,-4447.56,54906213.04
02/22/2023,Expense,Lemon Squeezy,,Tools & Subscription - G&A,89,54906302.04
02/22/2023,Expense,Typeform,,Tools & Subscription - G&A,52.5,54906354.54
02/22/2023,Expense,Typeform,,Tools & Subscription - G&A,52,54906406.54
02/22/2023,Expense,Bar Conte,Mike ross,Credit Card - Ramp,14.54,54906421.08
02/22/2023,Expense,Vimcal,Harvey Spector,Credit Card - Ramp,15,54906436.08
02/22/2023,Expense,Typeform,,Tools & Subscription - G&A,52.5,54906488.58
02/22/2023,Expense,Ichiban Boshi,Mike ross,Meals & Entertainment,33.04,54906521.62
02/22/2023,Expense,Bar Conte,Mike ross,Meals & Entertainment,14.54,54906536.16
02/22/2023,Expense,Dovetail,,Tools & Subscription - G&A,70,54906606.16
02/22/2023,Expense,Dovetail,Harvey Spector,Credit Card - Ramp,70,54906676.16
02/22/2023,Expense,Dovetail,,Tools & Subscription - G&A,70,54906746.16
02/22/2023,Expense,Vimcal,Harvey Spector,Credit Card - Ramp,15,54906761.16
02/22/2023,Expense,Ichiban Boshi,Mike ross,Credit Card - Ramp,33.04,54906794.2
02/22/2023,Expense,Typeform,Harvey Spector,Credit Card - Ramp,52,54906846.2
02/22/2023,Expense,Typeform,,Tools & Subscription - G&A,52,54906898.2
02/22/2023,Expense,Ichiban Boshi,Mike ross,Credit Card - Ramp,33.04,54906931.24
02/22/2023,Expense,Bar Conte,Mike ross,Credit Card - Ramp,14.54,54906945.78
02/22/2023,Expense,Vimcal,,Tools & Subscription - G&A,15,54906960.78
02/22/2023,Expense,Uber,,Travelling Expenses,11.33,54906972.11
02/22/2023,Expense,Ichiban Boshi,Mike ross,Meals & Entertainment,33.04,54907005.15
02/22/2023,Expense,Lemon Squeezy,,Tools & Subscription - G&A,89,54907094.15
02/22/2023,Credit Card Payment,,RAMP STATEMENT,Credit Card - Ramp,-4447.56,54902646.59
02/22/2023,Expense,Typeform,Harvey Spector,Credit Card - Ramp,52.5,54902699.09
02/22/2023,Expense,Lemon Squeezy,Mike ross,Credit Card - Ramp,89,54902788.09
02/22/2023,Credit Card Payment,,RAMP STATEMENT,Account1,-4447.56,54898340.53
02/22/2023,Expense,Typeform,Harvey Spector,Credit Card - Ramp,52,54898392.53
02/22/2023,Expense,Uber,Mike ross,Credit Card - Ramp,11.33,54898403.86
02/22/2023,Expense,Lemon Squeezy,,Tools & Subscription - G&A,89,54898492.86
02/22/2023,Expense,Typeform,,Tools & Subscription - G&A,52,54898544.86
02/22/2023,Expense,Bar Conte,Mike ross,Meals & Entertainment,14.54,54898559.4
02/22/2023,Expense,Typeform,,Tools & Subscription - G&A,52.5,54898611.9
02/22/2023,Expense,Lemon Squeezy,,Tools & Subscription - G&A,89,54898700.9
02/22/2023,Expense,Ichiban Boshi,Mike ross,Meals & Entertainment,33.04,54898733.94
02/22/2023,Expense,Vimcal,,Tools & Subscription - G&A,15,54898748.94
02/22/2023,Expense,Dovetail,,Tools & Subscription - G&A,70,54898818.94
02/22/2023,Expense,Bar Conte,Mike ross,Credit Card - Ramp,14.54,54898833.48
02/22/2023,Expense,Ichiban Boshi,Mike ross,Credit Card - Ramp,33.04,54898866.52
02/22/2023,Expense,Uber,,Travelling Expenses,11.33,54898877.85
02/22/2023,Credit Card Payment,,RAMP STATEMENT,Account1,-4447.56,54894430.29
02/22/2023,Expense,Vimcal,,Tools & Subscription - G&A,15,54894445.29
02/22/2023,Expense,Dovetail,Harvey Spector,Credit Card - Ramp,70,54894515.29
02/22/2023,Expense,Typeform,Harvey Spector,Credit Card - Ramp,52.5,54894567.79
02/22/2023,Expense,Ichiban Boshi,Mike ross,Meals & Entertainment,33.04,54894600.83
02/22/2023,Expense,Lemon Squeezy,Mike ross,Credit Card - Ramp,89,54894689.83
02/22/2023,Credit Card Payment,,RAMP STATEMENT,Credit Card - Ramp,-4447.56,54890242.27
02/22/2023,Expense,Uber,,Travelling Expenses,11.33,54890253.6
02/22/2023,Expense,Bar Conte,Mike ross,Meals & Entertainment,14.54,54890268.14
02/22/2023,Expense,Typeform,,Tools & Subscription - G&A,52,54890320.14
02/22/2023,Credit Card Payment,,RAMP STATEMENT,Credit Card - Ramp,-4447.56,54885872.58
02/22/2023,Expense,Uber,Mike ross,Credit Card - Ramp,11.33,54885883.91
02/22/2023,Credit Card Payment,,RAMP STATEMENT,Account1,-4447.56,54881436.35
02/22/2023,Expense,Dovetail,Harvey Spector,Credit Card - Ramp,70,54881506.35
02/22/2023,Expense,Typeform,,Tools & Subscription - G&A,52.5,54881558.85
02/22/2023,Expense,Typeform,Harvey Spector,Credit Card - Ramp,52,54881610.85
02/22/2023,Expense,Typeform,Harvey Spector,Credit Card - Ramp,52.5,54881663.35
02/22/2023,Expense,Vimcal,Harvey Spector,Credit Card - Ramp,15,54881678.35
02/22/2023,Expense,Ichiban Boshi,Mike ross,Credit Card - Ramp,33.04,54881711.39
02/22/2023,Expense,Bar Conte,Mike ross,Credit Card - Ramp,14.54,54881725.93
02/22/2023,Expense,Lemon Squeezy,Mike ross,Credit Card - Ramp,89,54881814.93
02/23/2023,Expense,Super,,Tools & Subscription - G&A,12,54881826.93
02/23/2023,Expense,Uber,,Travelling Expenses,11.32,54881838.25
02/23/2023,Expense,Rocket Sports Internet,Harvey Spector,Office expenses:Office supplies,5,54881843.25
02/23/2023,Expense,Artificer,,Meals & Entertainment,7.19,54881850.44
02/23/2023,Expense,Typeform,,Tools & Subscription - G&A,52,54881902.44
02/23/2023,Expense,Superhuman,,Professional Service Charges,30,54881932.44
02/23/2023,Expense,Bourke Street Bakery,Mike ross,Meals & Entertainment,3.96,54881936.4
02/23/2023,Expense,Superhuman,Mike ross,Credit Card - Ramp,30,54881966.4
02/23/2023,Expense,Super,,Tools & Subscription - G&A,12,54881978.4
02/23/2023,Expense,Segment,,Tools & Subscription - G&A,120,54882098.4
02/23/2023,Expense,Uber,Mike ross,Credit Card - Ramp,13.02,54882111.42
02/23/2023,Expense,Uber,Mike ross,Credit Card - Ramp,11.32,54882122.74
02/23/2023,Expense,Superhuman,,Professional Service Charges,30,54882152.74
02/23/2023,Expense,Superhuman,,Professional Service Charges,30,54882182.74
02/23/2023,Expense,Bourke Street Bakery,Mike ross,Meals & Entertainment,3.96,54882186.7
02/23/2023,Expense,Superhuman,Mike ross,Credit Card - Ramp,30,54882216.7
02/23/2023,Expense,Segment,,Tools & Subscription - G&A,120,54882336.7
02/23/2023,Expense,Bourke Street Bakery,Mike ross,Credit Card - Ramp,3.96,54882340.66
02/23/2023,Expense,Bourke Street Bakery,Mike ross,Credit Card - Ramp,3.96,54882344.62
02/23/2023,Expense,Rocket Sports Internet,Harvey Spector,Credit Card - Ramp,5,54882349.62
02/23/2023,Expense,Typeform,Harvey Spector,Credit Card - Ramp,52,54882401.62
02/23/2023,Expense,Superhuman,Mike ross,Credit Card - Ramp,30,54882431.62
02/23/2023,Expense,Rocket Sports Internet,Harvey Spector,Credit Card - Ramp,5,54882436.62
02/23/2023,Expense,Uber,,Travelling Expenses,13.02,54882449.64
02/23/2023,Expense,Segment,Balapavan Tirumani,Credit Card - Ramp,120,54882569.64
02/23/2023,Expense,Artificer,Mike ross,Credit Card - Ramp,7.19,54882576.83
02/23/2023,Expense,Artificer,Mike ross,Credit Card - Ramp,7.19,54882584.02
02/23/2023,Expense,Bourke Street Bakery,Mike ross,Credit Card - Ramp,3.96,54882587.98
02/23/2023,Expense,Uber,,Travelling Expenses,11.32,54882599.3
02/23/2023,Expense,Uber,,Travelling Expenses,13.02,54882612.32
02/23/2023,Expense,Typeform,,Tools & Subscription - G&A,52,54882664.32
02/23/2023,Expense,Super,Harvey Spector,Credit Card - Ramp,12,54882676.32
02/23/2023,Expense,Super,Harvey Spector,Credit Card - Ramp,12,54882688.32
02/23/2023,Expense,Bourke Street Bakery,Mike ross,Meals & Entertainment,3.96,54882692.28
02/23/2023,Expense,Segment,Balapavan Tirumani,Credit Card - Ramp,120,54882812.28
02/23/2023,Expense,Artificer,,Meals & Entertainment,7.19,54882819.47
02/23/2023,Expense,Uber,,Travelling Expenses,13.02,54882832.49
02/23/2023,Expense,Super,Harvey Spector,Credit Card - Ramp,12,54882844.49
02/23/2023,Expense,Segment,Balapavan Tirumani,Credit Card - Ramp,120,54882964.49
02/23/2023,Expense,Typeform,Harvey Spector,Credit Card - Ramp,52,54883016.49
02/23/2023,Expense,Super,,Tools & Subscription - G&A,12,54883028.49
02/23/2023,Expense,Rocket Sports Internet,Harvey Spector,Office expenses:Office supplies,5,54883033.49
02/23/2023,Expense,Uber,Mike ross,Credit Card - Ramp,11.32,54883044.81
02/23/2023,Expense,Uber,,Travelling Expenses,11.32,54883056.13
02/23/2023,Expense,Uber,Mike ross,Credit Card - Ramp,11.32,54883067.45
02/23/2023,Expense,Rocket Sports Internet,Harvey Spector,Office expenses:Office supplies,5,54883072.45
02/23/2023,Expense,Artificer,Mike ross,Credit Card - Ramp,7.19,54883079.64
02/23/2023,Expense,Bourke Street Bakery,Mike ross,Credit Card - Ramp,3.96,54883083.6
02/23/2023,Expense,Artificer,Mike ross,Credit Card - Ramp,7.19,54883090.79
02/23/2023,Expense,Uber,Mike ross,Credit Card - Ramp,13.02,54883103.81
02/23/2023,Expense,Rocket Sports Internet,Harvey Spector,Credit Card - Ramp,5,54883108.81
02/23/2023,Expense,Rocket Sports Internet,Harvey Spector,Credit Card - Ramp,5,54883113.81
02/23/2023,Expense,Superhuman,Mike ross,Credit Card - Ramp,30,54883143.81
02/23/2023,Expense,Superhuman,,Professional Service Charges,30,54883173.81
02/23/2023,Expense,Uber,,Travelling Expenses,11.32,54883185.13
02/23/2023,Expense,Bourke Street Bakery,Mike ross,Meals & Entertainment,3.96,54883189.09
02/23/2023,Expense,Typeform,Harvey Spector,Credit Card - Ramp,52,54883241.09
02/23/2023,Expense,Uber,Mike ross,Credit Card - Ramp,13.02,54883254.11
02/23/2023,Expense,Typeform,,Tools & Subscription - G&A,52,54883306.11
02/23/2023,Expense,Rocket Sports Internet,Harvey Spector,Office expenses:Office supplies,5,54883311.11
02/23/2023,Expense,Artificer,,Meals & Entertainment,7.19,54883318.3
02/23/2023,Expense,Artificer,,Meals & Entertainment,7.19,54883325.49
02/23/2023,Expense,Typeform,,Tools & Subscription - G&A,52,54883377.49
02/23/2023,Expense,Segment,,Tools & Subscription - G&A,120,54883497.49
02/23/2023,Expense,Uber,,Travelling Expenses,13.02,54883510.51
02/23/2023,Expense,Segment,,Tools & Subscription - G&A,120,54883630.51
02/23/2023,Expense,Super,,Tools & Subscription - G&A,12,54883642.51
02/24/2023,Expense,Fragola Apartments,,Travel:Hotels,1055.98,54884698.49
02/24/2023,Expense,Hypefury,Harvey Spector,Credit Card - Ramp,112.1,54884810.59
02/24/2023,Expense,Typeform,Harvey Spector,Credit Card - Ramp,51.63,54884862.22
02/24/2023,Expense,Typeform,,Tools & Subscription - G&A,51.63,54884913.85
02/24/2023,Expense,Hypefury,,Tools & Subscription - G&A,112.1,54885025.95
02/24/2023,Expense,Benedict Evans,Harvey Spector,Professional Service Charges,10,54885035.95
02/24/2023,Expense,Stockwood Strategy,STOCKWOOD STRATEGY,Professional Service Charges,-2500,54882535.95
02/24/2023,Expense,Fragola Apartments,,Travel:Hotels,1055.98,54883591.93
02/24/2023,Expense,Benedict Evans,Harvey Spector,Professional Service Charges,10,54883601.93
02/24/2023,Expense,Benedict Evans,Harvey Spector,Credit Card - Ramp,10,54883611.93
02/24/2023,Expense,Stockwood Strategy,STOCKWOOD STRATEGY,Account1,2500,54886111.93
02/24/2023,Expense,Stockwood Strategy,STOCKWOOD STRATEGY,Professional Service Charges,-2500,54883611.93
02/24/2023,Expense,Typeform,Harvey Spector,Credit Card - Ramp,51.63,54883663.56
02/24/2023,Expense,Hypefury,Harvey Spector,Credit Card - Ramp,112.1,54883775.66
02/24/2023,Expense,Typeform,,Tools & Subscription - G&A,51.63,54883827.29
02/24/2023,Expense,Stockwood Strategy,STOCKWOOD STRATEGY,Account1,2500,54886327.29
02/24/2023,Expense,Benedict Evans,Harvey Spector,Credit Card - Ramp,10,54886337.29
02/24/2023,Expense,Hypefury,Harvey Spector,Credit Card - Ramp,112.1,54886449.39
02/24/2023,Expense,Hypefury,,Tools & Subscription - G&A,112.1,54886561.49
02/24/2023,Expense,Benedict Evans,Harvey Spector,Professional Service Charges,10,54886571.49
02/24/2023,Expense,Hypefury,,Tools & Subscription - G&A,112.1,54886683.59
02/24/2023,Expense,Typeform,Harvey Spector,Credit Card - Ramp,51.63,54886735.22
02/24/2023,Expense,Fragola Apartments,,Travel:Hotels,1055.98,54887791.2
02/24/2023,Expense,Typeform,,Tools & Subscription - G&A,51.63,54887842.83
02/24/2023,Expense,Stockwood Strategy,STOCKWOOD STRATEGY,Professional Service Charges,-2500,54885342.83
02/24/2023,Expense,Stockwood Strategy,STOCKWOOD STRATEGY,Account1,2500,54887842.83
02/24/2023,Expense,Fragola Apartments,Harvey Spector,Credit Card - Ramp,1055.98,54888898.81
02/24/2023,Expense,Benedict Evans,Harvey Spector,Professional Service Charges,10,54888908.81
02/24/2023,Expense,Fragola Apartments,Harvey Spector,Credit Card - Ramp,1055.98,54889964.79
02/24/2023,Expense,Typeform,,Tools & Subscription - G&A,51.63,54890016.42
02/24/2023,Expense,Fragola Apartments,,Travel:Hotels,1055.98,54891072.4
02/24/2023,Expense,Stockwood Strategy,STOCKWOOD STRATEGY,Account1,2500,54893572.4
02/24/2023,Expense,Benedict Evans,Harvey Spector,Credit Card - Ramp,10,54893582.4
02/24/2023,Expense,Benedict Evans,Harvey Spector,Credit Card - Ramp,10,54893592.4
02/24/2023,Expense,Stockwood Strategy,STOCKWOOD STRATEGY,Professional Service Charges,-2500,54891092.4
02/24/2023,Expense,Fragola Apartments,Harvey Spector,Credit Card - Ramp,1055.98,54892148.38
02/24/2023,Expense,Hypefury,,Tools & Subscription - G&A,112.1,54892260.48
02/25/2023,Expense,Zoom,Chad Blumenthal,Credit Card - Ramp,14.99,54892275.47
02/25/2023,Expense,Miro,Mike ross,Credit Card - Ramp,90,54892365.47
02/25/2023,Expense,Zoom,Chad Blumenthal,Credit Card - Ramp,14.99,54892380.46
02/25/2023,Expense,Miro,,Tools & Subscription - G&A,90,54892470.46
02/25/2023,Expense,Miro,,Tools & Subscription - G&A,90,54892560.46
02/25/2023,Expense,Zoom,,Tools & Subscription - G&A,14.99,54892575.45
02/25/2023,Expense,Miro,Mike ross,Credit Card - Ramp,90,54892665.45
02/25/2023,Expense,Zoom,,Tools & Subscription - G&A,14.99,54892680.44
02/25/2023,Expense,Miro,Mike ross,Credit Card - Ramp,90,54892770.44
02/25/2023,Expense,Zoom,,Tools & Subscription - G&A,14.99,54892785.43
02/25/2023,Expense,Miro,,Tools & Subscription - G&A,90,54892875.43
02/25/2023,Expense,Zoom,,Tools & Subscription - G&A,14.99,54892890.42
02/25/2023,Expense,Miro,,Tools & Subscription - G&A,90,54892980.42
02/25/2023,Expense,Zoom,Chad Blumenthal,Credit Card - Ramp,14.99,54892995.41
02/27/2023,Expense,Sendinblue,Balapavan Tirumani,Credit Card - Ramp,55.78,54893051.19
02/27/2023,Expense,Artificer,,Meals & Entertainment,3.75,54893054.94
02/27/2023,Expense,Sentry,Balapavan Tirumani,Credit Card - Ramp,29,54893083.94
02/27/2023,Expense,Splitbee,,Tools & Subscription - G&A,16.52,54893100.46
02/27/2023,Expense,Cafe Dougie Restaurant,Mike ross,Credit Card - Ramp,33.96,54893134.42
02/27/2023,Expense,Cafe Dougie Restaurant,Mike ross,Credit Card - Ramp,33.96,54893168.38
02/27/2023,Expense,Artificer,Mike ross,Credit Card - Ramp,3.75,54893172.13
02/27/2023,Expense,Artificer,Mike ross,Credit Card - Ramp,3.75,54893175.88
02/27/2023,Expense,Splitbee,,Tools & Subscription - G&A,16.52,54893192.4
02/27/2023,Expense,Sendinblue,,Tools & Subscription - G&A,55.78,54893248.18
02/27/2023,Expense,Artificer,Mike ross,Credit Card - Ramp,3.75,54893251.93
02/27/2023,Expense,Sentry,Balapavan Tirumani,Credit Card - Ramp,29,54893280.93
02/27/2023,Expense,Cafe Dougie Restaurant,Mike ross,Meals & Entertainment,33.96,54893314.89
02/27/2023,Expense,Cafe Dougie Restaurant,Mike ross,Credit Card - Ramp,33.96,54893348.85
02/27/2023,Expense,Artificer,Mike ross,Credit Card - Ramp,3.75,54893352.6
02/27/2023,Expense,Splitbee,Harris Jose,Credit Card - Ramp,16.52,54893369.12
02/27/2023,Expense,Artificer,,Meals & Entertainment,3.75,54893372.87
02/27/2023,Expense,Sentry,Balapavan Tirumani,Credit Card - Ramp,29,54893401.87
02/27/2023,Expense,Sendinblue,Balapavan Tirumani,Credit Card - Ramp,55.78,54893457.65
02/27/2023,Expense,Cafe Dougie Restaurant,Mike ross,Meals & Entertainment,33.96,54893491.61
02/27/2023,Expense,Splitbee,Harris Jose,Credit Card - Ramp,16.52,54893508.13
02/27/2023,Expense,Splitbee,,Tools & Subscription - G&A,16.52,54893524.65
02/27/2023,Expense,Sendinblue,,Tools & Subscription - G&A,55.78,54893580.43
02/27/2023,Expense,Artificer,,Meals & Entertainment,3.75,54893584.18
02/27/2023,Expense,Sendinblue,,Tools & Subscription - G&A,55.78,54893639.96
02/27/2023,Expense,Sentry,,Tools & Subscription - G&A,29,54893668.96
02/27/2023,Expense,Cafe Dougie Restaurant,Mike ross,Meals & Entertainment,33.96,54893702.92
02/27/2023,Expense,Cafe Dougie Restaurant,Mike ross,Meals & Entertainment,33.96,54893736.88
02/27/2023,Expense,Splitbee,Harris Jose,Credit Card - Ramp,16.52,54893753.4
02/27/2023,Expense,Sentry,,Tools & Subscription - G&A,29,54893782.4
02/27/2023,Expense,Cafe Dougie Restaurant,Mike ross,Credit Card - Ramp,33.96,54893816.36
02/27/2023,Expense,Splitbee,,Tools & Subscription - G&A,16.52,54893832.88
02/27/2023,Expense,Sentry,,Tools & Subscription - G&A,29,54893861.88
02/27/2023,Expense,Sendinblue,Balapavan Tirumani,Credit Card - Ramp,55.78,54893917.66
02/27/2023,Expense,Sentry,,Tools & Subscription - G&A,29,54893946.66
02/27/2023,Expense,Sendinblue,,Tools & Subscription - G&A,55.78,54894002.44
02/27/2023,Expense,Artificer,,Meals & Entertainment,3.75,54894006.19
02/28/2023,Expense,Adobe,,Tools & Subscription - S&M,14.84,54894021.03
02/28/2023,Expense,Netlify,,Tools & Subscription - G&A,19,54894040.03
02/28/2023,Expense,Zapier,,Tools & Subscription - G&A,29.99,54894070.02
02/28/2023,Expense,Zapier,,Tools & Subscription - G&A,29.99,54894100.01
02/28/2023,Expense,Netlify,,Tools & Subscription - G&A,19,54894119.01
02/28/2023,Expense,Cafe Dougie Restaurant,Mike ross,Meals & Entertainment,21.24,54894140.25
02/28/2023,Expense,Cafe Dougie Restaurant,Mike ross,Meals & Entertainment,21.24,54894161.49
02/28/2023,Bill,Big Company ,"Service Expenses for the month of January 2023 
INR   50,83,583.86    @ 82.6816",Accounts Payable (A/P),61483.86,54955645.35
02/28/2023,Bill,Big Company ,"Service Expenses for the month of January 2023 
INR   50,83,583.86    @ 82.6816",Accounts Payable (A/P),61483.86,55017129.21
02/28/2023,Expense,Adobe,,Tools & Subscription - S&M,14.84,55017144.05
02/28/2023,Expense,Netlify,,Tools & Subscription - G&A,19,55017163.05
02/28/2023,Expense,Zapier,Chad Blumenthal,Credit Card - Ramp,29.99,55017193.04
02/28/2023,Expense,Zapier,,Tools & Subscription - G&A,29.99,55017223.03
02/28/2023,Expense,Cafe Dougie Restaurant,Mike ross,Credit Card - Ramp,21.24,55017244.27
02/28/2023,Expense,Netlify,Balapavan Tirumani,Credit Card - Ramp,19,55017263.27
02/28/2023,Expense,Cafe Dougie Restaurant,Mike ross,Credit Card - Ramp,21.24,55017284.51
02/28/2023,Bill,Big Company ,,Outsources Services - India,61483.86,55078768.37
02/28/2023,Expense,Cafe Dougie Restaurant,Mike ross,Meals & Entertainment,21.24,55078789.61
02/28/2023,Expense,Netlify,Balapavan Tirumani,Credit Card - Ramp,19,55078808.61
02/28/2023,Expense,Adobe,,Tools & Subscription - S&M,14.84,55078823.45
02/28/2023,Bill,Big Company ,"Service Expenses for the month of January 2023 
INR   50,83,583.86    @ 82.6816",Accounts Payable (A/P),61483.86,55140307.31
02/28/2023,Bill,Big Company ,,Outsources Services - India,61483.86,55201791.17
02/28/2023,Expense,Cafe Dougie Restaurant,Mike ross,Credit Card - Ramp,21.24,55201812.41
02/28/2023,Expense,Cafe Dougie Restaurant,Mike ross,Credit Card - Ramp,21.24,55201833.65
02/28/2023,Bill,Big Company ,,Outsources Services - India,61483.86,55263317.51
02/28/2023,Expense,Cafe Dougie Restaurant,Mike ross,Meals & Entertainment,21.24,55263338.75
02/28/2023,Expense,Adobe,,Tools & Subscription - S&M,14.84,55263353.59
02/28/2023,Expense,Netlify,,Tools & Subscription - G&A,19,55263372.59
02/28/2023,Expense,Zapier,Chad Blumenthal,Credit Card - Ramp,29.99,55263402.58
02/28/2023,Expense,Zapier,,Tools & Subscription - G&A,29.99,55263432.57
02/28/2023,Expense,Netlify,Balapavan Tirumani,Credit Card - Ramp,19,55263451.57
02/28/2023,Expense,Zapier,Chad Blumenthal,Credit Card - Ramp,29.99,55263481.56
02/28/2023,Expense,Adobe,Mike ross,Credit Card - Ramp,14.84,55263496.4
02/28/2023,Bill,Big Company ,,Outsources Services - India,61483.86,55324980.26
02/28/2023,Bill,Big Company ,"Service Expenses for the month of January 2023 
INR   50,83,583.86    @ 82.6816",Accounts Payable (A/P),61483.86,55386464.12
02/28/2023,Expense,Adobe,Mike ross,Credit Card - Ramp,14.84,55386478.96
02/28/2023,Expense,Adobe,Mike ross,Credit Card - Ramp,14.84,55386493.8
03/01/2023,Expense,Maloneys Grocer,,Meals & Entertainment,12.16,55386505.96
03/01/2023,Expense,Income Capitals ,Income Capitals ,Account1,10153,55396658.96
03/01/2023,Transfer,,Corp E Corp,Delaware Corporation Tax Payable,-3650,55393008.96
03/01/2023,Expense,Income Capitals ,Income Capitals ,Account1,3254,55396262.96
03/01/2023,Expense,Income Capitals ,Income Capitals ,Account1,3254,55399516.96
03/01/2023,Expense,Cafe Dougie Restaurant,Mike ross,Meals & Entertainment,27.45,55399544.41
03/01/2023,Expense,Income Capitals ,Income Capitals ,Account1,10153,55409697.41
03/01/2023,Transfer,,Corp E Corp,Delaware Corporation Tax Payable,-3650,55406047.41
03/01/2023,Expense,Income Capitals ,Income Capitals ,Contract labor,-10153,55395894.41
03/01/2023,Expense,Income Capitals ,Income Capitals ,Contract labor,-3254,55392640.41
03/01/2023,Expense,Github,,Tools & Subscription - G&A,40,55392680.41
03/01/2023,Transfer,,Corp E Corp,Account1,-3650,55389030.41
03/01/2023,Expense,Google G Suite,,Tools & Subscription - G&A,112.45,55389142.86
03/01/2023,Expense,Google G Suite,Mike ross,Credit Card - Ramp,112.45,55389255.31
03/01/2023,Expense,Github,Balapavan Tirumani,Credit Card - Ramp,40,55389295.31
03/01/2023,Expense,Cafe Dougie Restaurant,Mike ross,Meals & Entertainment,27.45,55389322.76
03/01/2023,Expense,Income Capitals ,Income Capitals ,Contract labor,-10153,55379169.76
03/01/2023,Expense,Income Capitals ,Income Capitals ,Contract labor,-3254,55375915.76
03/01/2023,Expense,Maloneys Grocer,Mike ross,Credit Card - Ramp,12.16,55375927.92
03/01/2023,Expense,Maloneys Grocer,,Meals & Entertainment,12.16,55375940.08
03/01/2023,Expense,Github,,Tools & Subscription - G&A,40,55375980.08
03/01/2023,Expense,Income Capitals ,Income Capitals ,Contract labor,-10153,55365827.08
03/01/2023,Transfer,,Corp E Corp,Delaware Corporation Tax Payable,-3650,55362177.08
03/01/2023,Expense,Cafe Dougie Restaurant,Mike ross,Credit Card - Ramp,27.45,55362204.53
03/01/2023,Expense,Google G Suite,,Tools & Subscription - G&A,112.45,55362316.98
03/01/2023,Transfer,,Corp E Corp,Account1,-3650,55358666.98
03/01/2023,Expense,Maloneys Grocer,,Meals & Entertainment,12.16,55358679.14
03/01/2023,Expense,Cafe Dougie Restaurant,Mike ross,Meals & Entertainment,27.45,55358706.59
03/01/2023,Transfer,,Corp E Corp,Account1,-3650,55355056.59
03/01/2023,Expense,Maloneys Grocer,Mike ross,Credit Card - Ramp,12.16,55355068.75
03/01/2023,Expense,Github,,Tools & Subscription - G&A,40,55355108.75
03/01/2023,Expense,Google G Suite,Mike ross,Credit Card - Ramp,112.45,55355221.2
03/01/2023,Expense,Google G Suite,Mike ross,Credit Card - Ramp,112.45,55355333.65
03/01/2023,Expense,Income Capitals ,Income Capitals ,Contract labor,-3254,55352079.65
03/01/2023,Expense,Maloneys Grocer,Mike ross,Credit Card - Ramp,12.16,55352091.81
03/01/2023,Expense,Cafe Dougie Restaurant,Mike ross,Meals & Entertainment,27.45,55352119.26
03/01/2023,Expense,Cafe Dougie Restaurant,Mike ross,Credit Card - Ramp,27.45,55352146.71
03/01/2023,Expense,Income Capitals ,Income Capitals ,Account1,10153,55362299.71
03/01/2023,Expense,Maloneys Grocer,Mike ross,Credit Card - Ramp,12.16,55362311.87
03/01/2023,Expense,Income Capitals ,Income Capitals ,Contract labor,-3254,55359057.87
03/01/2023,Transfer,,Corp E Corp,Delaware Corporation Tax Payable,-3650,55355407.87
03/01/2023,Expense,Github,Balapavan Tirumani,Credit Card - Ramp,40,55355447.87
03/01/2023,Expense,Cafe Dougie Restaurant,Mike ross,Credit Card - Ramp,27.45,55355475.32
03/01/2023,Expense,Income Capitals ,Income Capitals ,Contract labor,-10153,55345322.32
03/01/2023,Expense,Cafe Dougie Restaurant,Mike ross,Credit Card - Ramp,27.45,55345349.77
03/01/2023,Expense,Google G Suite,,Tools & Subscription - G&A,112.45,55345462.22
03/01/2023,Expense,Income Capitals ,Income Capitals ,Account1,3254,55348716.22
03/01/2023,Expense,Income Capitals ,Income Capitals ,Account1,10153,55358869.22
03/01/2023,Expense,Github,Balapavan Tirumani,Credit Card - Ramp,40,55358909.22
03/01/2023,Expense,Maloneys Grocer,,Meals & Entertainment,12.16,55358921.38
03/01/2023,Expense,Google G Suite,,Tools & Subscription - G&A,112.45,55359033.83
03/01/2023,Expense,Github,,Tools & Subscription - G&A,40,55359073.83
03/01/2023,Expense,Income Capitals ,Income Capitals ,Account1,3254,55362327.83
03/01/2023,Transfer,,Corp E Corp,Account1,-3650,55358677.83
03/02/2023,Expense,SWISS,Harvey Spector,Credit Card - Ramp,1017.1,55359694.93
03/02/2023,Deposit,,Interest Accrual INTEREST,Interest Received,4.18,55359699.11
03/02/2023,Expense,Lemon Squeezy,Mike ross,Credit Card - Ramp,89,55359788.11
03/02/2023,Deposit,,Interest Accrual INTEREST,Interest Received,4.18,55359792.29
03/02/2023,Expense,Bar Totti's,Mike ross,Credit Card - Ramp,80.93,55359873.22
03/02/2023,Expense,bills,Mike ross,Credit Card - Ramp,69.23,55359942.45
03/02/2023,Deposit,,Interest Accrual INTEREST,Interest Received,4.18,55359946.63
03/02/2023,Expense,bills,Mike ross,Credit Card - Ramp,69.23,55360015.86
03/02/2023,Deposit,,Interest Accrual INTEREST,Interest Received,4.18,55360020.04
03/02/2023,Expense,SWISS,,Travel:Airfare,1017.1,55361037.14
03/02/2023,Expense,Bar Totti's,,Meals & Entertainment,80.93,55361118.07
03/02/2023,Expense,Bar Totti's,Mike ross,Credit Card - Ramp,80.93,55361199
03/02/2023,Deposit,,Interest Accrual INTEREST,Savings (6977),4.18,55361203.18
03/02/2023,Expense,bills,Mike ross,Credit Card - Ramp,69.23,55361272.41
03/02/2023,Expense,bills,Mike ross,Meals & Entertainment,69.23,55361341.64
03/02/2023,Expense,bills,Mike ross,Meals & Entertainment,69.23,55361410.87
03/02/2023,Expense,Bar Totti's,Mike ross,Credit Card - Ramp,80.93,55361491.8
03/02/2023,Expense,SWISS,,Travel:Airfare,1017.1,55362508.9
03/02/2023,Expense,Lemon Squeezy,,Tools & Subscription - G&A,89,55362597.9
03/02/2023,Expense,SWISS,,Travel:Airfare,1017.1,55363615
03/02/2023,Deposit,,Interest Accrual INTEREST,Savings (6977),4.18,55363619.18
03/02/2023,Expense,bills,Mike ross,Credit Card - Ramp,69.23,55363688.41
03/02/2023,Expense,Bar Totti's,,Meals & Entertainment,80.93,55363769.34
03/02/2023,Expense,bills,Mike ross,Meals & Entertainment,69.23,55363838.57
03/02/2023,Expense,Bar Totti's,,Meals & Entertainment,80.93,55363919.5
03/02/2023,Expense,SWISS,,Travel:Airfare,1017.1,55364936.6
03/02/2023,Expense,Lemon Squeezy,,Tools & Subscription - G&A,89,55365025.6
03/02/2023,Expense,Lemon Squeezy,Mike ross,Credit Card - Ramp,89,55365114.6
03/02/2023,Expense,Lemon Squeezy,Mike ross,Credit Card - Ramp,89,55365203.6
03/02/2023,Expense,SWISS,Harvey Spector,Credit Card - Ramp,1017.1,55366220.7
03/02/2023,Expense,SWISS,Harvey Spector,Credit Card - Ramp,1017.1,55367237.8
03/02/2023,Expense,bills,Mike ross,Meals & Entertainment,69.23,55367307.03
03/02/2023,Deposit,,Interest Accrual INTEREST,Savings (6977),4.18,55367311.21
03/02/2023,Expense,Bar Totti's,Mike ross,Credit Card - Ramp,80.93,55367392.14
03/02/2023,Expense,Lemon Squeezy,,Tools & Subscription - G&A,89,55367481.14
03/02/2023,Expense,Bar Totti's,,Meals & Entertainment,80.93,55367562.07
03/02/2023,Expense,Lemon Squeezy,,Tools & Subscription - G&A,89,55367651.07
03/03/2023,Expense,The Carrington,Mike ross,Credit Card - Ramp,19.14,55367670.21
03/03/2023,Expense,Uber,Harvey Spector,Credit Card - Ramp,0.59,55367670.8
03/03/2023,Expense,Render,,Tools & Subscription - G&A,189,55367859.8
03/03/2023,Expense,The Carrington,Mike ross,Credit Card - Ramp,19.14,55367878.94
03/03/2023,Expense,Render,,Tools & Subscription - G&A,189,55368067.94
03/03/2023,Expense,Render,Balapavan Tirumani,Credit Card - Ramp,189,55368256.94
03/03/2023,Expense,Uber,,Travelling Expenses,0.59,55368257.53
03/03/2023,Expense,The Carrington,Mike ross,Credit Card - Ramp,19.14,55368276.67
03/03/2023,Expense,Uber,,Travelling Expenses,0.59,55368277.26
03/03/2023,Expense,The Carrington,,Meals & Entertainment,19.14,55368296.4
03/03/2023,Expense,The Carrington,,Meals & Entertainment,19.14,55368315.54
03/03/2023,Expense,Render,Balapavan Tirumani,Credit Card - Ramp,189,55368504.54
03/03/2023,Expense,Render,,Tools & Subscription - G&A,189,55368693.54
03/03/2023,Expense,Uber,,Travelling Expenses,0.59,55368694.13
03/03/2023,Expense,The Carrington,Mike ross,Credit Card - Ramp,19.14,55368713.27
03/03/2023,Expense,The Carrington,,Meals & Entertainment,19.14,55368732.41
03/03/2023,Expense,Render,,Tools & Subscription - G&A,189,55368921.41
03/03/2023,Expense,Uber,Harvey Spector,Credit Card - Ramp,0.59,55368922
03/03/2023,Expense,Render,Balapavan Tirumani,Credit Card - Ramp,189,55369111
03/03/2023,Expense,Uber,Harvey Spector,Credit Card - Ramp,0.59,55369111.59
03/03/2023,Expense,The Carrington,,Meals & Entertainment,19.14,55369130.73
03/03/2023,Expense,Uber,,Travelling Expenses,0.59,55369131.32
03/04/2023,Expense,Uber,Mike ross,Credit Card - Ramp,11.11,55369142.43
03/04/2023,Expense,Uber,Mike ross,Credit Card - Ramp,11.11,55369153.54
03/04/2023,Expense,Uber,,Travelling Expenses,11.11,55369164.65
03/04/2023,Expense,Uber,,Travelling Expenses,11.11,55369175.76
03/04/2023,Expense,Uber,,Travelling Expenses,11.11,55369186.87
03/04/2023,Expense,Uber,Mike ross,Credit Card - Ramp,11.11,55369197.98
03/04/2023,Expense,Uber,,Travelling Expenses,11.11,55369209.09
03/05/2023,Expense,Uber,,Travelling Expenses,7.65,55369216.74
03/05/2023,Expense,Uber,Mike ross,Credit Card - Ramp,7.65,55369224.39
03/05/2023,Expense,Klm India,,Travel:Airfare,224.13,55369448.52
03/05/2023,Expense,Uber,,Travelling Expenses,7.65,55369456.17
03/05/2023,Expense,Klm India,Harvey Spector,Credit Card - Ramp,224.13,55369680.3
03/05/2023,Expense,Klm India,,Travel:Airfare,224.13,55369904.43
03/05/2023,Expense,Klm India,Harvey Spector,Credit Card - Ramp,224.13,55370128.56
03/05/2023,Expense,Klm India,Harvey Spector,Credit Card - Ramp,224.13,55370352.69
03/05/2023,Expense,Uber,,Travelling Expenses,7.65,55370360.34
03/05/2023,Expense,Uber,Mike ross,Credit Card - Ramp,7.65,55370367.99
03/05/2023,Expense,Klm India,,Travel:Airfare,224.13,55370592.12
03/05/2023,Expense,Uber,,Travelling Expenses,7.65,55370599.77
03/05/2023,Expense,Klm India,,Travel:Airfare,224.13,55370823.9
03/05/2023,Expense,Uber,Mike ross,Credit Card - Ramp,7.65,55370831.55
03/06/2023,Expense,Adobe,,Tools & Subscription - S&M,82.71,55370914.26
03/06/2023,Expense,Lucky Pickle Dumpling Co,Mike ross,Credit Card - Ramp,10.98,55370925.24
03/06/2023,Expense,Adobe,,Tools & Subscription - S&M,82.71,55371007.95
03/06/2023,Expense,The Carrington,,Meals & Entertainment,16.43,55371024.38
03/06/2023,Expense,The Carrington,Mike ross,Credit Card - Ramp,16.43,55371040.81
03/06/2023,Expense,Lucky Pickle Dumpling Co,Mike ross,Meals & Entertainment,10.98,55371051.79
03/06/2023,Expense,Airbnb,,Travel:Hotels,1066.05,55372117.84
03/06/2023,Expense,Lucky Pickle Dumpling Co,Mike ross,Meals & Entertainment,10.98,55372128.82
03/06/2023,Expense,DI Domenico Moreno Alex Mario,"DI DOMENICO MORENO ALEX MARIO, website developer for building the landing page",Professional Service Charges,-7986.8,55364142.02
03/06/2023,Expense,The Carrington,,Meals & Entertainment,16.43,55364158.45
03/06/2023,Expense,Taplio,,Tools & Subscription - G&A,39,55364197.45
03/06/2023,Expense,Lucky Pickle Dumpling Co,Mike ross,Meals & Entertainment,10.98,55364208.43
03/06/2023,Expense,Adobe,,Tools & Subscription - S&M,82.71,55364291.14
03/06/2023,Expense,Taplio,,Tools & Subscription - G&A,39,55364330.14
03/06/2023,Expense,Airbnb,,Travel:Hotels,1066.05,55365396.19
03/06/2023,Expense,Taplio,,Tools & Subscription - G&A,39,55365435.19
03/06/2023,Expense,Airbnb,Mike ross,Credit Card - Ramp,1066.05,55366501.24
03/06/2023,Expense,Airbnb,,Travel:Hotels,1066.05,55367567.29
03/06/2023,Expense,DI Domenico Moreno Alex Mario,"DI DOMENICO MORENO ALEX MARIO, website developer for building the landing page",Account1,7986.8,55375554.09
03/06/2023,Expense,,Fees,General business expenses:Bank fees & service charges,-79.43,55375474.66
03/06/2023,Expense,,Fees,Account1,79.43,55375554.09
03/06/2023,Expense,The Carrington,,Meals & Entertainment,16.43,55375570.52
03/06/2023,Expense,The Carrington,Mike ross,Credit Card - Ramp,16.43,55375586.95
03/06/2023,Expense,The Carrington,Mike ross,Credit Card - Ramp,16.43,55375603.38
03/06/2023,Expense,Lucky Pickle Dumpling Co,Mike ross,Credit Card - Ramp,10.98,55375614.36
03/06/2023,Expense,Airbnb,Mike ross,Credit Card - Ramp,1066.05,55376680.41
03/06/2023,Expense,Adobe,Mike ross,Credit Card - Ramp,82.71,55376763.12
03/06/2023,Expense,DI Domenico Moreno Alex Mario,"DI DOMENICO MORENO ALEX MARIO, website developer for building the landing page",Account1,7986.8,55384749.92
03/06/2023,Expense,,Fees,General business expenses:Bank fees & service charges,-79.43,55384670.49
03/06/2023,Expense,Lucky Pickle Dumpling Co,Mike ross,Credit Card - Ramp,10.98,55384681.47
03/06/2023,Expense,,Fees,Account1,79.43,55384760.9
03/06/2023,Expense,DI Domenico Moreno Alex Mario,"DI DOMENICO MORENO ALEX MARIO, website developer for building the landing page",Account1,7986.8,55392747.7
03/06/2023,Expense,Lucky Pickle Dumpling Co,Mike ross,Credit Card - Ramp,10.98,55392758.68
03/06/2023,Expense,DI Domenico Moreno Alex Mario,"DI DOMENICO MORENO ALEX MARIO, website developer for building the landing page",Professional Service Charges,-7986.8,55384771.88
03/06/2023,Expense,,Fees,General business expenses:Bank fees & service charges,-79.43,55384692.45
03/06/2023,Expense,Adobe,Mike ross,Credit Card - Ramp,82.71,55384775.16
03/06/2023,Expense,Lucky Pickle Dumpling Co,Mike ross,Meals & Entertainment,10.98,55384786.14
03/06/2023,Expense,Taplio,Harvey Spector,Credit Card - Ramp,39,55384825.14
03/06/2023,Expense,DI Domenico Moreno Alex Mario,"DI DOMENICO MORENO ALEX MARIO, website developer for building the landing page",Professional Service Charges,-7986.8,55376838.34
03/06/2023,Expense,DI Domenico Moreno Alex Mario,"DI DOMENICO MORENO ALEX MARIO, website developer for building the landing page",Professional Service Charges,-7986.8,55368851.54
03/06/2023,Expense,Taplio,Harvey Spector,Credit Card - Ramp,39,55368890.54
03/06/2023,Expense,Airbnb,Mike ross,Credit Card - Ramp,1066.05,55369956.59
03/06/2023,Expense,,Fees,Account1,79.43,55370036.02
03/06/2023,Expense,Taplio,Harvey Spector,Credit Card - Ramp,39,55370075.02
03/06/2023,Expense,,Fees,Account1,79.43,55370154.45
03/06/2023,Expense,Adobe,,Tools & Subscription - S&M,82.71,55370237.16
03/06/2023,Expense,The Carrington,,Meals & Entertainment,16.43,55370253.59
03/06/2023,Expense,DI Domenico Moreno Alex Mario,"DI DOMENICO MORENO ALEX MARIO, website developer for building the landing page",Account1,7986.8,55378240.39
03/06/2023,Expense,Adobe,Mike ross,Credit Card - Ramp,82.71,55378323.1
03/06/2023,Expense,,Fees,General business expenses:Bank fees & service charges,-79.43,55378243.67
03/06/2023,Expense,The Carrington,Mike ross,Credit Card - Ramp,16.43,55378260.1
03/06/2023,Expense,Taplio,,Tools & Subscription - G&A,39,55378299.1
03/06/2023,Expense,Airbnb,,Travel:Hotels,1066.05,55379365.15
03/07/2023,Expense,Mailchimp,Mike ross,Credit Card - Ramp,22.2,55379387.35
03/07/2023,Expense,Mailchimp,,Tools & Subscription - G&A,22.2,55379409.55
03/07/2023,Expense,Mailchimp,Mike ross,Credit Card - Ramp,22.2,55379431.75
03/07/2023,Expense,Mailchimp,,Tools & Subscription - G&A,22.2,55379453.95
03/07/2023,Expense,Mailchimp,,Tools & Subscription - G&A,22.2,55379476.15
03/07/2023,Expense,Mailchimp,Mike ross,Credit Card - Ramp,22.2,55379498.35
03/07/2023,Expense,Mailchimp,,Tools & Subscription - G&A,22.2,55379520.55
03/08/2023,Expense,Bourke Street Bakery,Mike ross,Credit Card - Ramp,9.88,55379530.43
03/08/2023,Expense,Bourke Street Bakery,Mike ross,Credit Card - Ramp,9.88,55379540.31
03/08/2023,Expense,Reuben Hills,Mike ross,Credit Card - Ramp,22.14,55379562.45
03/08/2023,Expense,Reuben Hills,Mike ross,Meals & Entertainment,22.14,55379584.59
03/08/2023,Expense,Bourke Street Bakery,Mike ross,Meals & Entertainment,9.88,55379594.47
03/08/2023,Expense,Reuben Hills,Mike ross,Credit Card - Ramp,22.14,55379616.61
03/08/2023,Expense,Reuben Hills,Mike ross,Credit Card - Ramp,22.14,55379638.75
03/08/2023,Expense,Reuben Hills,Mike ross,Meals & Entertainment,22.14,55379660.89
03/08/2023,Expense,Bourke Street Bakery,Mike ross,Meals & Entertainment,9.88,55379670.77
03/08/2023,Expense,Reuben Hills,Mike ross,Credit Card - Ramp,22.14,55379692.91
03/08/2023,Expense,Bourke Street Bakery,Mike ross,Credit Card - Ramp,9.88,55379702.79
03/08/2023,Expense,Reuben Hills,Mike ross,Meals & Entertainment,22.14,55379724.93
03/08/2023,Expense,Bourke Street Bakery,Mike ross,Meals & Entertainment,9.88,55379734.81
03/08/2023,Expense,Reuben Hills,Mike ross,Meals & Entertainment,22.14,55379756.95
03/08/2023,Expense,Bourke Street Bakery,Mike ross,Meals & Entertainment,9.88,55379766.83
03/08/2023,Expense,Bourke Street Bakery,Mike ross,Credit Card - Ramp,9.88,55379776.71
03/09/2023,Expense,Conde Nast,,General business expenses:Memberships & subscriptions,10,55379786.71
03/09/2023,Expense,Datadog,Balapavan Tirumani,Credit Card - Ramp,3.71,55379790.42
03/09/2023,Expense,Streamline Trial Over,Chris George,Credit Card - Ramp,182.4,55379972.82
03/09/2023,Expense,Awwwards,Mike ross,Office expenses:Office supplies,65,55380037.82
03/09/2023,Expense,A Book Apart,Chris George,Credit Card - Ramp,41,55380078.82
03/09/2023,Expense,Conde Nast,Harvey Spector,Credit Card - Ramp,10,55380088.82
03/09/2023,Expense,Taplio,Harvey Spector,Credit Card - Ramp,39,55380127.82
03/09/2023,Expense,Streamline Trial Over,Chris George,Tools & Subscription,182.4,55380310.22
03/09/2023,Expense,A Book Apart,,General business expenses:Memberships & subscriptions,41,55380351.22
03/09/2023,Expense,Heroku,Balapavan Tirumani,Tools & Subscription - S&M,85,55380436.22
03/09/2023,Expense,Datadog,,Tools & Subscription - G&A,3.71,55380439.93
03/09/2023,Expense,Taplio,,Tools & Subscription - G&A,39,55380478.93
03/09/2023,Expense,Streamline Trial Over,Chris George,Tools & Subscription,182.4,55380661.33
03/09/2023,Expense,Conde Nast,Harvey Spector,Credit Card - Ramp,10,55380671.33
03/09/2023,Expense,Heroku,Balapavan Tirumani,Tools & Subscription - S&M,85,55380756.33
03/09/2023,Expense,Awwwards,Mike ross,Office expenses:Office supplies,65,55380821.33
03/09/2023,Expense,Usersnap,,Tools & Subscription - G&A,19,55380840.33
03/09/2023,Expense,Awwwards,Mike ross,Office expenses:Office supplies,65,55380905.33
03/09/2023,Expense,LinkedIn,,Tools & Subscription - G&A,92.31,55380997.64
03/09/2023,Expense,Datadog,,Tools & Subscription - G&A,3.71,55381001.35
03/09/2023,Expense,LinkedIn,Harvey Spector,Credit Card - Ramp,92.31,55381093.66
03/09/2023,Expense,Usersnap,Harris Jose,Credit Card - Ramp,19,55381112.66
03/09/2023,Expense,Uber,Mike ross,Credit Card - Ramp,9.69,55381122.35
03/09/2023,Expense,Taplio,Harvey Spector,Credit Card - Ramp,39,55381161.35
03/09/2023,Expense,Usersnap,Harris Jose,Credit Card - Ramp,19,55381180.35
03/09/2023,Expense,LinkedIn,Harvey Spector,Credit Card - Ramp,92.31,55381272.66
03/09/2023,Expense,LinkedIn,,Tools & Subscription - G&A,92.31,55381364.97
03/09/2023,Expense,Usersnap,,Tools & Subscription - G&A,19,55381383.97
03/09/2023,Expense,Conde Nast,,General business expenses:Memberships & subscriptions,10,55381393.97
03/09/2023,Expense,Datadog,Balapavan Tirumani,Credit Card - Ramp,3.71,55381397.68
03/09/2023,Expense,Uber,,Travelling Expenses,9.69,55381407.37
03/09/2023,Expense,Lemon Squeezy,Chris George,Credit Card - Ramp,99,55381506.37
03/09/2023,Expense,A Book Apart,Chris George,Credit Card - Ramp,41,55381547.37
03/09/2023,Expense,Lemon Squeezy,,Tools & Subscription - G&A,99,55381646.37
03/09/2023,Expense,Uber,,Travelling Expenses,9.69,55381656.06
03/09/2023,Expense,Heroku,Balapavan Tirumani,Credit Card - Ramp,85,55381741.06
03/09/2023,Expense,Usersnap,Harris Jose,Credit Card - Ramp,19,55381760.06
03/09/2023,Expense,Lemon Squeezy,Chris George,Credit Card - Ramp,99,55381859.06
03/09/2023,Expense,Awwwards,Mike ross,Credit Card - Ramp,65,55381924.06
03/09/2023,Expense,A Book Apart,,General business expenses:Memberships & subscriptions,41,55381965.06
03/09/2023,Expense,Conde Nast,Harvey Spector,Credit Card - Ramp,10,55381975.06
03/09/2023,Expense,Lemon Squeezy,,Tools & Subscription - G&A,99,55382074.06
03/09/2023,Expense,Lemon Squeezy,Chris George,Credit Card - Ramp,99,55382173.06
03/09/2023,Expense,Lemon Squeezy,,Tools & Subscription - G&A,99,55382272.06
03/09/2023,Expense,A Book Apart,Chris George,Credit Card - Ramp,41,55382313.06
03/09/2023,Expense,Streamline Trial Over,Chris George,Credit Card - Ramp,182.4,55382495.46
03/09/2023,Expense,LinkedIn,Harvey Spector,Credit Card - Ramp,92.31,55382587.77
03/09/2023,Expense,Streamline Trial Over,Chris George,Credit Card - Ramp,182.4,55382770.17
03/09/2023,Expense,Uber,Mike ross,Credit Card - Ramp,9.69,55382779.86
03/09/2023,Expense,Taplio,,Tools & Subscription - G&A,39,55382818.86
03/09/2023,Expense,Streamline Trial Over,Chris George,Tools & Subscription,182.4,55383001.26
03/09/2023,Expense,LinkedIn,,Tools & Subscription - G&A,92.31,55383093.57
03/09/2023,Expense,Uber,Mike ross,Credit Card - Ramp,9.69,55383103.26
03/09/2023,Expense,Awwwards,Mike ross,Credit Card - Ramp,65,55383168.26
03/09/2023,Expense,Usersnap,,Tools & Subscription - G&A,19,55383187.26
03/09/2023,Expense,Conde Nast,,General business expenses:Memberships & subscriptions,10,55383197.26
03/09/2023,Expense,Uber,,Travelling Expenses,9.69,55383206.95
03/09/2023,Expense,Taplio,,Tools & Subscription - G&A,39,55383245.95
03/09/2023,Expense,A Book Apart,Chris George,Credit Card - Ramp,41,55383286.95
03/09/2023,Expense,A Book Apart,,General business expenses:Memberships & subscriptions,41,55383327.95
03/09/2023,Expense,Heroku,Balapavan Tirumani,Credit Card - Ramp,85,55383412.95
03/09/2023,Expense,Conde Nast,Harvey Spector,Credit Card - Ramp,10,55383422.95
03/09/2023,Expense,Streamline Trial Over,Chris George,Tools & Subscription,182.4,55383605.35
03/09/2023,Expense,Datadog,Balapavan Tirumani,Credit Card - Ramp,3.71,55383609.06
03/09/2023,Expense,Lemon Squeezy,,Tools & Subscription - G&A,99,55383708.06
03/09/2023,Expense,Taplio,,Tools & Subscription - G&A,39,55383747.06
03/09/2023,Expense,A Book Apart,,General business expenses:Memberships & subscriptions,41,55383788.06
03/09/2023,Expense,Heroku,Balapavan Tirumani,Tools & Subscription - S&M,85,55383873.06
03/09/2023,Expense,Awwwards,Mike ross,Office expenses:Office supplies,65,55383938.06
03/09/2023,Expense,Heroku,Balapavan Tirumani,Credit Card - Ramp,85,55384023.06
03/09/2023,Expense,Datadog,,Tools & Subscription - G&A,3.71,55384026.77
03/09/2023,Expense,Conde Nast,,General business expenses:Memberships & subscriptions,10,55384036.77
03/09/2023,Expense,Usersnap,,Tools & Subscription - G&A,19,55384055.77
03/09/2023,Expense,LinkedIn,,Tools & Subscription - G&A,92.31,55384148.08
03/09/2023,Expense,Taplio,Harvey Spector,Credit Card - Ramp,39,55384187.08
03/09/2023,Expense,Awwwards,Mike ross,Credit Card - Ramp,65,55384252.08
03/09/2023,Expense,Awwwards,Mike ross,Credit Card - Ramp,65,55384317.08
03/09/2023,Expense,Datadog,,Tools & Subscription - G&A,3.71,55384320.79
03/09/2023,Expense,Uber,,Travelling Expenses,9.69,55384330.48
03/09/2023,Expense,Heroku,Balapavan Tirumani,Tools & Subscription - S&M,85,55384415.48
03/10/2023,Expense,Pause Cafe,Harvey Spector,Meals & Entertainment,12.86,55384428.34
03/10/2023,Expense,Rewind AI,,Tools & Subscription - G&A,20,55384448.34
03/10/2023,Expense,Pause Cafe,Harvey Spector,Meals & Entertainment,12.86,55384461.2
03/10/2023,Expense,The Carrington,,Meals & Entertainment,12.07,55384473.27
03/10/2023,Expense,The Carrington,Mike ross,Credit Card - Ramp,12.07,55384485.34
03/10/2023,Expense,Pause Cafe,Harvey Spector,Credit Card - Ramp,12.86,55384498.2
03/10/2023,Expense,The Carrington,Mike ross,Credit Card - Ramp,12.07,55384510.27
03/10/2023,Expense,Rewind AI,Harvey Spector,Credit Card - Ramp,20,55384530.27
03/10/2023,Expense,Pause Cafe,Harvey Spector,Credit Card - Ramp,12.86,55384543.13
03/10/2023,Expense,The Carrington,Mike ross,Credit Card - Ramp,12.07,55384555.2
03/10/2023,Expense,Rewind AI,,Tools & Subscription - G&A,20,55384575.2
03/10/2023,Expense,Pause Cafe,Harvey Spector,Meals & Entertainment,12.86,55384588.06
03/10/2023,Expense,Pause Cafe,Harvey Spector,Credit Card - Ramp,12.86,55384600.92
03/10/2023,Expense,Pause Cafe,Harvey Spector,Meals & Entertainment,12.86,55384613.78
03/10/2023,Expense,Rewind AI,Harvey Spector,Credit Card - Ramp,20,55384633.78
03/10/2023,Expense,The Carrington,Mike ross,Credit Card - Ramp,12.07,55384645.85
03/10/2023,Expense,Rewind AI,,Tools & Subscription - G&A,20,55384665.85
03/10/2023,Expense,Pause Cafe,Harvey Spector,Credit Card - Ramp,12.86,55384678.71
03/10/2023,Expense,Rewind AI,Harvey Spector,Credit Card - Ramp,20,55384698.71
03/10/2023,Expense,The Carrington,,Meals & Entertainment,12.07,55384710.78
03/10/2023,Expense,The Carrington,,Meals & Entertainment,12.07,55384722.85
03/10/2023,Expense,Rewind AI,,Tools & Subscription - G&A,20,55384742.85
03/10/2023,Expense,The Carrington,,Meals & Entertainment,12.07,55384754.92
03/11/2023,Transfer,,PaymentServiceB Savings **6977,Savings (6977),230000,55614754.92
03/11/2023,Transfer,,PaymentServiceB Savings **6977,Account1,-230000,55384754.92
03/11/2023,Transfer,,PaymentServiceB Savings **6977,Savings (6977),230000,55614754.92
03/11/2023,Transfer,,PaymentServiceB Savings **6977,Account1,-230000,55384754.92
03/11/2023,Transfer,,PaymentServiceB Savings **6977,Account1,-230000,55154754.92
03/11/2023,Transfer,,PaymentServiceB Savings **6977,Account1,-230000,54924754.92
03/11/2023,Transfer,,PaymentServiceB Savings **6977,Savings (6977),230000,55154754.92
03/11/2023,Transfer,,PaymentServiceB Savings **6977,Savings (6977),230000,55384754.92
03/12/2023,Expense,WordPress,Harris Jose,Credit Card - Ramp,15.37,55384770.29
03/12/2023,Expense,Maloneys Grocer,Mike ross,Credit Card - Ramp,18.6,55384788.89
03/12/2023,Expense,Maloneys Grocer,,Meals & Entertainment,18.6,55384807.49
03/12/2023,Expense,WordPress,,Tools & Subscription - G&A,15.37,55384822.86
03/12/2023,Expense,Maloneys Grocer,,Meals & Entertainment,18.6,55384841.46
03/12/2023,Expense,WordPress,Harris Jose,Credit Card - Ramp,15.37,55384856.83
03/12/2023,Expense,WordPress,,Tools & Subscription - G&A,15.37,55384872.2
03/12/2023,Expense,WordPress,,Tools & Subscription - G&A,15.37,55384887.57
03/12/2023,Expense,Maloneys Grocer,Mike ross,Credit Card - Ramp,18.6,55384906.17
03/12/2023,Expense,Maloneys Grocer,,Meals & Entertainment,18.6,55384924.77
03/12/2023,Expense,WordPress,,Tools & Subscription - G&A,15.37,55384940.14
03/12/2023,Expense,Maloneys Grocer,,Meals & Entertainment,18.6,55384958.74
03/12/2023,Expense,Maloneys Grocer,Mike ross,Credit Card - Ramp,18.6,55384977.34
03/12/2023,Expense,WordPress,Harris Jose,Credit Card - Ramp,15.37,55384992.71
03/12/2023,Expense,Maloneys Grocer,Mike ross,Credit Card - Ramp,18.6,55385011.31
03/13/2023,Transfer,,ServiceA,Bank account - Airwallex,-250000,55135011.31
03/13/2023,Deposit,Big Company ,Big Company ,Account1,200000,55335011.31
03/13/2023,Expense,Big Company ,Big Company ,Account1,-200000,55135011.31
03/13/2023,Transfer,,PaymentServiceB Savings **6977,Savings (6977),250000,55385011.31
03/13/2023,Expense,EntityA,ChronicleHQ Australia,Account1,-200000,55185011.31
03/13/2023,Expense,EntityA,ChronicleHQ Australia,Account1,-200000,54985011.31
03/13/2023,Transfer,,ServiceA,Account1,250000,55235011.31
03/13/2023,Expense,Intercom,,Tools & Subscription - G&A,176,55235187.31
03/13/2023,Deposit,Big Company ,Big Company ,Account1,200000,55435187.31
03/13/2023,Expense,Vercel,Harris Jose,Credit Card - Ramp,260,55435447.31
03/13/2023,Expense,Interact32,Harvey Spector,Tools & Subscription - G&A,9.93,55435457.24
03/13/2023,Transfer,,ServiceA,Bank account - Airwallex,-250000,55185457.24
03/13/2023,Expense,Big Company ,Big Company ,Account1,-200000,54985457.24
03/13/2023,Expense,EntityA,ChronicleHQ Australia,Account1,-200000,54785457.24
03/13/2023,Transfer,,ServiceA,Bank account - Airwallex,-250000,54535457.24
03/13/2023,Transfer,,PaymentServiceB Savings **6977,Account1,-250000,54285457.24
03/13/2023,Expense,EntityA,ChronicleHQ Australia,Account1,-200000,54085457.24
03/13/2023,Expense,Interact32,Harvey Spector,Credit Card - Ramp,9.93,54085467.17
03/13/2023,Transfer,,PaymentServiceB Savings **6977,Savings (6977),250000,54335467.17
03/13/2023,Expense,Vercel,,Tools & Subscription - G&A,260,54335727.17
03/13/2023,Expense,PocketSmith,,Tools & Subscription - G&A,9.95,54335737.12
03/13/2023,Expense,Vercel,,Tools & Subscription - G&A,260,54335997.12
03/13/2023,Expense,Figma,Mike ross,Credit Card - Ramp,180,54336177.12
03/13/2023,Transfer,,PaymentServiceB Savings **6977,Savings (6977),250000,54586177.12
03/13/2023,Expense,PocketSmith,Harvey Spector,Credit Card - Ramp,9.95,54586187.07
03/13/2023,Expense,,Fees,General business expenses:Bank fees & service charges,-2000,54584187.07
03/13/2023,Deposit,Big Company ,Big Company ,Accounts Payable (A/P),200000,54784187.07
03/13/2023,Expense,Big Company ,Big Company ,Accounts Payable (A/P),-200000,54584187.07
03/13/2023,Expense,EntityA,ChronicleHQ Australia,Account2,-200000,54384187.07
03/13/2023,Deposit,Big Company ,Big Company ,Account1,200000,54584187.07
03/13/2023,Transfer,,ServiceA,Account1,250000,54834187.07
03/13/2023,Expense,Interact32,Harvey Spector,Tools & Subscription - G&A,9.93,54834197
03/13/2023,Expense,Figma,,Tools & Subscription - G&A,180,54834377
03/13/2023,Expense,PocketSmith,,Tools & Subscription - G&A,9.95,54834386.95
03/13/2023,Expense,Intercom,,Tools & Subscription - G&A,176,54834562.95
03/13/2023,Expense,,Fees,Account1,2000,54836562.95
03/13/2023,Expense,Intercom,Balapavan Tirumani,Credit Card - Ramp,176,54836738.95
03/13/2023,Transfer,,ServiceA,Account1,250000,55086738.95
03/13/2023,Expense,Vercel,Harris Jose,Credit Card - Ramp,260,55086998.95
03/13/2023,Expense,,Fees,Account1,2000,55088998.95
03/13/2023,Expense,PocketSmith,,Tools & Subscription - G&A,9.95,55089008.9
03/13/2023,Expense,Intercom,Balapavan Tirumani,Credit Card - Ramp,176,55089184.9
03/13/2023,Expense,Interact32,Harvey Spector,Credit Card - Ramp,9.93,55089194.83
03/13/2023,Expense,,Fees,Account1,2000,55091194.83
03/13/2023,Expense,Interact32,Harvey Spector,Credit Card - Ramp,9.93,55091204.76
03/13/2023,Transfer,,PaymentServiceB Savings **6977,Account1,-250000,54841204.76
03/13/2023,Expense,,Fees,Account1,2000,54843204.76
03/13/2023,Expense,Interact32,Harvey Spector,Tools & Subscription - G&A,9.93,54843214.69
03/13/2023,Expense,Intercom,Balapavan Tirumani,Credit Card - Ramp,176,54843390.69
03/13/2023,Expense,Figma,,Tools & Subscription - G&A,180,54843570.69
03/13/2023,Expense,Figma,Mike ross,Credit Card - Ramp,180,54843750.69
03/13/2023,Expense,Vercel,,Tools & Subscription - G&A,260,54844010.69
03/13/2023,Expense,Intercom,,Tools & Subscription - G&A,176,54844186.69
03/13/2023,Expense,PocketSmith,,Tools & Subscription - G&A,9.95,54844196.64
03/13/2023,Expense,Interact32,Harvey Spector,Tools & Subscription - G&A,9.93,54844206.57
03/13/2023,Expense,Vercel,,Tools & Subscription - G&A,260,54844466.57
03/13/2023,Expense,Figma,,Tools & Subscription - G&A,180,54844646.57
03/13/2023,Expense,,Fees,General business expenses:Bank fees & service charges,-2000,54842646.57
03/13/2023,Transfer,,ServiceA,Bank account - Airwallex,-250000,54592646.57
03/13/2023,Expense,Intercom,,Tools & Subscription - G&A,176,54592822.57
03/13/2023,Transfer,,PaymentServiceB Savings **6977,Account1,-250000,54342822.57
03/13/2023,Transfer,,PaymentServiceB Savings **6977,Savings (6977),250000,54592822.57
03/13/2023,Expense,Figma,,Tools & Subscription - G&A,180,54593002.57
03/13/2023,Expense,,Fees,General business expenses:Bank fees & service charges,-2000,54591002.57
03/13/2023,Transfer,,ServiceA,Account1,250000,54841002.57
03/13/2023,Expense,Big Company ,Big Company ,Account1,-200000,54641002.57
03/13/2023,Transfer,,PaymentServiceB Savings **6977,Account1,-250000,54391002.57
03/13/2023,Deposit,Big Company ,Big Company ,Accounts Payable (A/P),200000,54591002.57
03/13/2023,Expense,EntityA,ChronicleHQ Australia,Account2,-200000,54391002.57
03/13/2023,Expense,Big Company ,Big Company ,Accounts Payable (A/P),-200000,54191002.57
03/13/2023,Deposit,Big Company ,Big Company ,Accounts Payable (A/P),200000,54391002.57
03/13/2023,Expense,Big Company ,Big Company ,Accounts Payable (A/P),-200000,54191002.57
03/13/2023,Expense,,Fees,General business expenses:Bank fees & service charges,-2000,54189002.57
03/13/2023,Expense,EntityA,ChronicleHQ Australia,Account2,-200000,53989002.57
03/13/2023,Expense,PocketSmith,Harvey Spector,Credit Card - Ramp,9.95,53989012.52
03/13/2023,Expense,Big Company ,Big Company ,Accounts Payable (A/P),-200000,53789012.52
03/13/2023,Expense,Vercel,Harris Jose,Credit Card - Ramp,260,53789272.52
03/13/2023,Expense,Big Company ,Big Company ,Account1,-200000,53589272.52
03/13/2023,Deposit,Big Company ,Big Company ,Account1,200000,53789272.52
03/13/2023,Expense,PocketSmith,Harvey Spector,Credit Card - Ramp,9.95,53789282.47
03/13/2023,Expense,EntityA,ChronicleHQ Australia,Account2,-200000,53589282.47
03/13/2023,Deposit,Big Company ,Big Company ,Accounts Payable (A/P),200000,53789282.47
03/13/2023,Expense,Figma,Mike ross,Credit Card - Ramp,180,53789462.47
03/14/2023,Expense,OpenAI,,Tools & Subscription - G&A,20,53789482.47
03/14/2023,Expense,Intuit,,Tools & Subscription - G&A,55,53789537.47
03/14/2023,Expense,Intuit,,Tools & Subscription - G&A,55,53789592.47
03/14/2023,Expense,OpenAI,,Tools & Subscription - G&A,20,53789612.47
03/14/2023,Expense,OpenAI,Balapavan Tirumani,Credit Card - Ramp,20,53789632.47
03/14/2023,Expense,Intuit,Harvey Spector,Credit Card - Ramp,55,53789687.47
03/14/2023,Expense,Intuit,,Tools & Subscription - G&A,55,53789742.47
03/14/2023,Expense,Intuit,Harvey Spector,Credit Card - Ramp,55,53789797.47
03/14/2023,Expense,OpenAI,,Tools & Subscription - G&A,20,53789817.47
03/14/2023,Expense,Intuit,Harvey Spector,Credit Card - Ramp,55,53789872.47
03/14/2023,Expense,OpenAI,,Tools & Subscription - G&A,20,53789892.47
03/14/2023,Expense,OpenAI,Balapavan Tirumani,Credit Card - Ramp,20,53789912.47
03/14/2023,Expense,OpenAI,Balapavan Tirumani,Credit Card - Ramp,20,53789932.47
03/14/2023,Expense,Intuit,,Tools & Subscription - G&A,55,53789987.47
03/15/2023,Expense,Cafe Dougie Restaurant,Mike ross,Meals & Entertainment,20.4,53790007.87
03/15/2023,Expense,Cafe Dougie Restaurant,Mike ross,Credit Card - Ramp,20.4,53790028.27
03/15/2023,Expense,Uber,Mike ross,Credit Card - Ramp,29.61,53790057.88
03/15/2023,Expense,Cafe Dougie Restaurant,Mike ross,Credit Card - Ramp,20.4,53790078.28
03/15/2023,Expense,Uber,,Travelling Expenses,29.61,53790107.89
03/15/2023,Expense,PayPal (Ramp Vendor),Mike ross,Credit Card - Ramp,50,53790157.89
03/15/2023,Expense,Cafe Dougie Restaurant,Mike ross,Meals & Entertainment,20.4,53790178.29
03/15/2023,Expense,PayPal (Ramp Vendor),Mike ross,Office expenses,50,53790228.29
03/15/2023,Expense,Cafe Dougie Restaurant,Mike ross,Meals & Entertainment,20.4,53790248.69
03/15/2023,Expense,PayPal (Ramp Vendor),Mike ross,Credit Card - Ramp,50,53790298.69
03/15/2023,Expense,PayPal (Ramp Vendor),Mike ross,Office expenses,50,53790348.69
03/15/2023,Expense,Cafe Dougie Restaurant,Mike ross,Credit Card - Ramp,20.4,53790369.09
03/15/2023,Expense,Uber,,Travelling Expenses,29.61,53790398.7
03/15/2023,Expense,Cafe Dougie Restaurant,Mike ross,Credit Card - Ramp,20.4,53790419.1
03/15/2023,Expense,PayPal (Ramp Vendor),Mike ross,Office expenses,50,53790469.1
03/15/2023,Expense,PayPal (Ramp Vendor),Mike ross,Credit Card - Ramp,50,53790519.1
03/15/2023,Expense,Uber,,Travelling Expenses,29.61,53790548.71
03/15/2023,Expense,PayPal (Ramp Vendor),Mike ross,Credit Card - Ramp,50,53790598.71
03/15/2023,Expense,Uber,Mike ross,Credit Card - Ramp,29.61,53790628.32
03/15/2023,Expense,PayPal (Ramp Vendor),Mike ross,Office expenses,50,53790678.32
03/15/2023,Expense,Uber,,Travelling Expenses,29.61,53790707.93
03/15/2023,Expense,Uber,Mike ross,Credit Card - Ramp,29.61,53790737.54
03/15/2023,Expense,Cafe Dougie Restaurant,Mike ross,Meals & Entertainment,20.4,53790757.94
03/16/2023,Expense,Linear,,Tools & Subscription - G&A,160,53790917.94
03/16/2023,Expense,Notion Labs,,Tools & Subscription - G&A,138.22,53791056.16
03/16/2023,Expense,Zapier,Harvey Spector,Credit Card - Ramp,29.99,53791086.15
03/16/2023,Expense,Notion Labs,,Tools & Subscription - G&A,138.22,53791224.37
03/16/2023,Expense,Notion Labs,,Tools & Subscription - G&A,138.22,53791362.59
03/16/2023,Expense,Zapier,,Tools & Subscription - G&A,29.99,53791392.58
03/16/2023,Expense,Zapier,,Tools & Subscription - G&A,29.99,53791422.57
03/16/2023,Expense,The Carrington,,Meals & Entertainment,19.33,53791441.9
03/16/2023,Expense,Notion Labs,,Tools & Subscription - G&A,138.22,53791580.12
03/16/2023,Expense,The Carrington,Mike ross,Credit Card - Ramp,19.33,53791599.45
03/16/2023,Expense,The Carrington,Mike ross,Credit Card - Ramp,19.33,53791618.78
03/16/2023,Expense,The Carrington,,Meals & Entertainment,19.33,53791638.11
03/16/2023,Expense,Linear,,Tools & Subscription - G&A,160,53791798.11
03/16/2023,Expense,Notion Labs,Mike ross,Credit Card - Ramp,138.22,53791936.33
03/16/2023,Expense,The Carrington,,Meals & Entertainment,19.33,53791955.66
03/16/2023,Expense,Linear,Chad Blumenthal,Credit Card - Ramp,160,53792115.66
03/16/2023,Expense,Linear,Chad Blumenthal,Credit Card - Ramp,160,53792275.66
03/16/2023,Expense,Notion Labs,Mike ross,Credit Card - Ramp,138.22,53792413.88
03/16/2023,Expense,Zapier,Harvey Spector,Credit Card - Ramp,29.99,53792443.87
03/16/2023,Expense,Zapier,Harvey Spector,Credit Card - Ramp,29.99,53792473.86
03/16/2023,Expense,The Carrington,Mike ross,Credit Card - Ramp,19.33,53792493.19
03/16/2023,Expense,Notion Labs,Mike ross,Credit Card - Ramp,138.22,53792631.41
03/16/2023,Expense,The Carrington,,Meals & Entertainment,19.33,53792650.74
03/16/2023,Expense,The Carrington,Mike ross,Credit Card - Ramp,19.33,53792670.07
03/16/2023,Expense,Linear,,Tools & Subscription - G&A,160,53792830.07
03/16/2023,Expense,Zapier,,Tools & Subscription - G&A,29.99,53792860.06
03/16/2023,Expense,Linear,,Tools & Subscription - G&A,160,53793020.06
03/16/2023,Expense,Linear,Chad Blumenthal,Credit Card - Ramp,160,53793180.06
03/16/2023,Expense,Zapier,,Tools & Subscription - G&A,29.99,53793210.05
03/17/2023,Expense,Uber,,Travelling Expenses,50.2,53793260.25
03/17/2023,Expense,Uber,Mike ross,Credit Card - Ramp,50.2,53793310.45
03/17/2023,Expense,Uber,Mike ross,Credit Card - Ramp,12.03,53793322.48
03/17/2023,Expense,Uber,Mike ross,Credit Card - Ramp,12.03,53793334.51
03/17/2023,Expense,Uber,Mike ross,Credit Card - Ramp,46.9,53793381.41
03/17/2023,Expense,Uber,Mike ross,Credit Card - Ramp,12.03,53793393.44
03/17/2023,Expense,Uber,,Travelling Expenses,50.2,53793443.64
03/17/2023,Expense,Uber,,Travelling Expenses,46.9,53793490.54
03/17/2023,Expense,Uber,,Travelling Expenses,50.2,53793540.74
03/17/2023,Expense,Uber,Mike ross,Credit Card - Ramp,50.2,53793590.94
03/17/2023,Expense,Uber,,Travelling Expenses,12.03,53793602.97
03/17/2023,Expense,Uber,Mike ross,Credit Card - Ramp,46.9,53793649.87
03/17/2023,Expense,Uber,,Travelling Expenses,12.03,53793661.9
03/17/2023,Expense,Uber,,Travelling Expenses,46.9,53793708.8
03/17/2023,Expense,Uber,Mike ross,Credit Card - Ramp,46.9,53793755.7
03/17/2023,Expense,Uber,,Travelling Expenses,50.2,53793805.9
03/17/2023,Expense,Uber,Mike ross,Credit Card - Ramp,50.2,53793856.1
03/17/2023,Expense,Uber,,Travelling Expenses,46.9,53793903
03/17/2023,Expense,Uber,,Travelling Expenses,12.03,53793915.03
03/17/2023,Expense,Uber,,Travelling Expenses,46.9,53793961.93
03/17/2023,Expense,Uber,,Travelling Expenses,12.03,53793973.96
03/18/2023,Expense,Uber,,Travelling Expenses,17.58,53793991.54
03/18/2023,Expense,OpenAI,,Tools & Subscription - G&A,20,53794011.54
03/18/2023,Expense,Uber,Mike ross,Credit Card - Ramp,17.58,53794029.12
03/18/2023,Expense,LinkedIn,Mike ross,Credit Card - Ramp,151.35,53794180.47
03/18/2023,Expense,Segment,Balapavan Tirumani,Credit Card - Ramp,120,53794300.47
03/18/2023,Expense,OpenAI,Anik Das,Credit Card - Ramp,20,53794320.47
03/18/2023,Expense,Segment,,Tools & Subscription - G&A,120,53794440.47
03/18/2023,Expense,Loom,Mike ross,Credit Card - Ramp,192,53794632.47
03/18/2023,Expense,LinkedIn,Mike ross,Credit Card - Ramp,151.35,53794783.82
03/18/2023,Expense,Uber,,Travelling Expenses,17.58,53794801.4
03/18/2023,Expense,Loom,,Tools & Subscription - G&A,192,53794993.4
03/18/2023,Expense,Segment,,Tools & Subscription - G&A,120,53795113.4
03/18/2023,Expense,Loom,,Tools & Subscription - G&A,192,53795305.4
03/18/2023,Expense,OpenAI,,Tools & Subscription - G&A,20,53795325.4
03/18/2023,Expense,Loom,,Tools & Subscription - G&A,192,53795517.4
03/18/2023,Expense,Superhuman,Harvey Spector,Credit Card - Ramp,30,53795547.4
03/18/2023,Expense,OpenAI,,Tools & Subscription - G&A,20,53795567.4
03/18/2023,Expense,LinkedIn,,Tools & Subscription - G&A,151.35,53795718.75
03/18/2023,Expense,Uber,Mike ross,Credit Card - Ramp,17.58,53795736.33
03/18/2023,Expense,Uber,,Travelling Expenses,17.58,53795753.91
03/18/2023,Expense,OpenAI,Anik Das,Credit Card - Ramp,20,53795773.91
03/18/2023,Expense,LinkedIn,,Tools & Subscription - G&A,151.35,53795925.26
03/18/2023,Expense,Loom,Mike ross,Credit Card - Ramp,192,53796117.26
03/18/2023,Expense,Superhuman,Harvey Spector,Credit Card - Ramp,30,53796147.26
03/18/2023,Expense,Uber,Mike ross,Credit Card - Ramp,17.58,53796164.84
03/18/2023,Expense,Superhuman,Harvey Spector,Credit Card - Ramp,30,53796194.84
03/18/2023,Expense,Superhuman,,Professional Service Charges,30,53796224.84
03/18/2023,Expense,LinkedIn,,Tools & Subscription - G&A,151.35,53796376.19
03/18/2023,Expense,Segment,,Tools & Subscription - G&A,120,53796496.19
03/18/2023,Expense,OpenAI,,Tools & Subscription - G&A,20,53796516.19
03/18/2023,Expense,Loom,,Tools & Subscription - G&A,192,53796708.19
03/18/2023,Expense,Superhuman,Harvey Spector,Credit Card - Ramp,30,53796738.19
03/18/2023,Expense,LinkedIn,,Tools & Subscription - G&A,151.35,53796889.54
03/18/2023,Expense,OpenAI,Anik Das,Credit Card - Ramp,20,53796909.54
03/18/2023,Expense,Segment,Balapavan Tirumani,Credit Card - Ramp,120,53797029.54
03/18/2023,Expense,Loom,Mike ross,Credit Card - Ramp,192,53797221.54
03/18/2023,Expense,LinkedIn,Mike ross,Credit Card - Ramp,151.35,53797372.89
03/18/2023,Expense,Superhuman,,Professional Service Charges,30,53797402.89
03/18/2023,Expense,Uber,,Travelling Expenses,17.58,53797420.47
03/18/2023,Expense,Segment,,Tools & Subscription - G&A,120,53797540.47
03/18/2023,Expense,Superhuman,,Professional Service Charges,30,53797570.47
03/18/2023,Expense,Segment,Balapavan Tirumani,Credit Card - Ramp,120,53797690.47
03/18/2023,Expense,Superhuman,,Professional Service Charges,30,53797720.47
03/19/2023,Expense,Uber,Mike ross,Credit Card - Ramp,8.85,53797729.32
03/19/2023,Expense,Uber,Mike ross,Credit Card - Ramp,8.85,53797738.17
03/19/2023,Expense,The New York Times,,General business expenses:Memberships & subscriptions,8.07,53797746.24
03/19/2023,Expense,Twitter,Harvey Spector,Credit Card - Ramp,7.89,53797754.13
03/19/2023,Expense,Qantas,Mike ross,Credit Card - Ramp,2011.72,53799765.85
03/19/2023,Expense,Twitter,,Tools & Subscription - G&A,7.89,53799773.74
03/19/2023,Expense,Uber,,Travelling Expenses,8.85,53799782.59
03/19/2023,Expense,The New York Times,,General business expenses:Memberships & subscriptions,8.07,53799790.66
03/19/2023,Expense,Qantas,,Travel:Airfare,2011.72,53801802.38
03/19/2023,Expense,Twitter,,Tools & Subscription - G&A,7.89,53801810.27
03/19/2023,Expense,Uber,,Travelling Expenses,8.85,53801819.12
03/19/2023,Expense,Qantas,Mike ross,Credit Card - Ramp,2011.72,53803830.84
03/19/2023,Expense,The New York Times,Mike ross,Credit Card - Ramp,8.07,53803838.91
03/19/2023,Expense,The New York Times,,General business expenses:Memberships & subscriptions,8.07,53803846.98
03/19/2023,Expense,Uber,,Travelling Expenses,8.85,53803855.83
03/19/2023,Expense,The New York Times,Mike ross,Credit Card - Ramp,8.07,53803863.9
03/19/2023,Expense,Qantas,,Travel:Airfare,2011.72,53805875.62
03/19/2023,Expense,Twitter,Harvey Spector,Credit Card - Ramp,7.89,53805883.51
03/19/2023,Expense,Qantas,Mike ross,Credit Card - Ramp,2011.72,53807895.23
03/19/2023,Expense,The New York Times,,General business expenses:Memberships & subscriptions,8.07,53807903.3
03/19/2023,Expense,Qantas,,Travel:Airfare,2011.72,53809915.02
03/19/2023,Expense,Twitter,,Tools & Subscription - G&A,7.89,53809922.91
03/19/2023,Expense,The New York Times,Mike ross,Credit Card - Ramp,8.07,53809930.98
03/19/2023,Expense,Uber,Mike ross,Credit Card - Ramp,8.85,53809939.83
03/19/2023,Expense,Uber,,Travelling Expenses,8.85,53809948.68
03/19/2023,Expense,Twitter,Harvey Spector,Credit Card - Ramp,7.89,53809956.57
03/19/2023,Expense,Twitter,,Tools & Subscription - G&A,7.89,53809964.46
03/19/2023,Expense,Qantas,,Travel:Airfare,2011.72,53811976.18
03/19/2023,Expense,The New York Times,Mike ross,Credit Card - Ramp,8.07,53811984.25
03/20/2023,Credit Card Payment,RAMP BUSINESS CO,RAMP STATEMENT,Account1,-9659.55,53802324.7
03/20/2023,Expense,Qantas,,Travel:Airfare,209.07,53802533.77
03/20/2023,Expense,Qantas,,Travel:Airfare,209.07,53802742.84
03/20/2023,Expense,LinkedIn,,Tools & Subscription - G&A,120.25,53802863.09
03/20/2023,Credit Card Payment,RAMP BUSINESS CO,RAMP STATEMENT,Account1,-9659.55,53793203.54
03/20/2023,Expense,Qantas,Mike ross,Credit Card - Ramp,209.07,53793412.61
03/20/2023,Expense,LinkedIn,,Tools & Subscription - G&A,120.25,53793532.86
03/20/2023,Credit Card Payment,RAMP BUSINESS CO,RAMP STATEMENT,Account1,-9659.55,53783873.31
03/20/2023,Expense,Graphics Press,,Tools & Subscription - G&A,230,53784103.31
03/20/2023,Expense,Graphics Press,,Tools & Subscription - G&A,230,53784333.31
03/20/2023,Credit Card Payment,RAMP BUSINESS CO,RAMP STATEMENT,Credit Card - Ramp,-9659.55,53774673.76
03/20/2023,Expense,Qantas,,Travel:Airfare,209.07,53774882.83
03/20/2023,Expense,Graphics Press,,Tools & Subscription - G&A,230,53775112.83
03/20/2023,Credit Card Payment,RAMP BUSINESS CO,RAMP STATEMENT,Account1,-9659.55,53765453.28
03/20/2023,Expense,LinkedIn,,Tools & Subscription - G&A,120.25,53765573.53
03/20/2023,Expense,Qantas,Mike ross,Credit Card - Ramp,209.07,53765782.6
03/20/2023,Credit Card Payment,RAMP BUSINESS CO,RAMP STATEMENT,Credit Card - Ramp,-9659.55,53756123.05
03/20/2023,Expense,Qantas,,Travel:Airfare,209.07,53756332.12
03/20/2023,Expense,Graphics Press,Mike ross,Credit Card - Ramp,230,53756562.12
03/20/2023,Expense,Qantas,Mike ross,Credit Card - Ramp,209.07,53756771.19
03/20/2023,Credit Card Payment,RAMP BUSINESS CO,RAMP STATEMENT,Credit Card - Ramp,-9659.55,53747111.64
03/20/2023,Expense,LinkedIn,Niteesha Ravela,Credit Card - Ramp,120.25,53747231.89
03/20/2023,Credit Card Payment,RAMP BUSINESS CO,RAMP STATEMENT,Credit Card - Ramp,-9659.55,53737572.34
03/20/2023,Expense,LinkedIn,Niteesha Ravela,Credit Card - Ramp,120.25,53737692.59
03/20/2023,Expense,LinkedIn,Niteesha Ravela,Credit Card - Ramp,120.25,53737812.84
03/20/2023,Expense,Graphics Press,Mike ross,Credit Card - Ramp,230,53738042.84
03/20/2023,Expense,LinkedIn,,Tools & Subscription - G&A,120.25,53738163.09
03/20/2023,Expense,Graphics Press,,Tools & Subscription - G&A,230,53738393.09
03/20/2023,Expense,Graphics Press,Mike ross,Credit Card - Ramp,230,53738623.09
03/21/2023,Expense,Gumroad,Mike ross,Professional Service Charges,61.6,53738684.69
03/21/2023,Expense,Eightify,Harvey Spector,Credit Card - Ramp,8.95,53738693.64
03/21/2023,Expense,Eightify,,Tools & Subscription - G&A,8.95,53738702.59
03/21/2023,Expense,Gumroad,Mike ross,Credit Card - Ramp,61.6,53738764.19
03/21/2023,Expense,Gum.Co Cc Alexey Seka,Mike ross,Credit Card - Ramp,26.4,53738790.59
03/21/2023,Expense,OpenAI,,Tools & Subscription - G&A,0.91,53738791.5
03/21/2023,Expense,Gum.Co Cc Alexey Seka,Mike ross,Credit Card - Ramp,26.4,53738817.9
03/21/2023,Expense,La Panchina,Mike ross,Credit Card - Ramp,36.72,53738854.62
03/21/2023,Expense,La Panchina,Mike ross,Meals & Entertainment,36.72,53738891.34
03/21/2023,Expense,OpenAI,,Tools & Subscription - G&A,0.91,53738892.25
03/21/2023,Expense,Gumroad,Mike ross,Credit Card - Ramp,61.6,53738953.85
03/21/2023,Expense,Gum.Co Cc Alexey Seka,Mike ross,Credit Card - Ramp,26.4,53738980.25
03/21/2023,Expense,Eightify,,Tools & Subscription - G&A,8.95,53738989.2
03/21/2023,Expense,Gum.Co Cc Alexey Seka,,General business expenses:Memberships & subscriptions,26.4,53739015.6
03/21/2023,Expense,OpenAI,Balapavan Tirumani,Credit Card - Ramp,0.91,53739016.51
03/21/2023,Expense,La Panchina,Mike ross,Credit Card - Ramp,36.72,53739053.23
03/21/2023,Expense,Gum.Co Cc Alexey Seka,,General business expenses:Memberships & subscriptions,26.4,53739079.63
03/21/2023,Expense,Gum.Co Cc Alexey Seka,Mike ross,Credit Card - Ramp,26.4,53739106.03
03/21/2023,Expense,OpenAI,Balapavan Tirumani,Credit Card - Ramp,0.91,53739106.94
03/21/2023,Expense,OpenAI,Balapavan Tirumani,Credit Card - Ramp,0.91,53739107.85
03/21/2023,Expense,Gumroad,Mike ross,Professional Service Charges,61.6,53739169.45
03/21/2023,Expense,La Panchina,Mike ross,Meals & Entertainment,36.72,53739206.17
03/21/2023,Expense,La Panchina,Mike ross,Meals & Entertainment,36.72,53739242.89
03/21/2023,Expense,Gumroad,Mike ross,Credit Card - Ramp,61.6,53739304.49
03/21/2023,Expense,Gum.Co Cc Alexey Seka,,General business expenses:Memberships & subscriptions,26.4,53739330.89
03/21/2023,Expense,OpenAI,,Tools & Subscription - G&A,0.91,53739331.8
03/21/2023,Expense,Gumroad,Mike ross,Professional Service Charges,61.6,53739393.4
03/21/2023,Expense,La Panchina,Mike ross,Credit Card - Ramp,36.72,53739430.12
03/21/2023,Expense,OpenAI,,Tools & Subscription - G&A,0.91,53739431.03
03/21/2023,Expense,Gumroad,Mike ross,Professional Service Charges,61.6,53739492.63
03/21/2023,Expense,Gum.Co Cc Alexey Seka,,General business expenses:Memberships & subscriptions,26.4,53739519.03
03/21/2023,Expense,Eightify,,Tools & Subscription - G&A,8.95,53739527.98
03/21/2023,Expense,Eightify,Harvey Spector,Credit Card - Ramp,8.95,53739536.93
03/21/2023,Expense,Eightify,,Tools & Subscription - G&A,8.95,53739545.88
03/21/2023,Expense,Eightify,Harvey Spector,Credit Card - Ramp,8.95,53739554.83
03/21/2023,Expense,Gumroad,Mike ross,Credit Card - Ramp,61.6,53739616.43
03/21/2023,Expense,La Panchina,Mike ross,Credit Card - Ramp,36.72,53739653.15
03/21/2023,Expense,La Panchina,Mike ross,Meals & Entertainment,36.72,53739689.87
03/22/2023,Expense,Marys Creative Garden Restaurant,Mike ross,Meals & Entertainment,10.04,53739699.91
03/22/2023,Expense,Vimcal,,Tools & Subscription - G&A,15,53739714.91
03/22/2023,Expense,Dovetail,,Tools & Subscription - G&A,70,53739784.91
03/22/2023,Expense,Notion Labs,Mike ross,Credit Card - Ramp,1211.1,53740996.01
03/22/2023,Expense,Notion Labs,,Tools & Subscription - G&A,1211.1,53742207.11
03/22/2023,Expense,Marys Creative Garden Restaurant,Mike ross,Credit Card - Ramp,10.04,53742217.15
03/22/2023,Expense,Notion Labs,,Tools & Subscription - G&A,1211.1,53743428.25
03/22/2023,Expense,Marys Creative Garden Restaurant,Mike ross,Credit Card - Ramp,10.04,53743438.29
03/22/2023,Expense,Marys Creative Garden Restaurant,Mike ross,Meals & Entertainment,10.04,53743448.33
03/22/2023,Expense,Marys Creative Garden Restaurant,Mike ross,Credit Card - Ramp,10.04,53743458.37
03/22/2023,Expense,Dovetail,,Tools & Subscription - G&A,70,53743528.37
03/22/2023,Expense,Notion Labs,,Tools & Subscription - G&A,1211.1,53744739.47
03/22/2023,Expense,Vimcal,,Tools & Subscription - G&A,15,53744754.47
03/22/2023,Expense,Dovetail,Harvey Spector,Credit Card - Ramp,70,53744824.47
03/22/2023,Expense,Vimcal,Harvey Spector,Credit Card - Ramp,15,53744839.47
03/22/2023,Expense,Marys Creative Garden Restaurant,Mike ross,Meals & Entertainment,10.04,53744849.51
03/22/2023,Expense,Dovetail,,Tools & Subscription - G&A,70,53744919.51
03/22/2023,Expense,Marys Creative Garden Restaurant,Mike ross,Meals & Entertainment,10.04,53744929.55
03/22/2023,Expense,Marys Creative Garden Restaurant,Mike ross,Credit Card - Ramp,10.04,53744939.59
03/22/2023,Expense,Vimcal,,Tools & Subscription - G&A,15,53744954.59
03/22/2023,Expense,Vimcal,Harvey Spector,Credit Card - Ramp,15,53744969.59
03/22/2023,Expense,Dovetail,Harvey Spector,Credit Card - Ramp,70,53745039.59
03/22/2023,Expense,Dovetail,,Tools & Subscription - G&A,70,53745109.59
03/22/2023,Expense,Notion Labs,Mike ross,Credit Card - Ramp,1211.1,53746320.69
03/22/2023,Expense,Dovetail,Harvey Spector,Credit Card - Ramp,70,53746390.69
03/22/2023,Expense,Vimcal,Harvey Spector,Credit Card - Ramp,15,53746405.69
03/22/2023,Expense,Notion Labs,,Tools & Subscription - G&A,1211.1,53747616.79
03/22/2023,Expense,Vimcal,,Tools & Subscription - G&A,15,53747631.79
03/22/2023,Expense,Notion Labs,Mike ross,Credit Card - Ramp,1211.1,53748842.89
03/23/2023,Expense,Super,Harvey Spector,Credit Card - Ramp,12,53748854.89
03/23/2023,Expense,Australia,Mike ross,Office expenses:Office supplies,128.78,53748983.67
03/23/2023,Expense,Dymocks Booragoon,Mike ross,Credit Card - Ramp,21.23,53749004.9
03/23/2023,Expense,Dymocks Booragoon,,General business expenses:Memberships & subscriptions,21.23,53749026.13
03/23/2023,Expense,Dymocks Booragoon,Mike ross,Credit Card - Ramp,31.33,53749057.46
03/23/2023,Expense,Uber Eats,Mike ross,Meals & Entertainment,24.3,53749081.76
03/23/2023,Expense,Super,,Tools & Subscription - G&A,12,53749093.76
03/23/2023,Expense,Dymocks Booragoon,,General business expenses:Memberships & subscriptions,31.33,53749125.09
03/23/2023,Expense,Uber Eats,Mike ross,Meals & Entertainment,24.3,53749149.39
03/23/2023,Expense,Super,Harvey Spector,Credit Card - Ramp,12,53749161.39
03/23/2023,Expense,Super,,Tools & Subscription - G&A,12,53749173.39
03/23/2023,Expense,Super,Harvey Spector,Credit Card - Ramp,12,53749185.39
03/23/2023,Expense,Dymocks Booragoon,,General business expenses:Memberships & subscriptions,21.23,53749206.62
03/23/2023,Expense,Australia,Mike ross,Office expenses:Office supplies,128.78,53749335.4
03/23/2023,Expense,Superhuman,,Professional Service Charges,30,53749365.4
03/23/2023,Expense,Dymocks Booragoon,,General business expenses:Memberships & subscriptions,31.33,53749396.73
03/23/2023,Expense,Uber Eats,Mike ross,Meals & Entertainment,24.3,53749421.03
03/23/2023,Expense,Superhuman,Mike ross,Credit Card - Ramp,30,53749451.03
03/23/2023,Expense,Dymocks Booragoon,Mike ross,Credit Card - Ramp,31.33,53749482.36
03/23/2023,Expense,Dymocks Booragoon,Mike ross,Credit Card - Ramp,21.23,53749503.59
03/23/2023,Expense,Uber Eats,Mike ross,Credit Card - Ramp,24.3,53749527.89
03/23/2023,Expense,Superhuman,Mike ross,Credit Card - Ramp,30,53749557.89
03/23/2023,Expense,Uber Eats,Mike ross,Credit Card - Ramp,24.3,53749582.19
03/23/2023,Expense,Super,,Tools & Subscription - G&A,12,53749594.19
03/23/2023,Expense,Dymocks Booragoon,Mike ross,Credit Card - Ramp,31.33,53749625.52
03/23/2023,Expense,Dymocks Booragoon,Mike ross,Credit Card - Ramp,21.23,53749646.75
03/23/2023,Expense,Superhuman,Mike ross,Credit Card - Ramp,30,53749676.75
03/23/2023,Expense,Australia,Mike ross,Credit Card - Ramp,128.78,53749805.53
03/23/2023,Expense,Uber Eats,Mike ross,Credit Card - Ramp,24.3,53749829.83
03/23/2023,Expense,Australia,Mike ross,Credit Card - Ramp,128.78,53749958.61
03/23/2023,Expense,Australia,Mike ross,Credit Card - Ramp,128.78,53750087.39
03/23/2023,Expense,Dymocks Booragoon,,General business expenses:Memberships & subscriptions,21.23,53750108.62
03/23/2023,Expense,Australia,Mike ross,Office expenses:Office supplies,128.78,53750237.4
03/23/2023,Expense,Superhuman,,Professional Service Charges,30,53750267.4
03/23/2023,Expense,Dymocks Booragoon,,General business expenses:Memberships & subscriptions,31.33,53750298.73
03/23/2023,Expense,Dymocks Booragoon,,General business expenses:Memberships & subscriptions,21.23,53750319.96
03/23/2023,Expense,Superhuman,,Professional Service Charges,30,53750349.96
03/23/2023,Expense,Dymocks Booragoon,Mike ross,Credit Card - Ramp,31.33,53750381.29
03/23/2023,Expense,Super,,Tools & Subscription - G&A,12,53750393.29
03/23/2023,Expense,Uber Eats,Mike ross,Credit Card - Ramp,24.3,53750417.59
03/23/2023,Expense,Superhuman,,Professional Service Charges,30,53750447.59
03/23/2023,Expense,Uber Eats,Mike ross,Meals & Entertainment,24.3,53750471.89
03/23/2023,Expense,Australia,Mike ross,Credit Card - Ramp,128.78,53750600.67
03/23/2023,Expense,Dymocks Booragoon,,General business expenses:Memberships & subscriptions,31.33,53750632
03/23/2023,Expense,Superhuman,Mike ross,Credit Card - Ramp,30,53750662
03/23/2023,Expense,Dymocks Booragoon,Mike ross,Credit Card - Ramp,21.23,53750683.23
03/23/2023,Expense,Australia,Mike ross,Office expenses:Office supplies,128.78,53750812.01
03/24/2023,Expense,Benedict Evans,Harvey Spector,Professional Service Charges,10,53750822.01
03/24/2023,Expense,Benedict Evans,Harvey Spector,Professional Service Charges,10,53750832.01
03/24/2023,Expense,Benedict Evans,Harvey Spector,Credit Card - Ramp,10,53750842.01
03/24/2023,Expense,Benedict Evans,Harvey Spector,Professional Service Charges,10,53750852.01
03/24/2023,Expense,Benedict Evans,Harvey Spector,Credit Card - Ramp,10,53750862.01
03/24/2023,Expense,Benedict Evans,Harvey Spector,Credit Card - Ramp,10,53750872.01
03/24/2023,Expense,Benedict Evans,Harvey Spector,Credit Card - Ramp,10,53750882.01
03/24/2023,Expense,Benedict Evans,Harvey Spector,Professional Service Charges,10,53750892.01
03/25/2023,Expense,Zoom,Chad Blumenthal,Credit Card - Ramp,15.99,53750908
03/25/2023,Expense,Miro,,Tools & Subscription - G&A,90,53750998
03/25/2023,Expense,Zoom,Chad Blumenthal,Credit Card - Ramp,15.99,53751013.99
03/25/2023,Expense,Zoom,,Tools & Subscription - G&A,15.99,53751029.98
03/25/2023,Expense,Miro,Mike ross,Credit Card - Ramp,90,53751119.98
03/25/2023,Expense,Miro,,Tools & Subscription - G&A,90,53751209.98
03/25/2023,Expense,Zoom,,Tools & Subscription - G&A,15.99,53751225.97
03/25/2023,Expense,Miro,,Tools & Subscription - G&A,90,53751315.97
03/25/2023,Expense,Miro,Mike ross,Credit Card - Ramp,90,53751405.97
03/25/2023,Expense,Miro,Mike ross,Credit Card - Ramp,90,53751495.97
03/25/2023,Expense,Miro,,Tools & Subscription - G&A,90,53751585.97
03/25/2023,Expense,Zoom,,Tools & Subscription - G&A,15.99,53751601.96
03/25/2023,Expense,Zoom,Chad Blumenthal,Credit Card - Ramp,15.99,53751617.95
03/25/2023,Expense,Zoom,,Tools & Subscription - G&A,15.99,53751633.94
03/26/2023,Expense,Man-made,Harvey Spector,Credit Card - Ramp,19,53751652.94
03/26/2023,Expense,Man-made,Harvey Spector,Credit Card - Ramp,19,53751671.94
03/26/2023,Expense,Artificer,Mike ross,Credit Card - Ramp,3.1,53751675.04
03/26/2023,Expense,Man-made,Harvey Spector,Professional Service Charges,19,53751694.04
03/26/2023,Expense,Man-made,Harvey Spector,Credit Card - Ramp,19,53751713.04
03/26/2023,Expense,Man-made,Harvey Spector,Professional Service Charges,19,53751732.04
03/26/2023,Expense,Artificer,,Meals & Entertainment,3.1,53751735.14
03/26/2023,Expense,Man-made,Harvey Spector,Professional Service Charges,19,53751754.14
03/26/2023,Expense,Artificer,Mike ross,Credit Card - Ramp,3.1,53751757.24
03/26/2023,Expense,Man-made,Harvey Spector,Professional Service Charges,19,53751776.24
03/26/2023,Expense,Artificer,Mike ross,Credit Card - Ramp,3.1,53751779.34
03/26/2023,Expense,Artificer,,Meals & Entertainment,3.1,53751782.44
03/26/2023,Expense,Artificer,Mike ross,Credit Card - Ramp,3.1,53751785.54
03/26/2023,Expense,Man-made,Harvey Spector,Credit Card - Ramp,19,53751804.54
03/26/2023,Expense,Artificer,,Meals & Entertainment,3.1,53751807.64
03/26/2023,Expense,Artificer,,Meals & Entertainment,3.1,53751810.74
03/27/2023,Expense,Cuckoo Callay,Mike ross,Meals & Entertainment,12.61,53751823.35
03/27/2023,Expense,Sentry,Balapavan Tirumani,Credit Card - Ramp,29,53751852.35
03/27/2023,Expense,Splitbee,Harris Jose,Credit Card - Ramp,16.52,53751868.87
03/27/2023,Expense,Cuckoo Callay,Mike ross,Credit Card - Ramp,12.61,53751881.48
03/27/2023,Expense,Splitbee,Harris Jose,Credit Card - Ramp,16.52,53751898
03/27/2023,Expense,Artificer,Mike ross,Credit Card - Ramp,3.09,53751901.09
03/27/2023,Expense,Sentry,Balapavan Tirumani,Credit Card - Ramp,29,53751930.09
03/27/2023,Expense,Sentry,,Tools & Subscription - G&A,29,53751959.09
03/27/2023,Expense,Artificer,Mike ross,Credit Card - Ramp,3.09,53751962.18
03/27/2023,Expense,Splitbee,,Tools & Subscription - G&A,16.52,53751978.7
03/27/2023,Expense,Cuckoo Callay,Mike ross,Meals & Entertainment,12.61,53751991.31
03/27/2023,Expense,Cuckoo Callay,Mike ross,Credit Card - Ramp,12.61,53752003.92
03/27/2023,Expense,Artificer,,Meals & Entertainment,3.09,53752007.01
03/27/2023,Expense,Splitbee,,Tools & Subscription - G&A,16.52,53752023.53
03/27/2023,Expense,Sendinblue,,Tools & Subscription - G&A,57.77,53752081.3
03/27/2023,Expense,Sentry,,Tools & Subscription - G&A,29,53752110.3
03/27/2023,Expense,Sendinblue,Balapavan Tirumani,Credit Card - Ramp,57.77,53752168.07
03/27/2023,Expense,Cuckoo Callay,Mike ross,Meals & Entertainment,12.61,53752180.68
03/27/2023,Expense,Artificer,,Meals & Entertainment,3.09,53752183.77
03/27/2023,Expense,Splitbee,Harris Jose,Credit Card - Ramp,16.52,53752200.29
03/27/2023,Expense,Sendinblue,Balapavan Tirumani,Credit Card - Ramp,57.77,53752258.06
03/27/2023,Expense,Artificer,,Meals & Entertainment,3.09,53752261.15
03/27/2023,Expense,Artificer,,Meals & Entertainment,3.09,53752264.24
03/27/2023,Expense,Sendinblue,,Tools & Subscription - G&A,57.77,53752322.01
03/27/2023,Expense,Cuckoo Callay,Mike ross,Credit Card - Ramp,12.61,53752334.62
03/27/2023,Expense,Sendinblue,Balapavan Tirumani,Credit Card - Ramp,57.77,53752392.39
03/27/2023,Expense,Artificer,Mike ross,Credit Card - Ramp,3.09,53752395.48
03/27/2023,Expense,Sentry,,Tools & Subscription - G&A,29,53752424.48
03/27/2023,Expense,Splitbee,,Tools & Subscription - G&A,16.52,53752441
03/27/2023,Expense,Sendinblue,,Tools & Subscription - G&A,57.77,53752498.77
03/27/2023,Expense,Artificer,Mike ross,Credit Card - Ramp,3.09,53752501.86
03/27/2023,Expense,Cuckoo Callay,Mike ross,Meals & Entertainment,12.61,53752514.47
03/27/2023,Expense,Sentry,,Tools & Subscription - G&A,29,53752543.47
03/27/2023,Expense,Splitbee,,Tools & Subscription - G&A,16.52,53752559.99
03/27/2023,Expense,Cuckoo Callay,Mike ross,Credit Card - Ramp,12.61,53752572.6
03/27/2023,Expense,Sendinblue,,Tools & Subscription - G&A,57.77,53752630.37
03/27/2023,Expense,Sentry,Balapavan Tirumani,Credit Card - Ramp,29,53752659.37
03/28/2023,Expense,TenTo,Mike ross,Meals & Entertainment,6.58,53752665.95
03/28/2023,Expense,Github,,Tools & Subscription - G&A,40,53752705.95
03/28/2023,Expense,Captain'S Cafe Bar And Gr Restaurant,Mike ross,Credit Card - Ramp,68.39,53752774.34
03/28/2023,Expense,Twcoffee Juhu Mumbai Restaurant,Harvey Spector,Credit Card - Ramp,9.07,53752783.41
03/28/2023,Expense,The Carrington,Mike ross,Credit Card - Ramp,17.35,53752800.76
03/28/2023,Expense,Dabang,Mike ross,Credit Card - Ramp,20.26,53752821.02
03/28/2023,Expense,Github,,Tools & Subscription - G&A,40,53752861.02
03/28/2023,Expense,Dabang,Mike ross,Meals & Entertainment,20.26,53752881.28
03/28/2023,Expense,TenTo,Mike ross,Credit Card - Ramp,6.58,53752887.86
03/28/2023,Expense,Twcoffee Juhu Mumbai Restaurant,Harvey Spector,Meals & Entertainment,9.07,53752896.93
03/28/2023,Expense,The Carrington,,Meals & Entertainment,17.35,53752914.28
03/28/2023,Expense,The Carrington,,Meals & Entertainment,17.35,53752931.63
03/28/2023,Expense,Dabang,Mike ross,Meals & Entertainment,20.26,53752951.89
03/28/2023,Expense,Captain'S Cafe Bar And Gr Restaurant,Mike ross,Meals & Entertainment,68.39,53753020.28
03/28/2023,Expense,Twcoffee Juhu Mumbai Restaurant,Harvey Spector,Credit Card - Ramp,9.07,53753029.35
03/28/2023,Expense,Twcoffee Juhu Mumbai Restaurant,Harvey Spector,Meals & Entertainment,9.07,53753038.42
03/28/2023,Expense,Dabang,Mike ross,Meals & Entertainment,20.26,53753058.68
03/28/2023,Expense,TenTo,Mike ross,Meals & Entertainment,6.58,53753065.26
03/28/2023,Expense,Github,Balapavan Tirumani,Credit Card - Ramp,40,53753105.26
03/28/2023,Expense,Github,,Tools & Subscription - G&A,40,53753145.26
03/28/2023,Expense,TenTo,Mike ross,Meals & Entertainment,6.58,53753151.84
03/28/2023,Expense,Captain'S Cafe Bar And Gr Restaurant,Mike ross,Meals & Entertainment,68.39,53753220.23
03/28/2023,Expense,The Carrington,,Meals & Entertainment,17.35,53753237.58
03/28/2023,Expense,The Carrington,Mike ross,Credit Card - Ramp,17.35,53753254.93
03/28/2023,Expense,Twcoffee Juhu Mumbai Restaurant,Harvey Spector,Meals & Entertainment,9.07,53753264
03/28/2023,Expense,Twcoffee Juhu Mumbai Restaurant,Harvey Spector,Credit Card - Ramp,9.07,53753273.07
03/28/2023,Expense,TenTo,Mike ross,Credit Card - Ramp,6.58,53753279.65
03/28/2023,Expense,Captain'S Cafe Bar And Gr Restaurant,Mike ross,Meals & Entertainment,68.39,53753348.04
03/28/2023,Expense,TenTo,Mike ross,Credit Card - Ramp,6.58,53753354.62
03/28/2023,Expense,Dabang,Mike ross,Credit Card - Ramp,20.26,53753374.88
03/28/2023,Expense,Github,Balapavan Tirumani,Credit Card - Ramp,40,53753414.88
03/28/2023,Expense,Github,,Tools & Subscription - G&A,40,53753454.88
03/28/2023,Expense,Captain'S Cafe Bar And Gr Restaurant,Mike ross,Meals & Entertainment,68.39,53753523.27
03/28/2023,Expense,The Carrington,,Meals & Entertainment,17.35,53753540.62
03/28/2023,Expense,TenTo,Mike ross,Meals & Entertainment,6.58,53753547.2
03/28/2023,Expense,Dabang,Mike ross,Meals & Entertainment,20.26,53753567.46
03/28/2023,Expense,Dabang,Mike ross,Credit Card - Ramp,20.26,53753587.72
03/28/2023,Expense,TenTo,Mike ross,Credit Card - Ramp,6.58,53753594.3
03/28/2023,Expense,Github,Balapavan Tirumani,Credit Card - Ramp,40,53753634.3
03/28/2023,Expense,Dabang,Mike ross,Credit Card - Ramp,20.26,53753654.56
03/28/2023,Expense,Twcoffee Juhu Mumbai Restaurant,Harvey Spector,Meals & Entertainment,9.07,53753663.63
03/28/2023,Expense,Captain'S Cafe Bar And Gr Restaurant,Mike ross,Credit Card - Ramp,68.39,53753732.02
03/28/2023,Expense,Twcoffee Juhu Mumbai Restaurant,Harvey Spector,Credit Card - Ramp,9.07,53753741.09
03/28/2023,Expense,Captain'S Cafe Bar And Gr Restaurant,Mike ross,Credit Card - Ramp,68.39,53753809.48
03/28/2023,Expense,The Carrington,Mike ross,Credit Card - Ramp,17.35,53753826.83
03/28/2023,Expense,Captain'S Cafe Bar And Gr Restaurant,Mike ross,Credit Card - Ramp,68.39,53753895.22
03/28/2023,Expense,The Carrington,Mike ross,Credit Card - Ramp,17.35,53753912.57
03/29/2023,Expense,Netlify,,Tools & Subscription - G&A,19,53753931.57
03/29/2023,Expense,Zushi,Mike ross,Meals & Entertainment,43.56,53753975.13
03/29/2023,Expense,Netlify,,Tools & Subscription - G&A,19,53753994.13
03/29/2023,Expense,Netlify,Balapavan Tirumani,Credit Card - Ramp,19,53754013.13
03/29/2023,Expense,Zushi,Mike ross,Credit Card - Ramp,43.56,53754056.69
03/29/2023,Expense,Zushi,Mike ross,Meals & Entertainment,43.56,53754100.25
03/29/2023,Expense,Netlify,Balapavan Tirumani,Credit Card - Ramp,19,53754119.25
03/29/2023,Expense,Zushi,Mike ross,Credit Card - Ramp,43.56,53754162.81
03/29/2023,Expense,Zushi,Mike ross,Meals & Entertainment,43.56,53754206.37
03/29/2023,Expense,Zushi,Mike ross,Meals & Entertainment,43.56,53754249.93
03/29/2023,Expense,Netlify,,Tools & Subscription - G&A,19,53754268.93
03/29/2023,Expense,Netlify,,Tools & Subscription - G&A,19,53754287.93
03/29/2023,Expense,Netlify,Balapavan Tirumani,Credit Card - Ramp,19,53754306.93
03/29/2023,Expense,Zushi,Mike ross,Credit Card - Ramp,43.56,53754350.49
03/29/2023,Expense,Zushi,Mike ross,Credit Card - Ramp,43.56,53754394.05
03/30/2023,Expense,Midjourney,,Tools & Subscription - G&A,105.6,53754499.65
03/30/2023,Expense,Zapier,,Tools & Subscription - G&A,29.99,53754529.64
03/30/2023,Expense,Hypefury,,Tools & Subscription - G&A,175.32,53754704.96
03/30/2023,Expense,Hypefury,,Tools & Subscription - G&A,175.32,53754880.28
03/30/2023,Expense,Zapier,,Tools & Subscription - G&A,29.99,53754910.27
03/30/2023,Expense,Retool,,Tools & Subscription - G&A,90,53755000.27
03/30/2023,Expense,Pragmaticengineer.Com,,Tools & Subscription - G&A,150,53755150.27
03/30/2023,Expense,Retool,Ahielan Ravichandran,Credit Card - Ramp,90,53755240.27
03/30/2023,Expense,Suzuya Restaurant,Mike ross,Meals & Entertainment,39.17,53755279.44
03/30/2023,Expense,Suzuya Restaurant,Mike ross,Credit Card - Ramp,39.17,53755318.61
03/30/2023,Expense,Hypefury,Harvey Spector,Credit Card - Ramp,175.32,53755493.93
03/30/2023,Expense,Suzuya Restaurant,Mike ross,Credit Card - Ramp,39.17,53755533.1
03/30/2023,Expense,Retool,,Tools & Subscription - G&A,90,53755623.1
03/30/2023,Expense,Zapier,Chad Blumenthal,Credit Card - Ramp,29.99,53755653.09
03/30/2023,Expense,Pragmaticengineer.Com,Harris Jose,Credit Card - Ramp,150,53755803.09
03/30/2023,Expense,Retool,,Tools & Subscription - G&A,90,53755893.09
03/30/2023,Expense,Midjourney,,Tools & Subscription - G&A,105.6,53755998.69
03/30/2023,Expense,Zapier,,Tools & Subscription - G&A,29.99,53756028.68
03/30/2023,Expense,Hypefury,,Tools & Subscription - G&A,175.32,53756204
03/30/2023,Expense,Suzuya Restaurant,Mike ross,Credit Card - Ramp,39.17,53756243.17
03/30/2023,Expense,Pragmaticengineer.Com,,Tools & Subscription - G&A,150,53756393.17
03/30/2023,Expense,Midjourney,,Tools & Subscription - G&A,105.6,53756498.77
03/30/2023,Expense,Hypefury,Harvey Spector,Credit Card - Ramp,175.32,53756674.09
03/30/2023,Expense,Suzuya Restaurant,Mike ross,Meals & Entertainment,39.17,53756713.26
03/30/2023,Expense,Hypefury,Harvey Spector,Credit Card - Ramp,175.32,53756888.58
03/30/2023,Expense,Midjourney,Mike ross,Credit Card - Ramp,105.6,53756994.18
03/30/2023,Expense,Pragmaticengineer.Com,Harris Jose,Credit Card - Ramp,150,53757144.18
03/30/2023,Expense,Zapier,Chad Blumenthal,Credit Card - Ramp,29.99,53757174.17
03/30/2023,Expense,Retool,Ahielan Ravichandran,Credit Card - Ramp,90,53757264.17
03/30/2023,Expense,Pragmaticengineer.Com,,Tools & Subscription - G&A,150,53757414.17
03/30/2023,Expense,Suzuya Restaurant,Mike ross,Meals & Entertainment,39.17,53757453.34
03/30/2023,Expense,Pragmaticengineer.Com,Harris Jose,Credit Card - Ramp,150,53757603.34
03/30/2023,Expense,Midjourney,Mike ross,Credit Card - Ramp,105.6,53757708.94
03/30/2023,Expense,Midjourney,Mike ross,Credit Card - Ramp,105.6,53757814.54
03/30/2023,Expense,Retool,,Tools & Subscription - G&A,90,53757904.54
03/30/2023,Expense,Pragmaticengineer.Com,,Tools & Subscription - G&A,150,53758054.54
03/30/2023,Expense,Suzuya Restaurant,Mike ross,Credit Card - Ramp,39.17,53758093.71
03/30/2023,Expense,Suzuya Restaurant,Mike ross,Meals & Entertainment,39.17,53758132.88
03/30/2023,Expense,Hypefury,,Tools & Subscription - G&A,175.32,53758308.2
03/30/2023,Expense,Retool,Ahielan Ravichandran,Credit Card - Ramp,90,53758398.2
03/30/2023,Expense,Zapier,,Tools & Subscription - G&A,29.99,53758428.19
03/30/2023,Expense,Midjourney,,Tools & Subscription - G&A,105.6,53758533.79
03/30/2023,Expense,Zapier,Chad Blumenthal,Credit Card - Ramp,29.99,53758563.78
03/31/2023,Expense,Adobe,Mike ross,Credit Card - Ramp,15.22,53758579
03/31/2023,Expense,The Commons Surry Hil,,Travel:Hotels,10.38,53758589.38
03/31/2023,Bill,Big Company ,"Service Expenses for the month of March 2023 
INR   43,82,039.35    @ 82.2169",Accounts Payable (A/P),53298.52,53811887.9
03/31/2023,Bill,EntityA,,outsources Services - Australia,108066.65,53919954.55
03/31/2023,Credit Card Credit,Retool,Ahielan Ravichandran,Credit Card - Ramp,-90,53919864.55
03/31/2023,Bill,EntityA,Mar2023 Quarter expenses incurred plus 10% mark up per the MSA,Account2,108066.65,54027931.2
03/31/2023,Bill,EntityA,Mar2023 Quarter expenses incurred plus 10% mark up per the MSA,Account2,108066.65,54135997.85
03/31/2023,Expense,Tenacious Restaurant,Mike ross,Meals & Entertainment,8.31,54136006.16
03/31/2023,Credit Card Credit,Retool,Ahielan Ravichandran,Credit Card - Ramp,-90,54135916.16
03/31/2023,Bill,Big Company ,,Outsources Services - India,53298.52,54189214.68
03/31/2023,Expense,Tenacious Restaurant,Mike ross,Meals & Entertainment,8.31,54189222.99
03/31/2023,Expense,Adobe,,Tools & Subscription - S&M,15.22,54189238.21
03/31/2023,Expense,Adobe,,Tools & Subscription - S&M,15.22,54189253.43
03/31/2023,Bill,Big Company ,,Outsources Services - India,53298.52,54242551.95
03/31/2023,Expense,Tenacious Restaurant,Mike ross,Credit Card - Ramp,8.31,54242560.26
03/31/2023,Bill,Big Company ,"Service Expenses for the month of March 2023 
INR   43,82,039.35    @ 82.2169",Accounts Payable (A/P),53298.52,54295858.78
03/31/2023,Credit Card Credit,Retool,,Tools & Subscription - G&A,-90,54295768.78
03/31/2023,Bill,EntityA,,outsources Services - Australia,108066.65,54403835.43
03/31/2023,Credit Card Credit,Retool,,Tools & Subscription - G&A,-90,54403745.43
03/31/2023,Expense,Tenacious Restaurant,Mike ross,Credit Card - Ramp,8.31,54403753.74
03/31/2023,Expense,The Commons Surry Hil,Mike ross,Credit Card - Ramp,10.38,54403764.12
03/31/2023,Bill,EntityA,Mar2023 Quarter expenses incurred plus 10% mark up per the MSA,Account2,108066.65,54511830.77
03/31/2023,Bill,Big Company ,"Service Expenses for the month of March 2023 
INR   43,82,039.35    @ 82.2169",Accounts Payable (A/P),53298.52,54565129.29
03/31/2023,Expense,The Commons Surry Hil,,Travel:Hotels,10.38,54565139.67
03/31/2023,Bill,Big Company ,"Service Expenses for the month of March 2023 
INR   43,82,039.35    @ 82.2169",Accounts Payable (A/P),53298.52,54618438.19
03/31/2023,Bill,EntityA,,outsources Services - Australia,108066.65,54726504.84
03/31/2023,Bill,EntityA,,outsources Services - Australia,108066.65,54834571.49
03/31/2023,Expense,Tenacious Restaurant,Mike ross,Credit Card - Ramp,8.31,54834579.8
03/31/2023,Expense,Adobe,Mike ross,Credit Card - Ramp,15.22,54834595.02
03/31/2023,Expense,Tenacious Restaurant,Mike ross,Credit Card - Ramp,8.31,54834603.33
03/31/2023,Expense,Adobe,Mike ross,Credit Card - Ramp,15.22,54834618.55
03/31/2023,Expense,The Commons Surry Hil,,Travel:Hotels,10.38,54834628.93
03/31/2023,Bill,Big Company ,,Outsources Services - India,53298.52,54887927.45
03/31/2023,Bill,Big Company ,,Outsources Services - India,53298.52,54941225.97
03/31/2023,Expense,The Commons Surry Hil,Mike ross,Credit Card - Ramp,10.38,54941236.35
03/31/2023,Expense,The Commons Surry Hil,,Travel:Hotels,10.38,54941246.73
03/31/2023,Expense,Tenacious Restaurant,Mike ross,Meals & Entertainment,8.31,54941255.04
03/31/2023,Expense,Adobe,,Tools & Subscription - S&M,15.22,54941270.26
03/31/2023,Bill,EntityA,Mar2023 Quarter expenses incurred plus 10% mark up per the MSA,Account2,108066.65,55049336.91
03/31/2023,Credit Card Credit,Retool,,Tools & Subscription - G&A,-90,55049246.91
03/31/2023,Credit Card Credit,Retool,Ahielan Ravichandran,Credit Card - Ramp,-90,55049156.91
03/31/2023,Credit Card Credit,Retool,,Tools & Subscription - G&A,-90,55049066.91
03/31/2023,Expense,Adobe,,Tools & Subscription - S&M,15.22,55049082.13
03/31/2023,Expense,Tenacious Restaurant,Mike ross,Meals & Entertainment,8.31,55049090.44
03/31/2023,Expense,The Commons Surry Hil,Mike ross,Credit Card - Ramp,10.38,55049100.82
04/01/2023,Expense,Google G Suite,Mike ross,Credit Card - Ramp,121.68,55049222.5
04/01/2023,Expense,Google G Suite,,Tools & Subscription - G&A,121.68,55049344.18
04/01/2023,Expense,Google G Suite,,Tools & Subscription - G&A,121.68,55049465.86
04/01/2023,Expense,Google G Suite,Mike ross,Credit Card - Ramp,121.68,55049587.54
04/01/2023,Expense,Google G Suite,Mike ross,Credit Card - Ramp,121.68,55049709.22
04/01/2023,Expense,Google G Suite,,Tools & Subscription - G&A,121.68,55049830.9
04/01/2023,Expense,Google G Suite,,Tools & Subscription - G&A,121.68,55049952.58
04/02/2023,Expense,Render,,Tools & Subscription - G&A,180.34,55050132.92
04/02/2023,Expense,bills,Mike ross,Meals & Entertainment,27.35,55050160.27
04/02/2023,Expense,Tata Starbucks,Harvey Spector,Meals & Entertainment,4.22,55050164.49
04/02/2023,Expense,Tata Starbucks,Harvey Spector,Credit Card - Ramp,4.22,55050168.71
04/02/2023,Expense,Tata Starbucks,Harvey Spector,Meals & Entertainment,4.22,55050172.93
04/02/2023,Expense,June,,Tools & Subscription - G&A,224,55050396.93
04/02/2023,Expense,bills,Mike ross,Meals & Entertainment,27.35,55050424.28
04/02/2023,Expense,June,,Tools & Subscription - G&A,224,55050648.28
04/02/2023,Expense,Render,,Tools & Subscription - G&A,180.34,55050828.62
04/02/2023,Expense,Uber,,Travelling Expenses,18.87,55050847.49
04/02/2023,Expense,Uber,,Travelling Expenses,18.87,55050866.36
04/02/2023,Expense,bills,Mike ross,Credit Card - Ramp,27.35,55050893.71
04/02/2023,Expense,Tata Starbucks,Harvey Spector,Credit Card - Ramp,4.22,55050897.93
04/02/2023,Expense,bills,Mike ross,Credit Card - Ramp,27.35,55050925.28
04/02/2023,Expense,June,Balapavan Tirumani,Credit Card - Ramp,224,55051149.28
04/02/2023,Expense,Render,Balapavan Tirumani,Credit Card - Ramp,180.34,55051329.62
04/02/2023,Expense,Render,Balapavan Tirumani,Credit Card - Ramp,180.34,55051509.96
04/02/2023,Expense,Uber,Mike ross,Credit Card - Ramp,18.87,55051528.83
04/02/2023,Expense,Uber,Mike ross,Credit Card - Ramp,18.87,55051547.7
04/02/2023,Expense,Render,,Tools & Subscription - G&A,180.34,55051728.04
04/02/2023,Expense,Tata Starbucks,Harvey Spector,Meals & Entertainment,4.22,55051732.26
04/02/2023,Expense,bills,Mike ross,Meals & Entertainment,27.35,55051759.61
04/02/2023,Expense,June,,Tools & Subscription - G&A,224,55051983.61
04/02/2023,Expense,Uber,,Travelling Expenses,18.87,55052002.48
04/02/2023,Expense,Render,Balapavan Tirumani,Credit Card - Ramp,180.34,55052182.82
04/02/2023,Expense,June,Balapavan Tirumani,Credit Card - Ramp,224,55052406.82
04/02/2023,Expense,June,Balapavan Tirumani,Credit Card - Ramp,224,55052630.82
04/02/2023,Expense,bills,Mike ross,Credit Card - Ramp,27.35,55052658.17
04/02/2023,Expense,Uber,Mike ross,Credit Card - Ramp,18.87,55052677.04
04/02/2023,Expense,bills,Mike ross,Meals & Entertainment,27.35,55052704.39
04/02/2023,Expense,Uber,,Travelling Expenses,18.87,55052723.26
04/02/2023,Expense,Tata Starbucks,Harvey Spector,Credit Card - Ramp,4.22,55052727.48
04/02/2023,Expense,Tata Starbucks,Harvey Spector,Credit Card - Ramp,4.22,55052731.7
04/02/2023,Expense,bills,Mike ross,Credit Card - Ramp,27.35,55052759.05
04/02/2023,Expense,Tata Starbucks,Harvey Spector,Meals & Entertainment,4.22,55052763.27
04/02/2023,Expense,Render,,Tools & Subscription - G&A,180.34,55052943.61
04/02/2023,Expense,June,,Tools & Subscription - G&A,224,55053167.61
04/03/2023,Expense,VirtualPostMail,Harvey Spector,Credit Card - Ramp,55,55053222.61
04/03/2023,Expense,Uber,,Travelling Expenses,18.59,55053241.2
04/03/2023,Expense,Bourke Street Bakery,Mike ross,Meals & Entertainment,10.18,55053251.38
04/03/2023,Expense,Uber,,Travelling Expenses,7.77,55053259.15
04/03/2023,Expense,Artificer,Mike ross,Credit Card - Ramp,6.29,55053265.44
04/03/2023,Expense,Bourke Street Bakery,Mike ross,Credit Card - Ramp,10.18,55053275.62
04/03/2023,Expense,Artificer,Mike ross,Credit Card - Ramp,6.29,55053281.91
04/03/2023,Expense,VirtualPostMail,Harvey Spector,Credit Card - Ramp,55,55053336.91
04/03/2023,Expense,Artificer,,Meals & Entertainment,6.29,55053343.2
04/03/2023,Expense,VirtualPostMail,,General business expenses:Memberships & subscriptions,55,55053398.2
04/03/2023,Expense,Uber,,Travelling Expenses,7.77,55053405.97
04/03/2023,Expense,Bourke Street Bakery,Mike ross,Meals & Entertainment,10.18,55053416.15
04/03/2023,Expense,VirtualPostMail,Harvey Spector,Credit Card - Ramp,55,55053471.15
04/03/2023,Expense,Uber,Mike ross,Credit Card - Ramp,7.77,55053478.92
04/03/2023,Expense,Uber,Mike ross,Credit Card - Ramp,18.59,55053497.51
04/03/2023,Expense,Bourke Street Bakery,Mike ross,Credit Card - Ramp,10.18,55053507.69
04/03/2023,Expense,VirtualPostMail,,General business expenses:Memberships & subscriptions,55,55053562.69
04/03/2023,Expense,Artificer,,Meals & Entertainment,6.29,55053568.98
04/03/2023,Expense,Artificer,,Meals & Entertainment,6.29,55053575.27
04/03/2023,Expense,Uber,,Travelling Expenses,18.59,55053593.86
04/03/2023,Expense,Bourke Street Bakery,Mike ross,Credit Card - Ramp,10.18,55053604.04
04/03/2023,Expense,VirtualPostMail,,General business expenses:Memberships & subscriptions,55,55053659.04
04/03/2023,Expense,Bourke Street Bakery,Mike ross,Meals & Entertainment,10.18,55053669.22
04/03/2023,Expense,Artificer,Mike ross,Credit Card - Ramp,6.29,55053675.51
04/03/2023,Expense,Uber,,Travelling Expenses,7.77,55053683.28
04/03/2023,Expense,Artificer,,Meals & Entertainment,6.29,55053689.57
04/03/2023,Expense,Uber,Mike ross,Credit Card - Ramp,7.77,55053697.34
04/03/2023,Expense,Uber,Mike ross,Credit Card - Ramp,7.77,55053705.11
04/03/2023,Expense,Uber,Mike ross,Credit Card - Ramp,18.59,55053723.7
04/03/2023,Expense,Uber,,Travelling Expenses,7.77,55053731.47
04/03/2023,Expense,VirtualPostMail,,General business expenses:Memberships & subscriptions,55,55053786.47
04/03/2023,Expense,Uber,,Travelling Expenses,18.59,55053805.06
04/03/2023,Expense,Uber,Mike ross,Credit Card - Ramp,18.59,55053823.65
04/03/2023,Expense,Bourke Street Bakery,Mike ross,Credit Card - Ramp,10.18,55053833.83
04/03/2023,Expense,Artificer,Mike ross,Credit Card - Ramp,6.29,55053840.12
04/03/2023,Expense,Bourke Street Bakery,Mike ross,Meals & Entertainment,10.18,55053850.3
04/03/2023,Expense,Uber,,Travelling Expenses,18.59,55053868.89
04/03/2023,Expense,VirtualPostMail,Harvey Spector,Credit Card - Ramp,55,55053923.89
04/04/2023,Expense,KAWA,Mike ross,Meals & Entertainment,16.61,55053940.5
04/04/2023,Expense,Artificer,Mike ross,Credit Card - Ramp,6.65,55053947.15
04/04/2023,Expense,Ventuno Restaurant,Mike ross,Credit Card - Ramp,83.2,55054030.35
04/04/2023,Expense,KAWA,Mike ross,Credit Card - Ramp,16.61,55054046.96
04/04/2023,Expense,Uber,Mike ross,Credit Card - Ramp,10.83,55054057.79
04/04/2023,Expense,KAWA,Mike ross,Meals & Entertainment,16.61,55054074.4
04/04/2023,Expense,Uber,Mike ross,Credit Card - Ramp,13.6,55054088
04/04/2023,Expense,Uber,,Travelling Expenses,10.83,55054098.83
04/04/2023,Expense,Artificer,,Meals & Entertainment,6.65,55054105.48
04/04/2023,Expense,Artificer,,Meals & Entertainment,6.65,55054112.13
04/04/2023,Deposit,,Interest Accrual INTEREST,Interest Received,4.33,55054116.46
04/04/2023,Expense,Uber,,Travelling Expenses,13.6,55054130.06
04/04/2023,Deposit,,Interest Accrual INTEREST,Savings (6977),4.33,55054134.39
04/04/2023,Expense,Income Capitals ,Income Capitals ,Account1,10172,55064306.39
04/04/2023,Expense,Uber,,Travelling Expenses,10.83,55064317.22
04/04/2023,Expense,Uber,,Travelling Expenses,13.6,55064330.82
04/04/2023,Expense,Uber,,Travelling Expenses,13.6,55064344.42
04/04/2023,Expense,Artificer,,Meals & Entertainment,6.65,55064351.07
04/04/2023,Expense,Ventuno Restaurant,Mike ross,Credit Card - Ramp,83.2,55064434.27
04/04/2023,Expense,Income Capitals ,Income Capitals ,Contract labor,-10172,55054262.27
04/04/2023,Expense,Ventuno Restaurant,Mike ross,Meals & Entertainment,83.2,55054345.47
04/04/2023,Deposit,,Interest Accrual INTEREST,Savings (6977),4.33,55054349.8
04/04/2023,Expense,Artificer,Mike ross,Credit Card - Ramp,6.65,55054356.45
04/04/2023,Expense,Uber,,Travelling Expenses,13.6,55054370.05
04/04/2023,Expense,Income Capitals ,Income Capitals ,Contract labor,-10172,55044198.05
04/04/2023,Expense,Ventuno Restaurant,Mike ross,Meals & Entertainment,83.2,55044281.25
04/04/2023,Expense,Uber,Mike ross,Credit Card - Ramp,13.6,55044294.85
04/04/2023,Expense,Income Capitals ,Income Capitals ,Contract labor,-10172,55034122.85
04/04/2023,Expense,KAWA,Mike ross,Credit Card - Ramp,16.61,55034139.46
04/04/2023,Expense,KAWA,Mike ross,Meals & Entertainment,16.61,55034156.07
04/04/2023,Expense,Income Capitals ,Income Capitals ,Contract labor,-10172,55023984.07
04/04/2023,Expense,Income Capitals ,Income Capitals ,Account1,10172,55034156.07
04/04/2023,Expense,Uber,,Travelling Expenses,10.83,55034166.9
04/04/2023,Expense,Ventuno Restaurant,Mike ross,Meals & Entertainment,83.2,55034250.1
04/04/2023,Expense,Uber,Mike ross,Credit Card - Ramp,10.83,55034260.93
04/04/2023,Expense,Uber,Mike ross,Credit Card - Ramp,13.6,55034274.53
04/04/2023,Expense,Uber,,Travelling Expenses,10.83,55034285.36
04/04/2023,Expense,Artificer,,Meals & Entertainment,6.65,55034292.01
04/04/2023,Expense,KAWA,Mike ross,Credit Card - Ramp,16.61,55034308.62
04/04/2023,Expense,Ventuno Restaurant,Mike ross,Meals & Entertainment,83.2,55034391.82
04/04/2023,Expense,Ventuno Restaurant,Mike ross,Credit Card - Ramp,83.2,55034475.02
04/04/2023,Expense,KAWA,Mike ross,Credit Card - Ramp,16.61,55034491.63
04/04/2023,Expense,Ventuno Restaurant,Mike ross,Credit Card - Ramp,83.2,55034574.83
04/04/2023,Expense,Artificer,Mike ross,Credit Card - Ramp,6.65,55034581.48
04/04/2023,Deposit,,Interest Accrual INTEREST,Savings (6977),4.33,55034585.81
04/04/2023,Deposit,,Interest Accrual INTEREST,Interest Received,4.33,55034590.14
04/04/2023,Expense,KAWA,Mike ross,Meals & Entertainment,16.61,55034606.75
04/04/2023,Deposit,,Interest Accrual INTEREST,Interest Received,4.33,55034611.08
04/04/2023,Expense,Income Capitals ,Income Capitals ,Account1,10172,55044783.08
04/04/2023,Expense,Income Capitals ,Income Capitals ,Account1,10172,55054955.08
04/04/2023,Expense,Uber,Mike ross,Credit Card - Ramp,10.83,55054965.91
04/04/2023,Deposit,,Interest Accrual INTEREST,Interest Received,4.33,55054970.24
04/04/2023,Expense,Artificer,Mike ross,Credit Card - Ramp,6.65,55054976.89
04/05/2023,Expense,Uber,Harvey Spector,Credit Card - Ramp,0.62,55054977.51
04/05/2023,Expense,Uber,Harvey Spector,Credit Card - Ramp,0.62,55054978.13
04/05/2023,Expense,Uber,Harvey Spector,Credit Card - Ramp,0.62,55054978.75
04/05/2023,Expense,Uber,,Travelling Expenses,0.62,55054979.37
04/05/2023,Expense,Uber,,Travelling Expenses,0.62,55054979.99
04/05/2023,Expense,Uber,,Travelling Expenses,0.62,55054980.61
04/05/2023,Expense,Uber,,Travelling Expenses,0.62,55054981.23
04/06/2023,Expense,Adobe,,Tools & Subscription - S&M,85.21,55055066.44
04/06/2023,Expense,Adobe,,Tools & Subscription - S&M,85.21,55055151.65
04/06/2023,Expense,Uber,,Travelling Expenses,11.63,55055163.28
04/06/2023,Expense,Adobe,Mike ross,Credit Card - Ramp,85.21,55055248.49
04/06/2023,Expense,Uber,,Travelling Expenses,11.63,55055260.12
04/06/2023,Expense,Uber,,Travelling Expenses,11.63,55055271.75
04/06/2023,Expense,Adobe,,Tools & Subscription - S&M,85.21,55055356.96
04/06/2023,Expense,Uber,Mike ross,Credit Card - Ramp,11.63,55055368.59
04/06/2023,Expense,Adobe,Mike ross,Credit Card - Ramp,85.21,55055453.8
04/06/2023,Expense,Uber,Mike ross,Credit Card - Ramp,11.63,55055465.43
04/06/2023,Expense,Uber,Mike ross,Credit Card - Ramp,11.63,55055477.06
04/06/2023,Expense,Adobe,,Tools & Subscription - S&M,85.21,55055562.27
04/06/2023,Expense,Adobe,Mike ross,Credit Card - Ramp,85.21,55055647.48
04/06/2023,Expense,Uber,,Travelling Expenses,11.63,55055659.11
04/07/2023,Expense,Mailchimp,Mike ross,Credit Card - Ramp,22.18,55055681.29
04/07/2023,Expense,OpenAI,,Tools & Subscription - G&A,7.78,55055689.07
04/07/2023,Expense,OpenAI,Balapavan Tirumani,Credit Card - Ramp,7.78,55055696.85
04/07/2023,Expense,Vistara,Harvey Spector,Credit Card - Ramp,125.89,55055822.74
04/07/2023,Expense,Vistara,,Travel:Airfare,125.89,55055948.63
04/07/2023,Expense,Mailchimp,,Tools & Subscription - G&A,22.18,55055970.81
04/07/2023,Expense,Vistara,Harvey Spector,Credit Card - Ramp,125.89,55056096.7
04/07/2023,Expense,OpenAI,Balapavan Tirumani,Credit Card - Ramp,7.78,55056104.48
04/07/2023,Expense,Mailchimp,Mike ross,Credit Card - Ramp,22.18,55056126.66
04/07/2023,Expense,OpenAI,,Tools & Subscription - G&A,7.78,55056134.44
04/07/2023,Expense,OpenAI,Balapavan Tirumani,Credit Card - Ramp,7.78,55056142.22
04/07/2023,Expense,Mailchimp,,Tools & Subscription - G&A,22.18,55056164.4
04/07/2023,Expense,Mailchimp,Mike ross,Credit Card - Ramp,22.18,55056186.58
04/07/2023,Expense,OpenAI,,Tools & Subscription - G&A,7.78,55056194.36
04/07/2023,Expense,Vistara,,Travel:Airfare,125.89,55056320.25
04/07/2023,Expense,Vistara,,Travel:Airfare,125.89,55056446.14
04/07/2023,Expense,Mailchimp,,Tools & Subscription - G&A,22.18,55056468.32
04/07/2023,Expense,OpenAI,,Tools & Subscription - G&A,7.78,55056476.1
04/07/2023,Expense,Mailchimp,,Tools & Subscription - G&A,22.18,55056498.28
04/07/2023,Expense,Vistara,Harvey Spector,Credit Card - Ramp,125.89,55056624.17
04/07/2023,Expense,Vistara,,Travel:Airfare,125.89,55056750.06
04/08/2023,Expense,Uber,,Travelling Expenses,10.19,55056760.25
04/08/2023,Expense,Uber,Mike ross,Credit Card - Ramp,10.42,55056770.67
04/08/2023,Credit Card Credit,Superhuman,,Professional Service Charges,-30,55056740.67
04/08/2023,Expense,Uber,,Travelling Expenses,10.19,55056750.86
04/08/2023,Credit Card Credit,Superhuman,Harvey Spector,Credit Card - Ramp,-30,55056720.86
04/08/2023,Credit Card Credit,Superhuman,Harvey Spector,Credit Card - Ramp,-30,55056690.86
04/08/2023,Credit Card Credit,Superhuman,,Professional Service Charges,-30,55056660.86
04/08/2023,Expense,Uber,,Travelling Expenses,10.42,55056671.28
04/08/2023,Expense,Uber,Mike ross,Credit Card - Ramp,10.42,55056681.7
04/08/2023,Expense,Uber,Mike ross,Credit Card - Ramp,10.19,55056691.89
04/08/2023,Expense,Uber,,Travelling Expenses,10.19,55056702.08
04/08/2023,Credit Card Credit,Superhuman,,Professional Service Charges,-30,55056672.08
04/08/2023,Expense,Uber,Mike ross,Credit Card - Ramp,10.42,55056682.5
04/08/2023,Credit Card Credit,Superhuman,Harvey Spector,Credit Card - Ramp,-30,55056652.5
04/08/2023,Credit Card Credit,Superhuman,Harvey Spector,Credit Card - Ramp,-30,55056622.5
04/08/2023,Expense,Uber,,Travelling Expenses,10.19,55056632.69
04/08/2023,Expense,Uber,Mike ross,Credit Card - Ramp,10.19,55056642.88
04/08/2023,Expense,Uber,,Travelling Expenses,10.42,55056653.3
04/08/2023,Expense,Uber,,Travelling Expenses,10.42,55056663.72
04/08/2023,Credit Card Credit,Superhuman,,Professional Service Charges,-30,55056633.72
04/08/2023,Expense,Uber,Mike ross,Credit Card - Ramp,10.19,55056643.91
04/08/2023,Expense,Uber,,Travelling Expenses,10.42,55056654.33
04/09/2023,Expense,LinkedIn,Harvey Spector,Credit Card - Ramp,105.74,55056760.07
04/09/2023,Expense,Usersnap,,Tools & Subscription - G&A,19,55056779.07
04/09/2023,Expense,Usersnap,,Tools & Subscription - G&A,19,55056798.07
04/09/2023,Expense,LinkedIn,,Tools & Subscription - G&A,105.74,55056903.81
04/09/2023,Expense,Uber,,Travelling Expenses,19.66,55056923.47
04/09/2023,Expense,LinkedIn,Harvey Spector,Credit Card - Ramp,105.74,55057029.21
04/09/2023,Expense,LinkedIn,Harvey Spector,Credit Card - Ramp,105.74,55057134.95
04/09/2023,Expense,Uber,Mike ross,Credit Card - Ramp,19.66,55057154.61
04/09/2023,Expense,Taplio,,Tools & Subscription - G&A,39,55057193.61
04/09/2023,Expense,Taplio,Harvey Spector,Credit Card - Ramp,39,55057232.61
04/09/2023,Expense,Usersnap,Harris Jose,Credit Card - Ramp,19,55057251.61
04/09/2023,Expense,Usersnap,Harris Jose,Credit Card - Ramp,19,55057270.61
04/09/2023,Expense,Uber,,Travelling Expenses,19.66,55057290.27
04/09/2023,Expense,LinkedIn,,Tools & Subscription - G&A,105.74,55057396.01
04/09/2023,Expense,Taplio,Harvey Spector,Credit Card - Ramp,39,55057435.01
04/09/2023,Expense,Taplio,Harvey Spector,Credit Card - Ramp,39,55057474.01
04/09/2023,Expense,Uber,,Travelling Expenses,19.66,55057493.67
04/09/2023,Expense,Uber,Mike ross,Credit Card - Ramp,19.66,55057513.33
04/09/2023,Expense,Uber,Mike ross,Credit Card - Ramp,19.66,55057532.99
04/09/2023,Expense,Taplio,,Tools & Subscription - G&A,39,55057571.99
04/09/2023,Expense,Usersnap,,Tools & Subscription - G&A,19,55057590.99
04/09/2023,Expense,LinkedIn,,Tools & Subscription - G&A,105.74,55057696.73
04/09/2023,Expense,Uber,,Travelling Expenses,19.66,55057716.39
04/09/2023,Expense,Taplio,,Tools & Subscription - G&A,39,55057755.39
04/09/2023,Expense,Taplio,,Tools & Subscription - G&A,39,55057794.39
04/09/2023,Expense,LinkedIn,,Tools & Subscription - G&A,105.74,55057900.13
04/09/2023,Expense,Usersnap,,Tools & Subscription - G&A,19,55057919.13
04/09/2023,Expense,Usersnap,Harris Jose,Credit Card - Ramp,19,55057938.13
04/10/2023,Expense,Pause Cafe,Harvey Spector,Credit Card - Ramp,13,55057951.13
04/10/2023,Expense,Rewind AI,,Tools & Subscription - G&A,20,55057971.13
04/10/2023,Expense,Uber,,Travelling Expenses,14.83,55057985.96
04/10/2023,Expense,Pause Cafe,Harvey Spector,Credit Card - Ramp,13,55057998.96
04/10/2023,Expense,Paper and Pie,Mike ross,Meals & Entertainment,13.62,55058012.58
04/10/2023,Expense,Heroku,Balapavan Tirumani,Tools & Subscription - S&M,85,55058097.58
04/10/2023,Expense,Pause Cafe,Harvey Spector,Meals & Entertainment,13,55058110.58
04/10/2023,Expense,Heroku,Balapavan Tirumani,Credit Card - Ramp,85,55058195.58
04/10/2023,Expense,Paper and Pie,Mike ross,Meals & Entertainment,13.62,55058209.2
04/10/2023,Expense,Pause Cafe,Harvey Spector,Meals & Entertainment,13,55058222.2
04/10/2023,Expense,Uber,,Travelling Expenses,1.32,55058223.52
04/10/2023,Expense,Uber,,Travelling Expenses,14.83,55058238.35
04/10/2023,Expense,Heroku,Balapavan Tirumani,Tools & Subscription - S&M,85,55058323.35
04/10/2023,Expense,Heroku,Balapavan Tirumani,Credit Card - Ramp,85,55058408.35
04/10/2023,Expense,Rewind AI,,Tools & Subscription - G&A,20,55058428.35
04/10/2023,Expense,Pause Cafe,Harvey Spector,Meals & Entertainment,13,55058441.35
04/10/2023,Expense,Uber,Mike ross,Credit Card - Ramp,1.32,55058442.67
04/10/2023,Expense,Uber,Mike ross,Credit Card - Ramp,14.83,55058457.5
04/10/2023,Expense,Heroku,Balapavan Tirumani,Credit Card - Ramp,85,55058542.5
04/10/2023,Expense,Paper and Pie,Mike ross,Credit Card - Ramp,13.62,55058556.12
04/10/2023,Expense,Rewind AI,Harvey Spector,Credit Card - Ramp,20,55058576.12
04/10/2023,Expense,Paper and Pie,Mike ross,Credit Card - Ramp,13.62,55058589.74
04/10/2023,Expense,Rewind AI,Harvey Spector,Credit Card - Ramp,20,55058609.74
04/10/2023,Expense,Uber,,Travelling Expenses,1.32,55058611.06
04/10/2023,Expense,Rewind AI,,Tools & Subscription - G&A,20,55058631.06
04/10/2023,Expense,Uber,,Travelling Expenses,14.83,55058645.89
04/10/2023,Expense,Uber,Mike ross,Credit Card - Ramp,14.83,55058660.72
04/10/2023,Expense,Uber,Mike ross,Credit Card - Ramp,1.32,55058662.04
04/10/2023,Expense,Uber,Mike ross,Credit Card - Ramp,1.32,55058663.36
04/10/2023,Expense,Uber,Mike ross,Credit Card - Ramp,14.83,55058678.19
04/10/2023,Expense,Rewind AI,Harvey Spector,Credit Card - Ramp,20,55058698.19
04/10/2023,Expense,Heroku,Balapavan Tirumani,Tools & Subscription - S&M,85,55058783.19
04/10/2023,Expense,Paper and Pie,Mike ross,Credit Card - Ramp,13.62,55058796.81
04/10/2023,Expense,Paper and Pie,Mike ross,Meals & Entertainment,13.62,55058810.43
04/10/2023,Expense,Uber,,Travelling Expenses,1.32,55058811.75
04/10/2023,Expense,Paper and Pie,Mike ross,Meals & Entertainment,13.62,55058825.37
04/10/2023,Expense,Uber,,Travelling Expenses,1.32,55058826.69
04/10/2023,Expense,Uber,,Travelling Expenses,14.83,55058841.52
04/10/2023,Expense,Heroku,Balapavan Tirumani,Tools & Subscription - S&M,85,55058926.52
04/10/2023,Expense,Rewind AI,,Tools & Subscription - G&A,20,55058946.52
04/10/2023,Expense,Pause Cafe,Harvey Spector,Meals & Entertainment,13,55058959.52
04/10/2023,Expense,Paper and Pie,Mike ross,Credit Card - Ramp,13.62,55058973.14
04/10/2023,Expense,Pause Cafe,Harvey Spector,Credit Card - Ramp,13,55058986.14
04/10/2023,Expense,Pause Cafe,Harvey Spector,Credit Card - Ramp,13,55058999.14
04/11/2023,Expense,Datadog,,Tools & Subscription - G&A,3.7,55059002.84
04/11/2023,Expense,Datadog,Balapavan Tirumani,Credit Card - Ramp,3.7,55059006.54
04/11/2023,Expense,Datadog,,Tools & Subscription - G&A,3.7,55059010.24
04/11/2023,Expense,Datadog,Balapavan Tirumani,Credit Card - Ramp,3.7,55059013.94
04/11/2023,Expense,Datadog,Balapavan Tirumani,Credit Card - Ramp,3.7,55059017.64
04/11/2023,Expense,Datadog,,Tools & Subscription - G&A,3.7,55059021.34
04/11/2023,Expense,Datadog,,Tools & Subscription - G&A,3.7,55059025.04
04/12/2023,Expense,The Oberoi Udaivilas,Mike ross,Credit Card - Ramp,535.72,55059560.76
04/12/2023,Expense,WordPress,Harris Jose,Credit Card - Ramp,15.84,55059576.6
04/12/2023,Expense,Adobe Ps Cloud Trial,Chris George,Credit Card - Ramp,20.99,55059597.59
04/12/2023,Expense,Sendinblue,Balapavan Tirumani,Credit Card - Ramp,4.33,55059601.92
04/12/2023,Expense,The Oberoi Udaivilas,Mike ross,Credit Card - Ramp,57.57,55059659.49
04/12/2023,Expense,Uber,Mike ross,Credit Card - Ramp,6.19,55059665.68
04/12/2023,Expense,WordPress,,Tools & Subscription - G&A,15.84,55059681.52
04/12/2023,Expense,Adobe Ps Cloud Trial,,Tools & Subscription - G&A,20.99,55059702.51
04/12/2023,Expense,WordPress,,Tools & Subscription - G&A,15.84,55059718.35
04/12/2023,Expense,The Oberoi Udaivilas,,Travel:Hotels,57.57,55059775.92
04/12/2023,Expense,Uber,,Travelling Expenses,6.64,55059782.56
04/12/2023,Expense,The Oberoi Udaivilas,,Travel:Hotels,535.72,55060318.28
04/12/2023,Expense,Sendinblue,,Tools & Subscription - G&A,4.33,55060322.61
04/12/2023,Expense,Uber,,Travelling Expenses,6.19,55060328.8
04/12/2023,Expense,Uber,,Travelling Expenses,6.64,55060335.44
04/12/2023,Expense,Uber,,Travelling Expenses,6.19,55060341.63
04/12/2023,Expense,The Oberoi Udaivilas,,Travel:Hotels,57.57,55060399.2
04/12/2023,Expense,Uber,Mike ross,Credit Card - Ramp,6.19,55060405.39
04/12/2023,Expense,Uber,Mike ross,Credit Card - Ramp,6.64,55060412.03
04/12/2023,Expense,Sendinblue,,Tools & Subscription - G&A,4.33,55060416.36
04/12/2023,Expense,Uber,Mike ross,Credit Card - Ramp,6.64,55060423
04/12/2023,Expense,Uber,Mike ross,Credit Card - Ramp,6.64,55060429.64
04/12/2023,Expense,The Oberoi Udaivilas,,Travel:Hotels,535.72,55060965.36
04/12/2023,Expense,Uber,Mike ross,Credit Card - Ramp,6.19,55060971.55
04/12/2023,Expense,Sendinblue,,Tools & Subscription - G&A,4.33,55060975.88
04/12/2023,Expense,Sendinblue,Balapavan Tirumani,Credit Card - Ramp,4.33,55060980.21
04/12/2023,Expense,Adobe Ps Cloud Trial,,Tools & Subscription - G&A,20.99,55061001.2
04/12/2023,Expense,Adobe Ps Cloud Trial,,Tools & Subscription - G&A,20.99,55061022.19
04/12/2023,Expense,Adobe Ps Cloud Trial,Chris George,Credit Card - Ramp,20.99,55061043.18
04/12/2023,Expense,The Oberoi Udaivilas,Mike ross,Credit Card - Ramp,57.57,55061100.75
04/12/2023,Expense,The Oberoi Udaivilas,Mike ross,Credit Card - Ramp,535.72,55061636.47
04/12/2023,Expense,Sendinblue,,Tools & Subscription - G&A,4.33,55061640.8
04/12/2023,Expense,WordPress,Harris Jose,Credit Card - Ramp,15.84,55061656.64
04/12/2023,Expense,Adobe Ps Cloud Trial,Chris George,Credit Card - Ramp,20.99,55061677.63
04/12/2023,Expense,Sendinblue,Balapavan Tirumani,Credit Card - Ramp,4.33,55061681.96
04/12/2023,Expense,The Oberoi Udaivilas,,Travel:Hotels,535.72,55062217.68
04/12/2023,Expense,Uber,,Travelling Expenses,6.64,55062224.32
04/12/2023,Expense,WordPress,Harris Jose,Credit Card - Ramp,15.84,55062240.16
04/12/2023,Expense,The Oberoi Udaivilas,Mike ross,Credit Card - Ramp,57.57,55062297.73
04/12/2023,Expense,The Oberoi Udaivilas,,Travel:Hotels,57.57,55062355.3
04/12/2023,Expense,Uber,,Travelling Expenses,6.19,55062361.49
04/12/2023,Expense,The Oberoi Udaivilas,,Travel:Hotels,535.72,55062897.21
04/12/2023,Expense,The Oberoi Udaivilas,,Travel:Hotels,57.57,55062954.78
04/12/2023,Expense,WordPress,,Tools & Subscription - G&A,15.84,55062970.62
04/12/2023,Expense,WordPress,,Tools & Subscription - G&A,15.84,55062986.46
04/12/2023,Expense,Adobe Ps Cloud Trial,,Tools & Subscription - G&A,20.99,55063007.45
04/12/2023,Expense,Uber,,Travelling Expenses,6.19,55063013.64
04/12/2023,Expense,The Oberoi Udaivilas,Mike ross,Credit Card - Ramp,535.72,55063549.36
04/12/2023,Expense,Uber,,Travelling Expenses,6.64,55063556
04/13/2023,Expense,Uber,Mike ross,Credit Card - Ramp,8.39,55063564.39
04/13/2023,Expense,LottieFiles,,Tools & Subscription - G&A,239.88,55063804.27
04/13/2023,Expense,Uber,Mike ross,Credit Card - Ramp,8.06,55063812.33
04/13/2023,Expense,Interact32,Harvey Spector,Credit Card - Ramp,10.23,55063822.56
04/13/2023,Expense,Uber,Mike ross,Credit Card - Ramp,5.02,55063827.58
04/13/2023,Expense,Uber,Mike ross,Credit Card - Ramp,8.06,55063835.64
04/13/2023,Expense,Uber,,Travelling Expenses,8.06,55063843.7
04/13/2023,Expense,PocketSmith,Harvey Spector,Credit Card - Ramp,9.95,55063853.65
04/13/2023,Expense,LottieFiles,Mike ross,Credit Card - Ramp,239.88,55064093.53
04/13/2023,Expense,Intercom,Balapavan Tirumani,Credit Card - Ramp,138,55064231.53
04/13/2023,Expense,Vercel,Harris Jose,Credit Card - Ramp,260,55064491.53
04/13/2023,Expense,Figma,Mike ross,Credit Card - Ramp,215,55064706.53
04/13/2023,Expense,Uber,,Travelling Expenses,8.06,55064714.59
04/13/2023,Expense,Uber,,Travelling Expenses,8.06,55064722.65
04/13/2023,Expense,Interact32,Harvey Spector,Tools & Subscription - G&A,10.23,55064732.88
04/13/2023,Expense,Interact32,Harvey Spector,Tools & Subscription - G&A,10.23,55064743.11
04/13/2023,Expense,Intercom,,Tools & Subscription - G&A,138,55064881.11
04/13/2023,Expense,Lenny Rachitsky,,General business expenses:Memberships & subscriptions,15,55064896.11
04/13/2023,Expense,Lenny Rachitsky,Max Kausman,Credit Card - Ramp,15,55064911.11
04/13/2023,Expense,PocketSmith,,Tools & Subscription - G&A,9.95,55064921.06
04/13/2023,Expense,Lenny Rachitsky,,General business expenses:Memberships & subscriptions,15,55064936.06
04/13/2023,Expense,Vercel,,Tools & Subscription - G&A,260,55065196.06
04/13/2023,Expense,Lenny Rachitsky,Max Kausman,Credit Card - Ramp,15,55065211.06
04/13/2023,Expense,Figma,,Tools & Subscription - G&A,215,55065426.06
04/13/2023,Expense,Uber,,Travelling Expenses,5.02,55065431.08
04/13/2023,Expense,Uber,,Travelling Expenses,8.39,55065439.47
04/13/2023,Expense,Lenny Rachitsky,Max Kausman,Credit Card - Ramp,15,55065454.47
04/13/2023,Expense,Uber,Mike ross,Credit Card - Ramp,5.02,55065459.49
04/13/2023,Expense,Uber,,Travelling Expenses,8.39,55065467.88
04/13/2023,Expense,Uber,,Travelling Expenses,5.02,55065472.9
04/13/2023,Expense,Intercom,,Tools & Subscription - G&A,138,55065610.9
04/13/2023,Expense,Figma,,Tools & Subscription - G&A,215,55065825.9
04/13/2023,Expense,Vercel,,Tools & Subscription - G&A,260,55066085.9
04/13/2023,Expense,PocketSmith,,Tools & Subscription - G&A,9.95,55066095.85
04/13/2023,Expense,Interact32,Harvey Spector,Tools & Subscription - G&A,10.23,55066106.08
04/13/2023,Expense,LottieFiles,,Tools & Subscription - G&A,239.88,55066345.96
04/13/2023,Expense,PocketSmith,,Tools & Subscription - G&A,9.95,55066355.91
04/13/2023,Expense,PocketSmith,Harvey Spector,Credit Card - Ramp,9.95,55066365.86
04/13/2023,Expense,Vercel,Harris Jose,Credit Card - Ramp,260,55066625.86
04/13/2023,Expense,Figma,Mike ross,Credit Card - Ramp,215,55066840.86
04/13/2023,Expense,Interact32,Harvey Spector,Credit Card - Ramp,10.23,55066851.09
04/13/2023,Expense,Figma,,Tools & Subscription - G&A,215,55067066.09
04/13/2023,Expense,LottieFiles,Mike ross,Credit Card - Ramp,239.88,55067305.97
04/13/2023,Expense,LottieFiles,Mike ross,Credit Card - Ramp,239.88,55067545.85
04/13/2023,Expense,PocketSmith,Harvey Spector,Credit Card - Ramp,9.95,55067555.8
04/13/2023,Expense,Uber,Mike ross,Credit Card - Ramp,8.39,55067564.19
04/13/2023,Expense,Uber,Mike ross,Credit Card - Ramp,8.06,55067572.25
04/13/2023,Expense,Uber,,Travelling Expenses,8.06,55067580.31
04/13/2023,Expense,Intercom,,Tools & Subscription - G&A,138,55067718.31
04/13/2023,Expense,Interact32,Harvey Spector,Credit Card - Ramp,10.23,55067728.54
04/13/2023,Expense,Figma,Mike ross,Credit Card - Ramp,215,55067943.54
04/13/2023,Expense,Vercel,Harris Jose,Credit Card - Ramp,260,55068203.54
04/13/2023,Expense,Intercom,Balapavan Tirumani,Credit Card - Ramp,138,55068341.54
04/13/2023,Expense,Uber,Mike ross,Credit Card - Ramp,5.02,55068346.56
04/13/2023,Expense,LottieFiles,,Tools & Subscription - G&A,239.88,55068586.44
04/13/2023,Expense,LottieFiles,,Tools & Subscription - G&A,239.88,55068826.32
04/13/2023,Expense,Lenny Rachitsky,,General business expenses:Memberships & subscriptions,15,55068841.32
04/13/2023,Expense,Vercel,,Tools & Subscription - G&A,260,55069101.32
04/13/2023,Expense,Figma,,Tools & Subscription - G&A,215,55069316.32
04/13/2023,Expense,Uber,,Travelling Expenses,5.02,55069321.34
04/13/2023,Expense,Uber,,Travelling Expenses,8.39,55069329.73
04/13/2023,Expense,Lenny Rachitsky,Max Kausman,Credit Card - Ramp,15,55069344.73
04/13/2023,Expense,Intercom,,Tools & Subscription - G&A,138,55069482.73
04/13/2023,Expense,Interact32,Harvey Spector,Tools & Subscription - G&A,10.23,55069492.96
04/13/2023,Expense,Intercom,Balapavan Tirumani,Credit Card - Ramp,138,55069630.96
04/13/2023,Expense,Uber,,Travelling Expenses,5.02,55069635.98
04/13/2023,Expense,Uber,,Travelling Expenses,8.39,55069644.37
04/13/2023,Expense,Vercel,,Tools & Subscription - G&A,260,55069904.37
04/13/2023,Expense,Lenny Rachitsky,,General business expenses:Memberships & subscriptions,15,55069919.37
04/13/2023,Expense,Uber,Mike ross,Credit Card - Ramp,8.39,55069927.76
04/13/2023,Expense,PocketSmith,,Tools & Subscription - G&A,9.95,55069937.71
04/14/2023,Expense,Intuit,,Tools & Subscription - G&A,55,55069992.71
04/14/2023,Expense,Uber,,Travelling Expenses,7.06,55069999.77
04/14/2023,Expense,Uber,,Travelling Expenses,8.32,55070008.09
04/14/2023,Expense,Uber,,Travelling Expenses,8.32,55070016.41
04/14/2023,Expense,Uber,Mike ross,Credit Card - Ramp,7.06,55070023.47
04/14/2023,Expense,Brewklyn Microbrewery,Mike ross,Meals & Entertainment,18.04,55070041.51
04/14/2023,Expense,OpenAI,,Tools & Subscription - G&A,20,55070061.51
04/14/2023,Expense,Intuit,,Tools & Subscription - G&A,55,55070116.51
04/14/2023,Expense,Uber,,Travelling Expenses,3.87,55070120.38
04/14/2023,Expense,Uber,,Travelling Expenses,3.9,55070124.28
04/14/2023,Expense,Brewklyn Microbrewery,Mike ross,Credit Card - Ramp,18.04,55070142.32
04/14/2023,Expense,OpenAI,,Tools & Subscription - G&A,20,55070162.32
04/14/2023,Expense,Uber,,Travelling Expenses,3.9,55070166.22
04/14/2023,Expense,Uber,,Travelling Expenses,7.06,55070173.28
04/14/2023,Expense,Uber,,Travelling Expenses,3.87,55070177.15
04/14/2023,Expense,Brewklyn Microbrewery,Mike ross,Meals & Entertainment,18.04,55070195.19
04/14/2023,Expense,Uber,,Travelling Expenses,3.9,55070199.09
04/14/2023,Expense,Uber,,Travelling Expenses,7.06,55070206.15
04/14/2023,Expense,Uber,,Travelling Expenses,8.32,55070214.47
04/14/2023,Expense,Uber,,Travelling Expenses,3.87,55070218.34
04/14/2023,Expense,OpenAI,,Tools & Subscription - G&A,20,55070238.34
04/14/2023,Expense,Uber,Mike ross,Credit Card - Ramp,8.32,55070246.66
04/14/2023,Expense,Brewklyn Microbrewery,Mike ross,Meals & Entertainment,18.04,55070264.7
04/14/2023,Expense,Brewklyn Microbrewery,Mike ross,Credit Card - Ramp,18.04,55070282.74
04/14/2023,Expense,Intuit,,Tools & Subscription - G&A,55,55070337.74
04/14/2023,Expense,Uber,Mike ross,Credit Card - Ramp,3.9,55070341.64
04/14/2023,Expense,Uber,Mike ross,Credit Card - Ramp,7.06,55070348.7
04/14/2023,Expense,Brewklyn Microbrewery,Mike ross,Credit Card - Ramp,18.04,55070366.74
04/14/2023,Expense,OpenAI,Balapavan Tirumani,Credit Card - Ramp,20,55070386.74
04/14/2023,Expense,Intuit,Harvey Spector,Credit Card - Ramp,55,55070441.74
04/14/2023,Expense,Uber,Mike ross,Credit Card - Ramp,3.9,55070445.64
04/14/2023,Expense,Intuit,Harvey Spector,Credit Card - Ramp,55,55070500.64
04/14/2023,Expense,Uber,Mike ross,Credit Card - Ramp,3.87,55070504.51
04/14/2023,Expense,Uber,Mike ross,Credit Card - Ramp,8.32,55070512.83
04/14/2023,Expense,OpenAI,Balapavan Tirumani,Credit Card - Ramp,20,55070532.83
04/14/2023,Expense,Uber,,Travelling Expenses,3.87,55070536.7
04/14/2023,Expense,OpenAI,,Tools & Subscription - G&A,20,55070556.7
04/14/2023,Expense,Brewklyn Microbrewery,Mike ross,Credit Card - Ramp,18.04,55070574.74
04/14/2023,Expense,Brewklyn Microbrewery,Mike ross,Meals & Entertainment,18.04,55070592.78
04/14/2023,Expense,Uber,Mike ross,Credit Card - Ramp,3.87,55070596.65
04/14/2023,Expense,Uber,,Travelling Expenses,7.06,55070603.71
04/14/2023,Expense,Uber,Mike ross,Credit Card - Ramp,3.9,55070607.61
04/14/2023,Expense,Uber,Mike ross,Credit Card - Ramp,7.06,55070614.67
04/14/2023,Expense,Uber,Mike ross,Credit Card - Ramp,8.32,55070622.99
04/14/2023,Expense,Uber,Mike ross,Credit Card - Ramp,3.87,55070626.86
04/14/2023,Expense,Intuit,Harvey Spector,Credit Card - Ramp,55,55070681.86
04/14/2023,Expense,Uber,,Travelling Expenses,3.9,55070685.76
04/14/2023,Expense,Uber,,Travelling Expenses,8.32,55070694.08
04/14/2023,Expense,Intuit,,Tools & Subscription - G&A,55,55070749.08
04/14/2023,Expense,OpenAI,Balapavan Tirumani,Credit Card - Ramp,20,55070769.08
04/15/2023,Expense,Uber,,Travelling Expenses,7.87,55070776.95
04/15/2023,Expense,Uber,,Travelling Expenses,49.04,55070825.99
04/15/2023,Expense,Uber,,Travelling Expenses,7.87,55070833.86
04/15/2023,Expense,Uber,Mike ross,Credit Card - Ramp,49.04,55070882.9
04/15/2023,Expense,Uber,,Travelling Expenses,49.04,55070931.94
04/15/2023,Expense,Uber,Mike ross,Credit Card - Ramp,7.87,55070939.81
04/15/2023,Expense,Uber,Mike ross,Credit Card - Ramp,7.87,55070947.68
04/15/2023,Expense,Uber,,Travelling Expenses,49.04,55070996.72
04/15/2023,Expense,Uber,,Travelling Expenses,49.04,55071045.76
04/15/2023,Expense,Uber,Mike ross,Credit Card - Ramp,49.04,55071094.8
04/15/2023,Expense,Uber,Mike ross,Credit Card - Ramp,7.87,55071102.67
04/15/2023,Expense,Uber,,Travelling Expenses,7.87,55071110.54
04/15/2023,Expense,Uber,,Travelling Expenses,7.87,55071118.41
04/15/2023,Expense,Uber,Mike ross,Credit Card - Ramp,49.04,55071167.45
04/16/2023,Expense,The New York Times,,General business expenses:Memberships & subscriptions,8.42,55071175.87
04/16/2023,Expense,Zapier,,Tools & Subscription - G&A,29.99,55071205.86
04/16/2023,Expense,The New York Times,,General business expenses:Memberships & subscriptions,8.42,55071214.28
04/16/2023,Expense,Zapier,Harvey Spector,Credit Card - Ramp,29.99,55071244.27
04/16/2023,Expense,Linear,,Tools & Subscription - G&A,160,55071404.27
04/16/2023,Expense,Zapier,Harvey Spector,Credit Card - Ramp,29.99,55071434.26
04/16/2023,Expense,Zapier,Harvey Spector,Credit Card - Ramp,29.99,55071464.25
04/16/2023,Expense,Linear,,Tools & Subscription - G&A,160,55071624.25
04/16/2023,Expense,Zapier,,Tools & Subscription - G&A,29.99,55071654.24
04/16/2023,Expense,The New York Times,Mike ross,Credit Card - Ramp,8.42,55071662.66
04/16/2023,Expense,Linear,,Tools & Subscription - G&A,160,55071822.66
04/16/2023,Expense,The New York Times,Mike ross,Credit Card - Ramp,8.42,55071831.08
04/16/2023,Expense,Zapier,,Tools & Subscription - G&A,29.99,55071861.07
04/16/2023,Expense,Linear,Chad Blumenthal,Credit Card - Ramp,160,55072021.07
04/16/2023,Expense,The New York Times,,General business expenses:Memberships & subscriptions,8.42,55072029.49
04/16/2023,Expense,The New York Times,Mike ross,Credit Card - Ramp,8.42,55072037.91
04/16/2023,Expense,Linear,Chad Blumenthal,Credit Card - Ramp,160,55072197.91
04/16/2023,Expense,Linear,Chad Blumenthal,Credit Card - Ramp,160,55072357.91
04/16/2023,Expense,Linear,,Tools & Subscription - G&A,160,55072517.91
04/16/2023,Expense,Zapier,,Tools & Subscription - G&A,29.99,55072547.9
04/16/2023,Expense,The New York Times,,General business expenses:Memberships & subscriptions,8.42,55072556.32
04/16/2023,Expense,The New York Times,Mike ross,Credit Card - Ramp,8.42,55072564.74
04/18/2023,Expense,LinkedIn,,Tools & Subscription - G&A,155.78,55072720.52
04/18/2023,Expense,RECLAIM,,Tools & Subscription - G&A,8,55072728.52
04/18/2023,Expense,OpenAI,,Tools & Subscription - G&A,20,55072748.52
04/18/2023,Expense,JB Hi-Fi,Max Kausman,Credit Card - Ramp,62.41,55072810.93
04/18/2023,Expense,RECLAIM,Max Kausman,Credit Card - Ramp,8,55072818.93
04/18/2023,Expense,OpenAI,Anik Das,Credit Card - Ramp,20,55072838.93
04/18/2023,Expense,Segment,Balapavan Tirumani,Credit Card - Ramp,120,55072958.93
04/18/2023,Expense,LinkedIn,,Tools & Subscription - G&A,155.78,55073114.71
04/18/2023,Expense,RECLAIM,Max Kausman,Credit Card - Ramp,8,55073122.71
04/18/2023,Expense,Segment,Balapavan Tirumani,Credit Card - Ramp,120,55073242.71
04/18/2023,Expense,JB Hi-Fi,Max Kausman,Credit Card - Ramp,62.41,55073305.12
04/18/2023,Expense,JB Hi-Fi,Max Kausman,Office expenses:Office supplies,62.41,55073367.53
04/18/2023,Expense,LinkedIn,Mike ross,Credit Card - Ramp,155.78,55073523.31
04/18/2023,Expense,Segment,Balapavan Tirumani,Credit Card - Ramp,120,55073643.31
04/18/2023,Expense,LinkedIn,Mike ross,Credit Card - Ramp,155.78,55073799.09
04/18/2023,Expense,OpenAI,Anik Das,Credit Card - Ramp,20,55073819.09
04/18/2023,Expense,Segment,,Tools & Subscription - G&A,120,55073939.09
04/18/2023,Expense,JB Hi-Fi,Max Kausman,Office expenses:Office supplies,62.41,55074001.5
04/18/2023,Expense,JB Hi-Fi,Max Kausman,Office expenses:Office supplies,62.41,55074063.91
04/18/2023,Expense,OpenAI,Anik Das,Credit Card - Ramp,20,55074083.91
04/18/2023,Expense,JB Hi-Fi,Max Kausman,Credit Card - Ramp,62.41,55074146.32
04/18/2023,Expense,JB Hi-Fi,Max Kausman,Credit Card - Ramp,62.41,55074208.73
04/18/2023,Expense,RECLAIM,Max Kausman,Credit Card - Ramp,8,55074216.73
04/18/2023,Expense,RECLAIM,,Tools & Subscription - G&A,8,55074224.73
04/18/2023,Expense,OpenAI,,Tools & Subscription - G&A,20,55074244.73
04/18/2023,Expense,RECLAIM,,Tools & Subscription - G&A,8,55074252.73
04/18/2023,Expense,LinkedIn,,Tools & Subscription - G&A,155.78,55074408.51
04/18/2023,Expense,OpenAI,,Tools & Subscription - G&A,20,55074428.51
04/18/2023,Expense,RECLAIM,,Tools & Subscription - G&A,8,55074436.51
04/18/2023,Expense,JB Hi-Fi,Max Kausman,Office expenses:Office supplies,62.41,55074498.92
04/18/2023,Expense,Segment,,Tools & Subscription - G&A,120,55074618.92
04/18/2023,Expense,Segment,,Tools & Subscription - G&A,120,55074738.92
04/18/2023,Expense,LinkedIn,Mike ross,Credit Card - Ramp,155.78,55074894.7
04/18/2023,Expense,OpenAI,,Tools & Subscription - G&A,20,55074914.7
04/18/2023,Expense,LinkedIn,,Tools & Subscription - G&A,155.78,55075070.48
04/18/2023,Expense,Segment,,Tools & Subscription - G&A,120,55075190.48
04/19/2023,Expense,RAMP BUSINESS CO,RAMP STATEMENT,Credit Card - Ramp,-8958.71,55066231.77
04/19/2023,Expense,RAMP BUSINESS CO,RAMP STATEMENT,Credit Card - Ramp,-8958.71,55057273.06
04/19/2023,Expense,Olvy,,Tools & Subscription - G&A,60,55057333.06
04/19/2023,Expense,Twitter,,Tools & Subscription - G&A,8.16,55057341.22
04/19/2023,Expense,RAMP BUSINESS CO,RAMP STATEMENT,Account1,-8958.71,55048382.51
04/19/2023,Expense,Olvy,,Tools & Subscription - G&A,60,55048442.51
04/19/2023,Expense,Twitter,,Tools & Subscription - G&A,8.16,55048450.67
04/19/2023,Expense,RAMP BUSINESS CO,RAMP STATEMENT,Credit Card - Ramp,-8958.71,55039491.96
04/19/2023,Expense,RAMP BUSINESS CO,RAMP STATEMENT,Account1,-8958.71,55030533.25
04/19/2023,Expense,Olvy,Chad Blumenthal,Credit Card - Ramp,60,55030593.25
04/19/2023,Expense,Twitter,Harvey Spector,Credit Card - Ramp,8.16,55030601.41
04/19/2023,Expense,Olvy,,Tools & Subscription - G&A,60,55030661.41
04/19/2023,Expense,Olvy,,Tools & Subscription - G&A,60,55030721.41
04/19/2023,Expense,RAMP BUSINESS CO,RAMP STATEMENT,Account1,-8958.71,55021762.7
04/19/2023,Expense,Twitter,,Tools & Subscription - G&A,8.16,55021770.86
04/19/2023,Expense,RAMP BUSINESS CO,RAMP STATEMENT,Account1,-8958.71,55012812.15
04/19/2023,Expense,Olvy,Chad Blumenthal,Credit Card - Ramp,60,55012872.15
04/19/2023,Expense,Twitter,Harvey Spector,Credit Card - Ramp,8.16,55012880.31
04/19/2023,Expense,RAMP BUSINESS CO,RAMP STATEMENT,Credit Card - Ramp,-8958.71,55003921.6
04/19/2023,Expense,Olvy,Chad Blumenthal,Credit Card - Ramp,60,55003981.6
04/19/2023,Expense,Twitter,,Tools & Subscription - G&A,8.16,55003989.76
04/19/2023,Expense,Twitter,Harvey Spector,Credit Card - Ramp,8.16,55003997.92
04/20/2023,Expense,Olvy,Chad Blumenthal,Credit Card - Ramp,32.01,55004029.93
04/20/2023,Expense,LinkedIn,,Tools & Subscription - G&A,124.44,55004154.37
04/20/2023,Expense,Olvy,Chad Blumenthal,Credit Card - Ramp,32.01,55004186.38
04/20/2023,Expense,Olvy,Chad Blumenthal,Credit Card - Ramp,32.01,55004218.39
04/20/2023,Expense,LinkedIn,Niteesha Ravela,Credit Card - Ramp,124.44,55004342.83
04/20/2023,Expense,LinkedIn,Niteesha Ravela,Credit Card - Ramp,124.44,55004467.27
04/20/2023,Expense,LinkedIn,,Tools & Subscription - G&A,124.44,55004591.71
04/20/2023,Expense,LinkedIn,Niteesha Ravela,Credit Card - Ramp,124.44,55004716.15
04/20/2023,Expense,LinkedIn,,Tools & Subscription - G&A,124.44,55004840.59
04/20/2023,Expense,Olvy,,Tools & Subscription - G&A,32.01,55004872.6
04/20/2023,Expense,LinkedIn,,Tools & Subscription - G&A,124.44,55004997.04
04/20/2023,Expense,Olvy,,Tools & Subscription - G&A,32.01,55005029.05
04/20/2023,Expense,Olvy,,Tools & Subscription - G&A,32.01,55005061.06
04/20/2023,Expense,Olvy,,Tools & Subscription - G&A,32.01,55005093.07
04/21/2023,Deposit,,PaymentServiceB Savings **6977,Savings (6977),50000,55055093.07
04/21/2023,Expense,Income Capitals ,Income Capitals ,Account1,9554,55064647.07
04/21/2023,Deposit,,PaymentServiceB Savings **6977,Account1,-50000,55014647.07
04/21/2023,Expense,Income Capitals ,Income Capitals ,Contract labor,-9554,55005093.07
04/21/2023,Deposit,,PaymentServiceB Savings **6977,Account1,-50000,54955093.07
04/21/2023,Deposit,,PaymentServiceB Savings **6977,Account1,-50000,54905093.07
04/21/2023,Expense,Income Capitals ,Income Capitals ,Contract labor,-9554,54895539.07
04/21/2023,Deposit,,PaymentServiceB Savings **6977,Savings (6977),50000,54945539.07
04/21/2023,Expense,Income Capitals ,Income Capitals ,Account1,9554,54955093.07
04/21/2023,Deposit,,PaymentServiceB Savings **6977,Savings (6977),50000,55005093.07
04/21/2023,Expense,Income Capitals ,Income Capitals ,Account1,9554,55014647.07
04/21/2023,Expense,Income Capitals ,Income Capitals ,Contract labor,-9554,55005093.07
04/21/2023,Deposit,,PaymentServiceB Savings **6977,Account1,-50000,54955093.07
04/21/2023,Expense,Income Capitals ,Income Capitals ,Contract labor,-9554,54945539.07
04/21/2023,Deposit,,PaymentServiceB Savings **6977,Savings (6977),50000,54995539.07
04/21/2023,Expense,Income Capitals ,Income Capitals ,Account1,9554,55005093.07
04/22/2023,Expense,Notion Labs,,Tools & Subscription - G&A,95.47,55005188.54
04/22/2023,Expense,Notion Labs,Mike ross,Credit Card - Ramp,95.47,55005284.01
04/22/2023,Expense,Vimcal,Harvey Spector,Credit Card - Ramp,15,55005299.01
04/22/2023,Expense,Dovetail,Harvey Spector,Credit Card - Ramp,70,55005369.01
04/22/2023,Expense,Vimcal,Harvey Spector,Credit Card - Ramp,15,55005384.01
04/22/2023,Expense,Vimcal,,Tools & Subscription - G&A,15,55005399.01
04/22/2023,Expense,Dovetail,Harvey Spector,Credit Card - Ramp,70,55005469.01
04/22/2023,Expense,Dovetail,,Tools & Subscription - G&A,70,55005539.01
04/22/2023,Expense,Notion Labs,,Tools & Subscription - G&A,95.47,55005634.48
04/22/2023,Expense,Dovetail,,Tools & Subscription - G&A,70,55005704.48
04/22/2023,Expense,Notion Labs,Mike ross,Credit Card - Ramp,95.47,55005799.95
04/22/2023,Expense,Notion Labs,Mike ross,Credit Card - Ramp,95.47,55005895.42
04/22/2023,Expense,Dovetail,Harvey Spector,Credit Card - Ramp,70,55005965.42
04/22/2023,Expense,Dovetail,,Tools & Subscription - G&A,70,55006035.42
04/22/2023,Expense,Vimcal,,Tools & Subscription - G&A,15,55006050.42
04/22/2023,Expense,Notion Labs,,Tools & Subscription - G&A,95.47,55006145.89
04/22/2023,Expense,Vimcal,Harvey Spector,Credit Card - Ramp,15,55006160.89
04/22/2023,Expense,Dovetail,,Tools & Subscription - G&A,70,55006230.89
04/22/2023,Expense,Vimcal,,Tools & Subscription - G&A,15,55006245.89
04/22/2023,Expense,Notion Labs,,Tools & Subscription - G&A,95.47,55006341.36
04/22/2023,Expense,Vimcal,,Tools & Subscription - G&A,15,55006356.36
04/23/2023,Expense,Superhuman,Mike ross,Credit Card - Ramp,60,55006416.36
04/23/2023,Expense,Midjourney,,Tools & Subscription - G&A,10,55006426.36
04/23/2023,Expense,Midjourney,Harvey Spector,Credit Card - Ramp,10,55006436.36
04/23/2023,Expense,Super,Harvey Spector,Credit Card - Ramp,12,55006448.36
04/23/2023,Expense,Github,,Tools & Subscription - G&A,0.78,55006449.14
04/23/2023,Expense,Superhuman,,Professional Service Charges,60,55006509.14
04/23/2023,Expense,Superhuman,,Professional Service Charges,60,55006569.14
04/23/2023,Expense,Midjourney,,Tools & Subscription - G&A,10,55006579.14
04/23/2023,Expense,Super,,Tools & Subscription - G&A,12,55006591.14
04/23/2023,Expense,Super,,Tools & Subscription - G&A,12,55006603.14
04/23/2023,Expense,Superhuman,Mike ross,Credit Card - Ramp,60,55006663.14
04/23/2023,Expense,Github,Balapavan Tirumani,Credit Card - Ramp,0.78,55006663.92
04/23/2023,Expense,Super,,Tools & Subscription - G&A,12,55006675.92
04/23/2023,Expense,Github,,Tools & Subscription - G&A,0.78,55006676.7
04/23/2023,Expense,Midjourney,,Tools & Subscription - G&A,10,55006686.7
04/23/2023,Expense,Github,,Tools & Subscription - G&A,0.78,55006687.48
04/23/2023,Expense,Github,,Tools & Subscription - G&A,0.78,55006688.26
04/23/2023,Expense,Superhuman,,Professional Service Charges,60,55006748.26
04/23/2023,Expense,Midjourney,Harvey Spector,Credit Card - Ramp,10,55006758.26
04/23/2023,Expense,Midjourney,,Tools & Subscription - G&A,10,55006768.26
04/23/2023,Expense,Super,Harvey Spector,Credit Card - Ramp,12,55006780.26
04/23/2023,Expense,Midjourney,Harvey Spector,Credit Card - Ramp,10,55006790.26
04/23/2023,Expense,Superhuman,,Professional Service Charges,60,55006850.26
04/23/2023,Expense,Super,Harvey Spector,Credit Card - Ramp,12,55006862.26
04/23/2023,Expense,Github,Balapavan Tirumani,Credit Card - Ramp,0.78,55006863.04
04/23/2023,Expense,Superhuman,Mike ross,Credit Card - Ramp,60,55006923.04
04/23/2023,Expense,Superhuman,Mike ross,Credit Card - Ramp,60,55006983.04
04/23/2023,Expense,Super,,Tools & Subscription - G&A,12,55006995.04
04/23/2023,Expense,Github,Balapavan Tirumani,Credit Card - Ramp,0.78,55006995.82
04/24/2023,Expense,Benedict Evans,Harvey Spector,Credit Card - Ramp,10,55007005.82
04/24/2023,Expense,Page Flows,Max Kausman,Credit Card - Ramp,39,55007044.82
04/24/2023,Expense,Page Flows,Max Kausman,Credit Card - Ramp,39,55007083.82
04/24/2023,Expense,Page Flows,,Tools & Subscription - G&A,39,55007122.82
04/24/2023,Expense,Benedict Evans,Harvey Spector,Credit Card - Ramp,10,55007132.82
04/24/2023,Expense,Benedict Evans,Harvey Spector,Professional Service Charges,10,55007142.82
04/24/2023,Expense,Benedict Evans,Harvey Spector,Professional Service Charges,10,55007152.82
04/24/2023,Expense,Page Flows,,Tools & Subscription - G&A,39,55007191.82
04/24/2023,Expense,Page Flows,,Tools & Subscription - G&A,39,55007230.82
04/24/2023,Expense,Benedict Evans,Harvey Spector,Credit Card - Ramp,10,55007240.82
04/24/2023,Expense,Benedict Evans,Harvey Spector,Credit Card - Ramp,10,55007250.82
04/24/2023,Expense,Benedict Evans,Harvey Spector,Professional Service Charges,10,55007260.82
04/24/2023,Expense,Page Flows,Max Kausman,Credit Card - Ramp,39,55007299.82
04/24/2023,Expense,Benedict Evans,Harvey Spector,Professional Service Charges,10,55007309.82
04/24/2023,Expense,Page Flows,,Tools & Subscription - G&A,39,55007348.82
04/25/2023,Expense,Miro,,Tools & Subscription - G&A,90,55007438.82
04/25/2023,Expense,Miro,,Tools & Subscription - G&A,90,55007528.82
04/25/2023,Expense,Zoom,,Tools & Subscription - G&A,15.99,55007544.81
04/25/2023,Expense,Miro,,Tools & Subscription - G&A,90,55007634.81
04/25/2023,Expense,Zoom,Chad Blumenthal,Credit Card - Ramp,15.99,55007650.8
04/25/2023,Expense,Zoom,,Tools & Subscription - G&A,15.99,55007666.79
04/25/2023,Expense,Miro,Mike ross,Credit Card - Ramp,90,55007756.79
04/25/2023,Expense,Zoom,,Tools & Subscription - G&A,15.99,55007772.78
04/25/2023,Expense,Miro,,Tools & Subscription - G&A,90,55007862.78
04/25/2023,Expense,Zoom,Chad Blumenthal,Credit Card - Ramp,15.99,55007878.77
04/25/2023,Expense,Zoom,Chad Blumenthal,Credit Card - Ramp,15.99,55007894.76
04/25/2023,Expense,Miro,Mike ross,Credit Card - Ramp,90,55007984.76
04/25/2023,Expense,Zoom,,Tools & Subscription - G&A,15.99,55008000.75
04/25/2023,Expense,Miro,Mike ross,Credit Card - Ramp,90,55008090.75
04/26/2023,Expense,Man-made,Harvey Spector,Professional Service Charges,19,55008109.75
04/26/2023,Expense,Man-made,Harvey Spector,Credit Card - Ramp,19,55008128.75
04/26/2023,Expense,Man-made,Harvey Spector,Professional Service Charges,19,55008147.75
04/26/2023,Expense,Man-made,Harvey Spector,Professional Service Charges,19,55008166.75
04/26/2023,Expense,Man-made,Harvey Spector,Credit Card - Ramp,19,55008185.75
04/26/2023,Expense,Man-made,Harvey Spector,Professional Service Charges,19,55008204.75
04/26/2023,Expense,Man-made,Harvey Spector,Credit Card - Ramp,19,55008223.75
04/26/2023,Expense,Man-made,Harvey Spector,Credit Card - Ramp,19,55008242.75
04/27/2023,Expense,Uber,,Travelling Expenses,2.8,55008245.55
04/27/2023,Expense,Sentry,,Tools & Subscription - G&A,29,55008274.55
04/27/2023,Expense,Sentry,,Tools & Subscription - G&A,29,55008303.55
04/27/2023,Expense,Olvy,,Tools & Subscription - G&A,20.79,55008324.34
04/27/2023,Expense,Uber,,Travelling Expenses,4.42,55008328.76
04/27/2023,Expense,Uber,,Travelling Expenses,2.8,55008331.56
04/27/2023,Expense,Sendinblue,,Tools & Subscription - G&A,67.17,55008398.73
04/27/2023,Expense,Uber,,Travelling Expenses,4.42,55008403.15
04/27/2023,Expense,Sendinblue,Balapavan Tirumani,Credit Card - Ramp,67.17,55008470.32
04/27/2023,Expense,Sentry,Balapavan Tirumani,Credit Card - Ramp,29,55008499.32
04/27/2023,Expense,Uber,Mike ross,Credit Card - Ramp,2.8,55008502.12
04/27/2023,Expense,Uber,,Travelling Expenses,2.8,55008504.92
04/27/2023,Expense,Olvy,Chad Blumenthal,Credit Card - Ramp,20.79,55008525.71
04/27/2023,Expense,Sendinblue,Balapavan Tirumani,Credit Card - Ramp,67.17,55008592.88
04/27/2023,Expense,Splitbee,Harris Jose,Credit Card - Ramp,16.52,55008609.4
04/27/2023,Expense,Uber,Mike ross,Credit Card - Ramp,4.42,55008613.82
04/27/2023,Expense,Sentry,Balapavan Tirumani,Credit Card - Ramp,29,55008642.82
04/27/2023,Expense,Splitbee,,Tools & Subscription - G&A,16.52,55008659.34
04/27/2023,Expense,Splitbee,Harris Jose,Credit Card - Ramp,16.52,55008675.86
04/27/2023,Expense,Sendinblue,,Tools & Subscription - G&A,67.17,55008743.03
04/27/2023,Expense,Uber,,Travelling Expenses,4.42,55008747.45
04/27/2023,Expense,Splitbee,,Tools & Subscription - G&A,16.52,55008763.97
04/27/2023,Expense,Olvy,,Tools & Subscription - G&A,20.79,55008784.76
04/27/2023,Expense,Splitbee,,Tools & Subscription - G&A,16.52,55008801.28
04/27/2023,Expense,Uber,Mike ross,Credit Card - Ramp,4.42,55008805.7
04/27/2023,Expense,Uber,Mike ross,Credit Card - Ramp,2.8,55008808.5
04/27/2023,Expense,Sentry,Balapavan Tirumani,Credit Card - Ramp,29,55008837.5
04/27/2023,Expense,Sentry,,Tools & Subscription - G&A,29,55008866.5
04/27/2023,Expense,Uber,Mike ross,Credit Card - Ramp,2.8,55008869.3
04/27/2023,Expense,Olvy,Chad Blumenthal,Credit Card - Ramp,20.79,55008890.09
04/27/2023,Expense,Splitbee,Harris Jose,Credit Card - Ramp,16.52,55008906.61
04/27/2023,Expense,Olvy,,Tools & Subscription - G&A,20.79,55008927.4
04/27/2023,Expense,Sendinblue,,Tools & Subscription - G&A,67.17,55008994.57
04/27/2023,Expense,Sendinblue,Balapavan Tirumani,Credit Card - Ramp,67.17,55009061.74
04/27/2023,Expense,Olvy,Chad Blumenthal,Credit Card - Ramp,20.79,55009082.53
04/27/2023,Expense,Sentry,,Tools & Subscription - G&A,29,55009111.53
04/27/2023,Expense,Olvy,,Tools & Subscription - G&A,20.79,55009132.32
04/27/2023,Expense,Uber,Mike ross,Credit Card - Ramp,4.42,55009136.74
04/27/2023,Expense,Sendinblue,,Tools & Subscription - G&A,67.17,55009203.91
04/27/2023,Expense,Uber,,Travelling Expenses,4.42,55009208.33
04/27/2023,Expense,Uber,,Travelling Expenses,2.8,55009211.13
04/27/2023,Expense,Splitbee,,Tools & Subscription - G&A,16.52,55009227.65
04/28/2023,Expense,Uber,Mike ross,Credit Card - Ramp,0.33,55009227.98
04/28/2023,Expense,Uber,,Travelling Expenses,2.42,55009230.4
04/28/2023,Expense,Uber,Mike ross,Credit Card - Ramp,0.33,55009230.73
04/28/2023,Expense,Github,,Tools & Subscription - G&A,44,55009274.73
04/28/2023,Expense,Uber,,Travelling Expenses,15.11,55009289.84
04/28/2023,Expense,Uber,,Travelling Expenses,2.42,55009292.26
04/28/2023,Expense,Uber,,Travelling Expenses,15.11,55009307.37
04/28/2023,Expense,Uber,Mike ross,Credit Card - Ramp,0.33,55009307.7
04/28/2023,Expense,Uber,,Travelling Expenses,2.98,55009310.68
04/28/2023,Expense,Github,Balapavan Tirumani,Credit Card - Ramp,44,55009354.68
04/28/2023,Expense,Github,,Tools & Subscription - G&A,44,55009398.68
04/28/2023,Expense,Uber,Mike ross,Credit Card - Ramp,15.11,55009413.79
04/28/2023,Expense,Uber,Mike ross,Credit Card - Ramp,2.42,55009416.21
04/28/2023,Expense,Uber,,Travelling Expenses,2.42,55009418.63
04/28/2023,Expense,Uber,,Travelling Expenses,0.33,55009418.96
04/28/2023,Expense,Uber,,Travelling Expenses,0.33,55009419.29
04/28/2023,Expense,Uber,,Travelling Expenses,2.98,55009422.27
04/28/2023,Expense,Uber,Mike ross,Credit Card - Ramp,15.11,55009437.38
04/28/2023,Expense,Uber,,Travelling Expenses,0.33,55009437.71
04/28/2023,Expense,Uber,,Travelling Expenses,15.11,55009452.82
04/28/2023,Expense,Github,,Tools & Subscription - G&A,44,55009496.82
04/28/2023,Expense,Uber,,Travelling Expenses,2.42,55009499.24
04/28/2023,Expense,Github,Balapavan Tirumani,Credit Card - Ramp,44,55009543.24
04/28/2023,Expense,Uber,,Travelling Expenses,2.98,55009546.22
04/28/2023,Expense,Uber,,Travelling Expenses,15.11,55009561.33
04/28/2023,Expense,Github,,Tools & Subscription - G&A,44,55009605.33
04/28/2023,Expense,Uber,Mike ross,Credit Card - Ramp,2.98,55009608.31
04/28/2023,Expense,Uber,,Travelling Expenses,0.33,55009608.64
04/28/2023,Expense,Uber,Mike ross,Credit Card - Ramp,2.98,55009611.62
04/28/2023,Expense,Uber,Mike ross,Credit Card - Ramp,2.42,55009614.04
04/28/2023,Expense,Uber,Mike ross,Credit Card - Ramp,15.11,55009629.15
04/28/2023,Expense,Github,Balapavan Tirumani,Credit Card - Ramp,44,55009673.15
04/28/2023,Expense,Uber,,Travelling Expenses,2.98,55009676.13
04/28/2023,Expense,Uber,Mike ross,Credit Card - Ramp,2.98,55009679.11
04/28/2023,Expense,Uber,Mike ross,Credit Card - Ramp,2.42,55009681.53
04/29/2023,Expense,Uber,,Travelling Expenses,13.86,55009695.39
04/29/2023,Expense,Netlify,Balapavan Tirumani,Credit Card - Ramp,19,55009714.39
04/29/2023,Expense,Uber,,Travelling Expenses,13.86,55009728.25
04/29/2023,Expense,Uber,,Travelling Expenses,13.86,55009742.11
04/29/2023,Expense,Netlify,,Tools & Subscription - G&A,19,55009761.11
04/29/2023,Expense,Netlify,,Tools & Subscription - G&A,19,55009780.11
04/29/2023,Expense,Netlify,,Tools & Subscription - G&A,19,55009799.11
04/29/2023,Expense,Netlify,Balapavan Tirumani,Credit Card - Ramp,19,55009818.11
04/29/2023,Expense,Uber,Mike ross,Credit Card - Ramp,13.86,55009831.97
04/29/2023,Expense,Netlify,,Tools & Subscription - G&A,19,55009850.97
04/29/2023,Expense,Uber,Mike ross,Credit Card - Ramp,13.86,55009864.83
04/29/2023,Expense,Uber,Mike ross,Credit Card - Ramp,13.86,55009878.69
04/29/2023,Expense,Netlify,Balapavan Tirumani,Credit Card - Ramp,19,55009897.69
04/29/2023,Expense,Uber,,Travelling Expenses,13.86,55009911.55
04/30/2023,Expense,Adobe,Mike ross,Credit Card - Ramp,15.05,55009926.6
04/30/2023,Expense,Github,,Tools & Subscription - G&A,9.33,55009935.93
04/30/2023,Expense,Adobe,,Tools & Subscription - S&M,15.05,55009950.98
04/30/2023,Bill,Big Company ,"Service Expenses for the month of April 2023 
INR    29,73,511     @ 81.7186",Accounts Payable (A/P),36387.2,55046338.18
04/30/2023,Bill,Big Company ,,Outsources Services - India,36387.2,55082725.38
04/30/2023,Expense,Github,,Tools & Subscription - G&A,9.33,55082734.71
04/30/2023,Expense,Github,Balapavan Tirumani,Credit Card - Ramp,9.33,55082744.04
04/30/2023,Expense,Adobe,Mike ross,Credit Card - Ramp,15.05,55082759.09
04/30/2023,Expense,Zapier,Chad Blumenthal,Credit Card - Ramp,29.99,55082789.08
04/30/2023,Expense,Zapier,,Tools & Subscription - G&A,29.99,55082819.07
04/30/2023,Bill,Big Company ,,Outsources Services - India,36387.2,55119206.27
04/30/2023,Expense,Adobe,Mike ross,Credit Card - Ramp,15.05,55119221.32
04/30/2023,Expense,Adobe,,Tools & Subscription - S&M,15.05,55119236.37
04/30/2023,Expense,Zapier,,Tools & Subscription - G&A,29.99,55119266.36
04/30/2023,Expense,Zapier,,Tools & Subscription - G&A,29.99,55119296.35
04/30/2023,Expense,Adobe,,Tools & Subscription - S&M,15.05,55119311.4
04/30/2023,Expense,Github,,Tools & Subscription - G&A,9.33,55119320.73
04/30/2023,Bill,Big Company ,,Outsources Services - India,36387.2,55155707.93
04/30/2023,Expense,Adobe,,Tools & Subscription - S&M,15.05,55155722.98
04/30/2023,Bill,Big Company ,"Service Expenses for the month of April 2023 
INR    29,73,511     @ 81.7186",Accounts Payable (A/P),36387.2,55192110.18
04/30/2023,Expense,Github,Balapavan Tirumani,Credit Card - Ramp,9.33,55192119.51
04/30/2023,Expense,Zapier,Chad Blumenthal,Credit Card - Ramp,29.99,55192149.5
04/30/2023,Bill,Big Company ,,Outsources Services - India,36387.2,55228536.7
04/30/2023,Bill,Big Company ,"Service Expenses for the month of April 2023 
INR    29,73,511     @ 81.7186",Accounts Payable (A/P),36387.2,55264923.9
04/30/2023,Expense,Zapier,Chad Blumenthal,Credit Card - Ramp,29.99,55264953.89
04/30/2023,Expense,Github,Balapavan Tirumani,Credit Card - Ramp,9.33,55264963.22
04/30/2023,Expense,Github,,Tools & Subscription - G&A,9.33,55264972.55
04/30/2023,Bill,Big Company ,"Service Expenses for the month of April 2023 
INR    29,73,511     @ 81.7186",Accounts Payable (A/P),36387.2,55301359.75
04/30/2023,Expense,Zapier,,Tools & Subscription - G&A,29.99,55301389.74
05/01/2023,Expense,Clay Labs Inc,,Tools & Subscription - G&A,79,55301468.74
05/01/2023,Expense,Google G Suite,,Tools & Subscription - G&A,116.37,55301585.11
05/01/2023,Expense,Clay Labs Inc,,Tools & Subscription - G&A,79,55301664.11
05/01/2023,Expense,Replay Software,,Tools & Subscription - G&A,5.99,55301670.1
05/01/2023,Expense,Inventus Law,"INVENTUS LAW, PC",Account1,125,55301795.1
05/01/2023,Expense,Replay Software,,Tools & Subscription - G&A,5.99,55301801.09
05/01/2023,Expense,Google G Suite,,Tools & Subscription - G&A,116.37,55301917.46
05/01/2023,Expense,Clay Labs Inc,Harvey Spector,Credit Card - Ramp,79,55301996.46
05/01/2023,Expense,Inventus Law,"INVENTUS LAW, PC",Account1,125,55302121.46
05/01/2023,Expense,Inventus Law,"INVENTUS LAW, PC",Legal & accounting services:Legal Fees,-125,55301996.46
05/01/2023,Expense,Clay Labs Inc,,Tools & Subscription - G&A,79,55302075.46
05/01/2023,Expense,Clay Labs Inc,Harvey Spector,Credit Card - Ramp,79,55302154.46
05/01/2023,Expense,Inventus Law,"INVENTUS LAW, PC",Account1,125,55302279.46
05/01/2023,Expense,Replay Software,Harvey Spector,Credit Card - Ramp,5.99,55302285.45
05/01/2023,Expense,Google G Suite,Mike ross,Credit Card - Ramp,116.37,55302401.82
05/01/2023,Expense,Clay Labs Inc,Harvey Spector,Credit Card - Ramp,79,55302480.82
05/01/2023,Expense,Google G Suite,Mike ross,Credit Card - Ramp,116.37,55302597.19
05/01/2023,Expense,Inventus Law,"INVENTUS LAW, PC",Account1,125,55302722.19
05/01/2023,Expense,Google G Suite,,Tools & Subscription - G&A,116.37,55302838.56
05/01/2023,Expense,Clay Labs Inc,,Tools & Subscription - G&A,79,55302917.56
05/01/2023,Expense,Inventus Law,"INVENTUS LAW, PC",Legal & accounting services:Legal Fees,-125,55302792.56
05/01/2023,Expense,Google G Suite,Mike ross,Credit Card - Ramp,116.37,55302908.93
05/01/2023,Expense,Replay Software,,Tools & Subscription - G&A,5.99,55302914.92
05/01/2023,Expense,Inventus Law,"INVENTUS LAW, PC",Legal & accounting services:Legal Fees,-125,55302789.92
05/01/2023,Expense,Inventus Law,"INVENTUS LAW, PC",Legal & accounting services:Legal Fees,-125,55302664.92
05/01/2023,Expense,Replay Software,,Tools & Subscription - G&A,5.99,55302670.91
05/01/2023,Expense,Google G Suite,,Tools & Subscription - G&A,116.37,55302787.28
05/01/2023,Expense,Replay Software,Harvey Spector,Credit Card - Ramp,5.99,55302793.27
05/01/2023,Expense,Replay Software,Harvey Spector,Credit Card - Ramp,5.99,55302799.26
05/02/2023,Expense,Cuckoo Callay,Mike ross,Credit Card - Ramp,77.77,55302877.03
05/02/2023,Expense,Cuckoo Callay,Mike ross,Meals & Entertainment,77.77,55302954.8
05/02/2023,Expense,Olvy,,Tools & Subscription - G&A,15.89,55302970.69
05/02/2023,Expense,Olvy,,Tools & Subscription - G&A,15.89,55302986.58
05/02/2023,Expense,June,,Tools & Subscription - G&A,314,55303300.58
05/02/2023,Expense,June,,Tools & Subscription - G&A,314,55303614.58
05/02/2023,Expense,Cuckoo Callay,Mike ross,Meals & Entertainment,77.77,55303692.35
05/02/2023,Expense,Render,,Tools & Subscription - G&A,220,55303912.35
05/02/2023,Deposit,,Interest Accrual INTEREST,Savings (6977),4.04,55303916.39
05/02/2023,Expense,June,Balapavan Tirumani,Credit Card - Ramp,314,55304230.39
05/02/2023,Expense,Olvy,,Tools & Subscription - G&A,15.89,55304246.28
05/02/2023,Deposit,,Interest Accrual INTEREST,Interest Received,4.04,55304250.32
05/02/2023,Expense,Cuckoo Callay,Mike ross,Meals & Entertainment,77.77,55304328.09
05/02/2023,Deposit,,Interest Accrual INTEREST,Interest Received,4.04,55304332.13
05/02/2023,Expense,Olvy,Chad Blumenthal,Credit Card - Ramp,15.89,55304348.02
05/02/2023,Deposit,,Interest Accrual INTEREST,Interest Received,4.04,55304352.06
05/02/2023,Expense,Render,Balapavan Tirumani,Credit Card - Ramp,220,55304572.06
05/02/2023,Expense,June,,Tools & Subscription - G&A,314,55304886.06
05/02/2023,Expense,Olvy,Chad Blumenthal,Credit Card - Ramp,15.89,55304901.95
05/02/2023,Deposit,,Interest Accrual INTEREST,Savings (6977),4.04,55304905.99
05/02/2023,Expense,Render,Balapavan Tirumani,Credit Card - Ramp,220,55305125.99
05/02/2023,Deposit,,Interest Accrual INTEREST,Interest Received,4.04,55305130.03
05/02/2023,Expense,Olvy,Chad Blumenthal,Credit Card - Ramp,15.89,55305145.92
05/02/2023,Deposit,,Interest Accrual INTEREST,Savings (6977),4.04,55305149.96
05/02/2023,Expense,June,Balapavan Tirumani,Credit Card - Ramp,314,55305463.96
05/02/2023,Expense,Render,Balapavan Tirumani,Credit Card - Ramp,220,55305683.96
05/02/2023,Expense,June,,Tools & Subscription - G&A,314,55305997.96
05/02/2023,Expense,June,Balapavan Tirumani,Credit Card - Ramp,314,55306311.96
05/02/2023,Expense,Cuckoo Callay,Mike ross,Credit Card - Ramp,77.77,55306389.73
05/02/2023,Expense,Cuckoo Callay,Mike ross,Meals & Entertainment,77.77,55306467.5
05/02/2023,Expense,Olvy,,Tools & Subscription - G&A,15.89,55306483.39
05/02/2023,Expense,Cuckoo Callay,Mike ross,Credit Card - Ramp,77.77,55306561.16
05/02/2023,Expense,Cuckoo Callay,Mike ross,Credit Card - Ramp,77.77,55306638.93
05/02/2023,Expense,Render,,Tools & Subscription - G&A,220,55306858.93
05/02/2023,Expense,Render,,Tools & Subscription - G&A,220,55307078.93
05/02/2023,Expense,Render,,Tools & Subscription - G&A,220,55307298.93
05/03/2023,Expense,Uber,,Travelling Expenses,18.44,55307317.37
05/03/2023,Expense,Cook & Archies,Mike ross,Credit Card - Ramp,17.15,55307334.52
05/03/2023,Expense,Uber,Mike ross,Credit Card - Ramp,18.44,55307352.96
05/03/2023,Expense,Cook & Archies,Mike ross,Credit Card - Ramp,17.15,55307370.11
05/03/2023,Expense,VirtualPostMail,,General business expenses:Memberships & subscriptions,15,55307385.11
05/03/2023,Expense,Cook & Archies,Mike ross,Credit Card - Ramp,17.15,55307402.26
05/03/2023,Expense,Uber,,Travelling Expenses,18.44,55307420.7
05/03/2023,Expense,Uber,Mike ross,Credit Card - Ramp,18.44,55307439.14
05/03/2023,Expense,Cook & Archies,Mike ross,Meals & Entertainment,17.15,55307456.29
05/03/2023,Expense,Cook & Archies,Mike ross,Credit Card - Ramp,17.15,55307473.44
05/03/2023,Expense,VirtualPostMail,Harvey Spector,Credit Card - Ramp,15,55307488.44
05/03/2023,Expense,Cook & Archies,Mike ross,Meals & Entertainment,17.15,55307505.59
05/03/2023,Expense,VirtualPostMail,,General business expenses:Memberships & subscriptions,15,55307520.59
05/03/2023,Expense,VirtualPostMail,,General business expenses:Memberships & subscriptions,15,55307535.59
05/03/2023,Expense,Uber,,Travelling Expenses,18.44,55307554.03
05/03/2023,Expense,Cook & Archies,Mike ross,Meals & Entertainment,17.15,55307571.18
05/03/2023,Expense,VirtualPostMail,,General business expenses:Memberships & subscriptions,15,55307586.18
05/03/2023,Expense,VirtualPostMail,Harvey Spector,Credit Card - Ramp,15,55307601.18
05/03/2023,Expense,Cook & Archies,Mike ross,Meals & Entertainment,17.15,55307618.33
05/03/2023,Expense,Uber,Mike ross,Credit Card - Ramp,18.44,55307636.77
05/03/2023,Expense,VirtualPostMail,Harvey Spector,Credit Card - Ramp,15,55307651.77
05/03/2023,Expense,VirtualPostMail,Harvey Spector,Credit Card - Ramp,15,55307666.77
05/03/2023,Expense,Uber,,Travelling Expenses,18.44,55307685.21
05/04/2023,Expense,Four Ate Five,Mike ross,Credit Card - Ramp,52.83,55307738.04
05/04/2023,Expense,Four Ate Five,Mike ross,Meals & Entertainment,52.83,55307790.87
05/04/2023,Expense,Four Ate Five,Mike ross,Credit Card - Ramp,52.83,55307843.7
05/04/2023,Expense,Four Ate Five,Mike ross,Credit Card - Ramp,52.83,55307896.53
05/04/2023,Expense,Four Ate Five,Mike ross,Credit Card - Ramp,52.83,55307949.36
05/04/2023,Expense,Uber,Mike ross,Credit Card - Ramp,47.98,55307997.34
05/04/2023,Expense,Uber,Mike ross,Credit Card - Ramp,47.98,55308045.32
05/04/2023,Expense,Four Ate Five,Mike ross,Meals & Entertainment,52.83,55308098.15
05/04/2023,Expense,Uber,Mike ross,Credit Card - Ramp,47.98,55308146.13
05/04/2023,Expense,Uber,,Travelling Expenses,47.98,55308194.11
05/04/2023,Expense,Uber,,Travelling Expenses,47.98,55308242.09
05/04/2023,Expense,Four Ate Five,Mike ross,Meals & Entertainment,52.83,55308294.92
05/04/2023,Expense,Four Ate Five,Mike ross,Meals & Entertainment,52.83,55308347.75
05/04/2023,Expense,Uber,,Travelling Expenses,47.98,55308395.73
05/04/2023,Expense,Uber,,Travelling Expenses,47.98,55308443.71
05/06/2023,Expense,Starter Story,Harvey Spector,Credit Card - Ramp,1,55308444.71
05/06/2023,Expense,OpenAI,,Tools & Subscription - G&A,0.5,55308445.21
05/06/2023,Expense,Starter Story,,Tools & Subscription - G&A,1,55308446.21
05/06/2023,Expense,Adobe,,Tools & Subscription - S&M,84.92,55308531.13
05/06/2023,Expense,Adobe,,Tools & Subscription - S&M,84.92,55308616.05
05/06/2023,Expense,OpenAI,,Tools & Subscription - G&A,0.5,55308616.55
05/06/2023,Expense,OpenAI,Balapavan Tirumani,Credit Card - Ramp,0.5,55308617.05
05/06/2023,Expense,Starter Story,Harvey Spector,Credit Card - Ramp,1,55308618.05
05/06/2023,Expense,Adobe,Mike ross,Credit Card - Ramp,84.92,55308702.97
05/06/2023,Expense,OpenAI,Balapavan Tirumani,Credit Card - Ramp,0.5,55308703.47
05/06/2023,Expense,Adobe,Mike ross,Credit Card - Ramp,84.92,55308788.39
05/06/2023,Expense,Starter Story,,Tools & Subscription - G&A,1,55308789.39
05/06/2023,Expense,Adobe,,Tools & Subscription - S&M,84.92,55308874.31
05/06/2023,Expense,Starter Story,,Tools & Subscription - G&A,1,55308875.31
05/06/2023,Expense,Adobe,Mike ross,Credit Card - Ramp,84.92,55308960.23
05/06/2023,Expense,Starter Story,Harvey Spector,Credit Card - Ramp,1,55308961.23
05/06/2023,Expense,Adobe,,Tools & Subscription - S&M,84.92,55309046.15
05/06/2023,Expense,OpenAI,,Tools & Subscription - G&A,0.5,55309046.65
05/06/2023,Expense,Starter Story,,Tools & Subscription - G&A,1,55309047.65
05/06/2023,Expense,OpenAI,,Tools & Subscription - G&A,0.5,55309048.15
05/06/2023,Expense,OpenAI,Balapavan Tirumani,Credit Card - Ramp,0.5,55309048.65
05/07/2023,Expense,Mailchimp,,Tools & Subscription - G&A,22.23,55309070.88
05/07/2023,Expense,Mailchimp,,Tools & Subscription - G&A,22.23,55309093.11
05/07/2023,Expense,Mailchimp,Mike ross,Credit Card - Ramp,22.23,55309115.34
05/07/2023,Expense,Mailchimp,Mike ross,Credit Card - Ramp,22.23,55309137.57
05/07/2023,Expense,Mailchimp,Mike ross,Credit Card - Ramp,22.23,55309159.8
05/07/2023,Expense,Mailchimp,,Tools & Subscription - G&A,22.23,55309182.03
05/07/2023,Expense,Mailchimp,,Tools & Subscription - G&A,22.23,55309204.26
05/08/2023,Expense,Userflow,,Tools & Subscription - G&A,250,55309454.26
05/08/2023,Expense,Cuckoo Callay,Mike ross,Credit Card - Ramp,35.33,55309489.59
05/08/2023,Expense,Userflow,,Tools & Subscription - G&A,250,55309739.59
05/08/2023,Expense,Cuckoo Callay,Mike ross,Credit Card - Ramp,35.33,55309774.92
05/08/2023,Expense,Userflow,Max Kausman,Credit Card - Ramp,250,55310024.92
05/08/2023,Expense,Userflow,Max Kausman,Credit Card - Ramp,250,55310274.92
05/08/2023,Expense,Cuckoo Callay,Mike ross,Meals & Entertainment,35.33,55310310.25
05/08/2023,Expense,Userflow,,Tools & Subscription - G&A,250,55310560.25
05/08/2023,Expense,Userflow,Max Kausman,Credit Card - Ramp,250,55310810.25
05/08/2023,Expense,Cuckoo Callay,Mike ross,Meals & Entertainment,35.33,55310845.58
05/08/2023,Expense,Cuckoo Callay,Mike ross,Credit Card - Ramp,35.33,55310880.91
05/08/2023,Expense,Cuckoo Callay,Mike ross,Credit Card - Ramp,35.33,55310916.24
05/08/2023,Expense,Cuckoo Callay,Mike ross,Meals & Entertainment,35.33,55310951.57
05/08/2023,Expense,Userflow,,Tools & Subscription - G&A,250,55311201.57
05/08/2023,Expense,Cuckoo Callay,Mike ross,Meals & Entertainment,35.33,55311236.9
05/09/2023,Expense,Bar Positano,Mike ross,Meals & Entertainment,34,55311270.9
05/09/2023,Expense,Bar Positano,Mike ross,Meals & Entertainment,34,55311304.9
05/09/2023,Expense,Sendinblue,,Tools & Subscription - G&A,5.71,55311310.61
05/09/2023,Expense,Usersnap,Harris Jose,Credit Card - Ramp,19,55311329.61
05/09/2023,Expense,Sendinblue,Balapavan Tirumani,Credit Card - Ramp,5.71,55311335.32
05/09/2023,Expense,Taplio,Harvey Spector,Credit Card - Ramp,39,55311374.32
05/09/2023,Expense,Sendinblue,Balapavan Tirumani,Credit Card - Ramp,5.71,55311380.03
05/09/2023,Expense,Usersnap,Harris Jose,Credit Card - Ramp,19,55311399.03
05/09/2023,Expense,Usersnap,,Tools & Subscription - G&A,19,55311418.03
05/09/2023,Expense,Taplio,,Tools & Subscription - G&A,39,55311457.03
05/09/2023,Expense,Linkedin Recruiter,,General business expenses:Memberships & subscriptions,105.9,55311562.93
05/09/2023,Expense,Linkedin Recruiter,Harvey Spector,Credit Card - Ramp,105.9,55311668.83
05/09/2023,Expense,Taplio,Harvey Spector,Credit Card - Ramp,39,55311707.83
05/09/2023,Expense,Bar Positano,Mike ross,Credit Card - Ramp,34,55311741.83
05/09/2023,Expense,Linkedin Recruiter,Harvey Spector,Credit Card - Ramp,105.9,55311847.73
05/09/2023,Expense,Linkedin Recruiter,,General business expenses:Memberships & subscriptions,105.9,55311953.63
05/09/2023,Expense,Bar Positano,Mike ross,Credit Card - Ramp,34,55311987.63
05/09/2023,Expense,Usersnap,,Tools & Subscription - G&A,19,55312006.63
05/09/2023,Expense,Sendinblue,Balapavan Tirumani,Credit Card - Ramp,5.71,55312012.34
05/09/2023,Expense,Taplio,,Tools & Subscription - G&A,39,55312051.34
05/09/2023,Expense,Bar Positano,Mike ross,Credit Card - Ramp,34,55312085.34
05/09/2023,Expense,Bar Positano,Mike ross,Meals & Entertainment,34,55312119.34
05/09/2023,Expense,Linkedin Recruiter,,General business expenses:Memberships & subscriptions,105.9,55312225.24
05/09/2023,Expense,Usersnap,,Tools & Subscription - G&A,19,55312244.24
05/09/2023,Expense,Linkedin Recruiter,,General business expenses:Memberships & subscriptions,105.9,55312350.14
05/09/2023,Expense,Taplio,Harvey Spector,Credit Card - Ramp,39,55312389.14
05/09/2023,Expense,Taplio,,Tools & Subscription - G&A,39,55312428.14
05/09/2023,Expense,Bar Positano,Mike ross,Meals & Entertainment,34,55312462.14
05/09/2023,Expense,Taplio,,Tools & Subscription - G&A,39,55312501.14
05/09/2023,Expense,Usersnap,,Tools & Subscription - G&A,19,55312520.14
05/09/2023,Expense,Sendinblue,,Tools & Subscription - G&A,5.71,55312525.85
05/09/2023,Expense,Usersnap,Harris Jose,Credit Card - Ramp,19,55312544.85
05/09/2023,Expense,Sendinblue,,Tools & Subscription - G&A,5.71,55312550.56
05/09/2023,Expense,Linkedin Recruiter,Harvey Spector,Credit Card - Ramp,105.9,55312656.46
05/09/2023,Expense,Bar Positano,Mike ross,Credit Card - Ramp,34,55312690.46
05/09/2023,Expense,Linkedin Recruiter,Harvey Spector,Credit Card - Ramp,105.9,55312796.36
05/09/2023,Expense,Sendinblue,,Tools & Subscription - G&A,5.71,55312802.07
05/10/2023,Expense,Rewind AI,,Tools & Subscription - G&A,20,55312822.07
05/10/2023,Expense,Uber,,Travelling Expenses,7.65,55312829.72
05/10/2023,Expense,Pause Cafe,Harvey Spector,Meals & Entertainment,13,55312842.72
05/10/2023,Expense,Rewind AI,Harvey Spector,Credit Card - Ramp,20,55312862.72
05/10/2023,Expense,Pause Cafe,Harvey Spector,Credit Card - Ramp,13,55312875.72
05/10/2023,Expense,Rewind AI,Harvey Spector,Credit Card - Ramp,20,55312895.72
05/10/2023,Expense,Uber,Mike ross,Credit Card - Ramp,7.65,55312903.37
05/10/2023,Expense,Uber,,Travelling Expenses,7.65,55312911.02
05/10/2023,Expense,Uber,Mike ross,Credit Card - Ramp,7.65,55312918.67
05/10/2023,Expense,Pause Cafe,Harvey Spector,Credit Card - Ramp,13,55312931.67
05/10/2023,Expense,Rewind AI,,Tools & Subscription - G&A,20,55312951.67
05/10/2023,Expense,Pause Cafe,Harvey Spector,Credit Card - Ramp,13,55312964.67
05/10/2023,Expense,Uber,,Travelling Expenses,7.65,55312972.32
05/10/2023,Expense,Pause Cafe,Harvey Spector,Credit Card - Ramp,13,55312985.32
05/10/2023,Expense,Pause Cafe,Harvey Spector,Meals & Entertainment,13,55312998.32
05/10/2023,Expense,Uber,,Travelling Expenses,7.65,55313005.97
05/10/2023,Expense,Rewind AI,Harvey Spector,Credit Card - Ramp,20,55313025.97
05/10/2023,Expense,Pause Cafe,Harvey Spector,Meals & Entertainment,13,55313038.97
05/10/2023,Expense,Pause Cafe,Harvey Spector,Meals & Entertainment,13,55313051.97
05/10/2023,Expense,Uber,Mike ross,Credit Card - Ramp,7.65,55313059.62
05/10/2023,Expense,Rewind AI,,Tools & Subscription - G&A,20,55313079.62
05/10/2023,Expense,Rewind AI,,Tools & Subscription - G&A,20,55313099.62
05/11/2023,Expense,Heroku,Balapavan Tirumani,Credit Card - Ramp,85,55313184.62
05/11/2023,Expense,Heroku,Balapavan Tirumani,Tools & Subscription - S&M,85,55313269.62
05/11/2023,Expense,Cafe Dougie Restaurant,Mike ross,Meals & Entertainment,18.54,55313288.16
05/11/2023,Expense,Heroku,Balapavan Tirumani,Tools & Subscription - S&M,85,55313373.16
05/11/2023,Expense,Heroku,Balapavan Tirumani,Credit Card - Ramp,85,55313458.16
05/11/2023,Expense,Heroku,Balapavan Tirumani,Tools & Subscription - S&M,85,55313543.16
05/11/2023,Expense,Cafe Dougie Restaurant,Mike ross,Meals & Entertainment,18.54,55313561.7
05/11/2023,Expense,Cafe Dougie Restaurant,Mike ross,Meals & Entertainment,18.54,55313580.24
05/11/2023,Expense,Heroku,Balapavan Tirumani,Tools & Subscription - S&M,85,55313665.24
05/11/2023,Expense,Cafe Dougie Restaurant,Mike ross,Credit Card - Ramp,18.54,55313683.78
05/11/2023,Expense,Cafe Dougie Restaurant,Mike ross,Credit Card - Ramp,18.54,55313702.32
05/11/2023,Expense,Heroku,Balapavan Tirumani,Credit Card - Ramp,85,55313787.32
05/11/2023,Expense,Cafe Dougie Restaurant,Mike ross,Credit Card - Ramp,18.54,55313805.86
05/11/2023,Expense,Cafe Dougie Restaurant,Mike ross,Credit Card - Ramp,18.54,55313824.4
05/11/2023,Expense,Cafe Dougie Restaurant,Mike ross,Meals & Entertainment,18.54,55313842.94
05/12/2023,Expense,Adobe,,Tools & Subscription - S&M,20.99,55313863.93
05/12/2023,Expense,WordPress,,Tools & Subscription - G&A,15.84,55313879.77
05/12/2023,Expense,Uber,,Travelling Expenses,14.15,55313893.92
05/12/2023,Expense,Uber,,Travelling Expenses,14.15,55313908.07
05/12/2023,Expense,Uber,Mike ross,Credit Card - Ramp,14.15,55313922.22
05/12/2023,Expense,Adobe,,Tools & Subscription - S&M,20.99,55313943.21
05/12/2023,Expense,Uber,Mike ross,Credit Card - Ramp,14.15,55313957.36
05/12/2023,Expense,WordPress,,Tools & Subscription - G&A,15.84,55313973.2
05/12/2023,Expense,Adobe,Chris George,Credit Card - Ramp,20.99,55313994.19
05/12/2023,Expense,Adobe,Chris George,Credit Card - Ramp,20.99,55314015.18
05/12/2023,Expense,Uber,,Travelling Expenses,14.15,55314029.33
05/12/2023,Expense,Adobe,,Tools & Subscription - S&M,20.99,55314050.32
05/12/2023,Expense,Adobe,Chris George,Credit Card - Ramp,20.99,55314071.31
05/12/2023,Expense,Uber,Mike ross,Credit Card - Ramp,14.15,55314085.46
05/12/2023,Expense,WordPress,Harris Jose,Credit Card - Ramp,15.84,55314101.3
05/12/2023,Expense,Adobe,,Tools & Subscription - S&M,20.99,55314122.29
05/12/2023,Expense,WordPress,,Tools & Subscription - G&A,15.84,55314138.13
05/12/2023,Expense,WordPress,,Tools & Subscription - G&A,15.84,55314153.97
05/12/2023,Expense,Uber,,Travelling Expenses,14.15,55314168.12
05/12/2023,Expense,WordPress,Harris Jose,Credit Card - Ramp,15.84,55314183.96
05/12/2023,Expense,WordPress,Harris Jose,Credit Card - Ramp,15.84,55314199.8
05/13/2023,Expense,Uber,Mike ross,Credit Card - Ramp,12.7,55314212.5
05/13/2023,Expense,Uber,Harvey Spector,Credit Card - Ramp,3.8,55314216.3
05/13/2023,Expense,Uber,Harvey Spector,Credit Card - Ramp,3.8,55314220.1
05/13/2023,Expense,Lenny Rachitsky,Max Kausman,Credit Card - Ramp,15,55314235.1
05/13/2023,Expense,Vercel,,Tools & Subscription - G&A,260,55314495.1
05/13/2023,Expense,Figma,Mike ross,Credit Card - Ramp,215,55314710.1
05/13/2023,Expense,PocketSmith,,Tools & Subscription - G&A,9.95,55314720.05
05/13/2023,Expense,Interact32,Harvey Spector,Tools & Subscription - G&A,10.22,55314730.27
05/13/2023,Expense,Figma,,Tools & Subscription - G&A,215,55314945.27
05/13/2023,Expense,Lenny Rachitsky,,General business expenses:Memberships & subscriptions,15,55314960.27
05/13/2023,Expense,Uber,,Travelling Expenses,3.8,55314964.07
05/13/2023,Expense,Intercom,,Tools & Subscription - G&A,19,55314983.07
05/13/2023,Expense,Lenny Rachitsky,Max Kausman,Credit Card - Ramp,15,55314998.07
05/13/2023,Expense,PocketSmith,Harvey Spector,Credit Card - Ramp,9.95,55315008.02
05/13/2023,Expense,Lenny Rachitsky,,General business expenses:Memberships & subscriptions,15,55315023.02
05/13/2023,Expense,Lenny Rachitsky,Max Kausman,Credit Card - Ramp,15,55315038.02
05/13/2023,Expense,Vercel,,Tools & Subscription - G&A,260,55315298.02
05/13/2023,Expense,Interact32,Harvey Spector,Credit Card - Ramp,10.22,55315308.24
05/13/2023,Expense,Figma,Mike ross,Credit Card - Ramp,215,55315523.24
05/13/2023,Expense,PocketSmith,,Tools & Subscription - G&A,9.95,55315533.19
05/13/2023,Expense,Uber,Mike ross,Credit Card - Ramp,12.7,55315545.89
05/13/2023,Expense,Uber,Harvey Spector,Credit Card - Ramp,3.8,55315549.69
05/13/2023,Expense,Interact32,Harvey Spector,Tools & Subscription - G&A,10.22,55315559.91
05/13/2023,Expense,Uber,,Travelling Expenses,12.7,55315572.61
05/13/2023,Expense,Uber,,Travelling Expenses,3.8,55315576.41
05/13/2023,Expense,Figma,,Tools & Subscription - G&A,215,55315791.41
05/13/2023,Expense,Vercel,Harris Jose,Credit Card - Ramp,260,55316051.41
05/13/2023,Expense,Vercel,Harris Jose,Credit Card - Ramp,260,55316311.41
05/13/2023,Expense,Uber,,Travelling Expenses,12.7,55316324.11
05/13/2023,Expense,Intercom,Balapavan Tirumani,Credit Card - Ramp,19,55316343.11
05/13/2023,Expense,Intercom,,Tools & Subscription - G&A,19,55316362.11
05/13/2023,Expense,Vercel,Harris Jose,Credit Card - Ramp,260,55316622.11
05/13/2023,Expense,Interact32,Harvey Spector,Credit Card - Ramp,10.22,55316632.33
05/13/2023,Expense,Intercom,Balapavan Tirumani,Credit Card - Ramp,19,55316651.33
05/13/2023,Expense,PocketSmith,Harvey Spector,Credit Card - Ramp,9.95,55316661.28
05/13/2023,Expense,Vercel,,Tools & Subscription - G&A,260,55316921.28
05/13/2023,Expense,Intercom,,Tools & Subscription - G&A,19,55316940.28
05/13/2023,Expense,Interact32,Harvey Spector,Credit Card - Ramp,10.22,55316950.5
05/13/2023,Expense,Uber,,Travelling Expenses,12.7,55316963.2
05/13/2023,Expense,Figma,Mike ross,Credit Card - Ramp,215,55317178.2
05/13/2023,Expense,Uber,,Travelling Expenses,3.8,55317182
05/13/2023,Expense,Interact32,Harvey Spector,Tools & Subscription - G&A,10.22,55317192.22
05/13/2023,Expense,Lenny Rachitsky,Max Kausman,Credit Card - Ramp,15,55317207.22
05/13/2023,Expense,PocketSmith,,Tools & Subscription - G&A,9.95,55317217.17
05/13/2023,Expense,Uber,,Travelling Expenses,3.8,55317220.97
05/13/2023,Expense,Figma,,Tools & Subscription - G&A,215,55317435.97
05/13/2023,Expense,Intercom,Balapavan Tirumani,Credit Card - Ramp,19,55317454.97
05/13/2023,Expense,PocketSmith,Harvey Spector,Credit Card - Ramp,9.95,55317464.92
05/13/2023,Expense,Intercom,,Tools & Subscription - G&A,19,55317483.92
05/13/2023,Expense,Lenny Rachitsky,,General business expenses:Memberships & subscriptions,15,55317498.92
05/13/2023,Expense,Uber,Mike ross,Credit Card - Ramp,12.7,55317511.62
05/13/2023,Expense,PocketSmith,,Tools & Subscription - G&A,9.95,55317521.57
05/13/2023,Expense,Interact32,Harvey Spector,Tools & Subscription - G&A,10.22,55317531.79
05/13/2023,Expense,Lenny Rachitsky,,General business expenses:Memberships & subscriptions,15,55317546.79
05/13/2023,Expense,Figma,,Tools & Subscription - G&A,215,55317761.79
05/13/2023,Expense,Uber,,Travelling Expenses,12.7,55317774.49
05/13/2023,Expense,Vercel,,Tools & Subscription - G&A,260,55318034.49
05/14/2023,Expense,OpenAI,Balapavan Tirumani,Credit Card - Ramp,20,55318054.49
05/14/2023,Expense,Uber,,Travelling Expenses,49.63,55318104.12
05/14/2023,Expense,The New York Times,,General business expenses:Memberships & subscriptions,8.29,55318112.41
05/14/2023,Expense,Intuit,,Tools & Subscription - G&A,55,55318167.41
05/14/2023,Expense,The New York Times,Mike ross,Credit Card - Ramp,8.29,55318175.7
05/14/2023,Expense,Intuit,,Tools & Subscription - G&A,55,55318230.7
05/14/2023,Expense,The New York Times,Mike ross,Credit Card - Ramp,8.29,55318238.99
05/14/2023,Expense,OpenAI,,Tools & Subscription - G&A,20,55318258.99
05/14/2023,Expense,Uber,,Travelling Expenses,49.63,55318308.62
05/14/2023,Expense,OpenAI,,Tools & Subscription - G&A,20,55318328.62
05/14/2023,Expense,Uber,,Travelling Expenses,49.63,55318378.25
05/14/2023,Expense,The New York Times,,General business expenses:Memberships & subscriptions,8.29,55318386.54
05/14/2023,Expense,Uber,Mike ross,Credit Card - Ramp,49.63,55318436.17
05/14/2023,Expense,OpenAI,Balapavan Tirumani,Credit Card - Ramp,20,55318456.17
05/14/2023,Expense,The New York Times,,General business expenses:Memberships & subscriptions,8.29,55318464.46
05/14/2023,Expense,The New York Times,,General business expenses:Memberships & subscriptions,8.29,55318472.75
05/14/2023,Expense,OpenAI,Balapavan Tirumani,Credit Card - Ramp,20,55318492.75
05/14/2023,Expense,The New York Times,Mike ross,Credit Card - Ramp,8.29,55318501.04
05/14/2023,Expense,Intuit,Harvey Spector,Credit Card - Ramp,55,55318556.04
05/14/2023,Expense,The New York Times,Mike ross,Credit Card - Ramp,8.29,55318564.33
05/14/2023,Expense,Intuit,Harvey Spector,Credit Card - Ramp,55,55318619.33
05/14/2023,Expense,Uber,Mike ross,Credit Card - Ramp,49.63,55318668.96
05/14/2023,Expense,OpenAI,,Tools & Subscription - G&A,20,55318688.96
05/14/2023,Expense,Uber,Mike ross,Credit Card - Ramp,49.63,55318738.59
05/14/2023,Expense,Uber,,Travelling Expenses,49.63,55318788.22
05/14/2023,Expense,OpenAI,,Tools & Subscription - G&A,20,55318808.22
05/14/2023,Expense,Intuit,,Tools & Subscription - G&A,55,55318863.22
05/14/2023,Expense,Intuit,,Tools & Subscription - G&A,55,55318918.22
05/14/2023,Expense,Intuit,Harvey Spector,Credit Card - Ramp,55,55318973.22
05/15/2023,Expense,,Stephan Eggum O1A,Account1,10000,55328973.22
05/15/2023,Bill,ANSR Dubai,,Professional Service Charges,28470,55357443.22
05/15/2023,Expense,,Stephan Eggum O1A,Account1,10000,55367443.22
05/15/2023,Expense,Raycast,,Tools & Subscription - G&A,96,55367539.22
05/15/2023,Bill,ANSR Dubai,Service Fees for May 2023,Accounts Payable (A/P),28470,55396009.22
05/15/2023,Expense,Raycast,,Tools & Subscription - G&A,96,55396105.22
05/15/2023,Expense,Meggykenny Pty Ltd,Mike ross,Meals & Entertainment,25.12,55396130.34
05/15/2023,Expense,,Stephan Eggum O1A,Professional Service Charges,-10000,55386130.34
05/15/2023,Bill,ANSR Dubai,,Professional Service Charges,28470,55414600.34
05/15/2023,Expense,Meggykenny Pty Ltd,Mike ross,Meals & Entertainment,25.12,55414625.46
05/15/2023,Expense,Raycast,,Tools & Subscription - G&A,96,55414721.46
05/15/2023,Bill,ANSR Dubai,Service Fees for May 2023,Accounts Payable (A/P),28470,55443191.46
05/15/2023,Expense,Raycast,Mike ross,Credit Card - Ramp,96,55443287.46
05/15/2023,Bill,ANSR Dubai,,Professional Service Charges,28470,55471757.46
05/15/2023,Expense,,Stephan Eggum O1A,Professional Service Charges,-10000,55461757.46
05/15/2023,Expense,Meggykenny Pty Ltd,Mike ross,Meals & Entertainment,25.12,55461782.58
05/15/2023,Expense,Raycast,,Tools & Subscription - G&A,96,55461878.58
05/15/2023,Expense,Raycast,Mike ross,Credit Card - Ramp,96,55461974.58
05/15/2023,Expense,Meggykenny Pty Ltd,Mike ross,Meals & Entertainment,25.12,55461999.7
05/15/2023,Expense,,Stephan Eggum O1A,Account1,10000,55471999.7
05/15/2023,Bill,ANSR Dubai,Service Fees for May 2023,Accounts Payable (A/P),28470,55500469.7
05/15/2023,Bill,ANSR Dubai,,Professional Service Charges,28470,55528939.7
05/15/2023,Expense,Meggykenny Pty Ltd,Mike ross,Credit Card - Ramp,25.12,55528964.82
05/15/2023,Bill,ANSR Dubai,Service Fees for May 2023,Accounts Payable (A/P),28470,55557434.82
05/15/2023,Expense,Raycast,Mike ross,Credit Card - Ramp,96,55557530.82
05/15/2023,Expense,Meggykenny Pty Ltd,Mike ross,Credit Card - Ramp,25.12,55557555.94
05/15/2023,Expense,Meggykenny Pty Ltd,Mike ross,Credit Card - Ramp,25.12,55557581.06
05/15/2023,Expense,,Stephan Eggum O1A,Professional Service Charges,-10000,55547581.06
05/15/2023,Expense,,Stephan Eggum O1A,Professional Service Charges,-10000,55537581.06
05/15/2023,Expense,,Stephan Eggum O1A,Account1,10000,55547581.06
05/15/2023,Expense,Meggykenny Pty Ltd,Mike ross,Credit Card - Ramp,25.12,55547606.18
05/16/2023,Expense,Linear,Chad Blumenthal,Credit Card - Ramp,170,55547776.18
05/16/2023,Expense,Zapier,Harvey Spector,Credit Card - Ramp,29.99,55547806.17
05/16/2023,Expense,Linear,Chad Blumenthal,Credit Card - Ramp,170,55547976.17
05/16/2023,Expense,Zapier,Harvey Spector,Credit Card - Ramp,29.99,55548006.16
05/16/2023,Expense,Zapier,,Tools & Subscription - G&A,29.99,55548036.15
05/16/2023,Expense,Linear,,Tools & Subscription - G&A,170,55548206.15
05/16/2023,Expense,Linear,Chad Blumenthal,Credit Card - Ramp,170,55548376.15
05/16/2023,Expense,Zapier,,Tools & Subscription - G&A,29.99,55548406.14
05/16/2023,Expense,Zapier,Harvey Spector,Credit Card - Ramp,29.99,55548436.13
05/16/2023,Expense,Linear,,Tools & Subscription - G&A,170,55548606.13
05/16/2023,Expense,Zapier,,Tools & Subscription - G&A,29.99,55548636.12
05/16/2023,Expense,Linear,,Tools & Subscription - G&A,170,55548806.12
05/16/2023,Expense,Linear,,Tools & Subscription - G&A,170,55548976.12
05/16/2023,Expense,Zapier,,Tools & Subscription - G&A,29.99,55549006.11
05/17/2023,Expense,HCC Medical Insurance Services,Harvey Spector,Credit Card - Ramp,30.59,55549036.7
05/17/2023,Expense,HCC Medical Insurance Services,,Insurance,30.59,55549067.29
05/17/2023,Expense,,Fees,HSBC A/c,23.34,55549090.63
05/17/2023,Expense,HCC Medical Insurance Services,,Insurance,30.59,55549121.22
05/17/2023,Expense,Uber,,Travelling Expenses,39.19,55549160.41
05/17/2023,Expense,HCC Medical Insurance Services,Harvey Spector,Credit Card - Ramp,30.59,55549191
05/17/2023,Expense,Uber,,Travelling Expenses,16.06,55549207.06
05/17/2023,Expense,,Fees MONTHLY CHARGE Bank Charges for the per 11APR2023 TO 30APR2023 Invoice No 1610504,General business expenses:Bank fees & service charges,-23.34,55549183.72
05/17/2023,Expense,Uber,,Travelling Expenses,39.19,55549222.91
05/17/2023,Expense,Uber,Mike ross,Credit Card - Ramp,39.19,55549262.1
05/17/2023,Expense,,Fees MONTHLY CHARGE Bank Charges for the per 11APR2023 TO 30APR2023 Invoice No 1610504,General business expenses:Bank fees & service charges,-23.34,55549238.76
05/17/2023,Expense,HCC Medical Insurance Services,Harvey Spector,Credit Card - Ramp,30.59,55549269.35
05/17/2023,Expense,Uber,Mike ross,Credit Card - Ramp,16.06,55549285.41
05/17/2023,Expense,,Fees,HSBC A/c,23.34,55549308.75
05/17/2023,Expense,HCC Medical Insurance Services,,Insurance,30.59,55549339.34
05/17/2023,Expense,HCC Medical Insurance Services,,Insurance,30.59,55549369.93
05/17/2023,Expense,Uber,,Travelling Expenses,16.06,55549385.99
05/17/2023,Expense,,Fees MONTHLY CHARGE Bank Charges for the per 11APR2023 TO 30APR2023 Invoice No 1610504,General business expenses:Bank fees & service charges,-23.34,55549362.65
05/17/2023,Expense,Uber,Mike ross,Credit Card - Ramp,16.06,55549378.71
05/17/2023,Expense,,Fees MONTHLY CHARGE Bank Charges for the per 11APR2023 TO 30APR2023 Invoice No 1610504,General business expenses:Bank fees & service charges,-23.34,55549355.37
05/17/2023,Expense,Uber,Mike ross,Credit Card - Ramp,39.19,55549394.56
05/17/2023,Expense,Uber,,Travelling Expenses,39.19,55549433.75
05/17/2023,Expense,Uber,Mike ross,Credit Card - Ramp,16.06,55549449.81
05/17/2023,Expense,,Fees,HSBC A/c,23.34,55549473.15
05/17/2023,Expense,Uber,,Travelling Expenses,16.06,55549489.21
05/17/2023,Expense,,Fees,HSBC A/c,23.34,55549512.55
05/17/2023,Expense,Uber,Mike ross,Credit Card - Ramp,39.19,55549551.74
05/17/2023,Expense,Uber,,Travelling Expenses,39.19,55549590.93
05/17/2023,Expense,Uber,,Travelling Expenses,16.06,55549606.99
05/17/2023,Expense,HCC Medical Insurance Services,Harvey Spector,Credit Card - Ramp,30.59,55549637.58
05/18/2023,Expense,Uber,Mike ross,Credit Card - Ramp,12.05,55549649.63
05/18/2023,Expense,Uber,Mike ross,Credit Card - Ramp,10.51,55549660.14
05/18/2023,Expense,Linkedin Recruiter,Mike ross,Credit Card - Ramp,154.71,55549814.85
05/18/2023,Expense,Uber,,Travelling Expenses,10.51,55549825.36
05/18/2023,Expense,Uber,Mike ross,Credit Card - Ramp,7.22,55549832.58
05/18/2023,Expense,Cafe Bench,Mike ross,Meals & Entertainment,30.94,55549863.52
05/18/2023,Expense,Reclaim.ai,,Tools & Subscription - G&A,8,55549871.52
05/18/2023,Expense,Cafe Bench,Mike ross,Credit Card - Ramp,30.94,55549902.46
05/18/2023,Expense,Segment,Balapavan Tirumani,Credit Card - Ramp,120,55550022.46
05/18/2023,Expense,Reclaim.ai,Max Kausman,Credit Card - Ramp,8,55550030.46
05/18/2023,Expense,Uber,Mike ross,Credit Card - Ramp,13.25,55550043.71
05/18/2023,Expense,Uber,,Travelling Expenses,12.05,55550055.76
05/18/2023,Expense,Uber,Mike ross,Credit Card - Ramp,7.22,55550062.98
05/18/2023,Expense,Cafe Bench,Mike ross,Meals & Entertainment,30.94,55550093.92
05/18/2023,Expense,Uber,,Travelling Expenses,7.22,55550101.14
05/18/2023,Expense,Uber,,Travelling Expenses,10.51,55550111.65
05/18/2023,Expense,Uber,,Travelling Expenses,13.25,55550124.9
05/18/2023,Expense,Cafe Bench,Mike ross,Credit Card - Ramp,30.94,55550155.84
05/18/2023,Expense,Uber,,Travelling Expenses,12.05,55550167.89
05/18/2023,Expense,Reclaim.ai,,Tools & Subscription - G&A,8,55550175.89
05/18/2023,Expense,Linkedin Recruiter,Mike ross,Credit Card - Ramp,154.71,55550330.6
05/18/2023,Expense,Segment,,Tools & Subscription - G&A,120,55550450.6
05/18/2023,Expense,Linkedin Recruiter,,General business expenses:Memberships & subscriptions,154.71,55550605.31
05/18/2023,Expense,Uber,Mike ross,Credit Card - Ramp,10.51,55550615.82
05/18/2023,Expense,Uber,Mike ross,Credit Card - Ramp,7.22,55550623.04
05/18/2023,Expense,Uber,,Travelling Expenses,7.22,55550630.26
05/18/2023,Expense,Linkedin Recruiter,Mike ross,Credit Card - Ramp,154.71,55550784.97
05/18/2023,Expense,Uber,,Travelling Expenses,13.25,55550798.22
05/18/2023,Expense,Segment,,Tools & Subscription - G&A,120,55550918.22
05/18/2023,Expense,Uber,,Travelling Expenses,7.22,55550925.44
05/18/2023,Expense,Linkedin Recruiter,,General business expenses:Memberships & subscriptions,154.71,55551080.15
05/18/2023,Expense,Uber,,Travelling Expenses,10.51,55551090.66
05/18/2023,Expense,Segment,Balapavan Tirumani,Credit Card - Ramp,120,55551210.66
05/18/2023,Expense,Reclaim.ai,Max Kausman,Credit Card - Ramp,8,55551218.66
05/18/2023,Expense,Uber,,Travelling Expenses,7.22,55551225.88
05/18/2023,Expense,Cafe Bench,Mike ross,Credit Card - Ramp,30.94,55551256.82
05/18/2023,Expense,Uber,Mike ross,Credit Card - Ramp,13.25,55551270.07
05/18/2023,Expense,Uber,Mike ross,Credit Card - Ramp,12.05,55551282.12
05/18/2023,Expense,Segment,Balapavan Tirumani,Credit Card - Ramp,120,55551402.12
05/18/2023,Expense,Linkedin Recruiter,Mike ross,Credit Card - Ramp,154.71,55551556.83
05/18/2023,Expense,Linkedin Recruiter,,General business expenses:Memberships & subscriptions,154.71,55551711.54
05/18/2023,Expense,Segment,,Tools & Subscription - G&A,120,55551831.54
05/18/2023,Expense,Cafe Bench,Mike ross,Meals & Entertainment,30.94,55551862.48
05/18/2023,Expense,Uber,Mike ross,Credit Card - Ramp,13.25,55551875.73
05/18/2023,Expense,Reclaim.ai,Max Kausman,Credit Card - Ramp,8,55551883.73
05/18/2023,Expense,Uber,,Travelling Expenses,12.05,55551895.78
05/18/2023,Expense,Uber,,Travelling Expenses,13.25,55551909.03
05/18/2023,Expense,Uber,,Travelling Expenses,13.25,55551922.28
05/18/2023,Expense,Uber,,Travelling Expenses,12.05,55551934.33
05/18/2023,Expense,Reclaim.ai,,Tools & Subscription - G&A,8,55551942.33
05/18/2023,Expense,Cafe Bench,Mike ross,Meals & Entertainment,30.94,55551973.27
05/18/2023,Expense,Uber,,Travelling Expenses,10.51,55551983.78
05/18/2023,Expense,Linkedin Recruiter,,General business expenses:Memberships & subscriptions,154.71,55552138.49
05/18/2023,Expense,Cafe Bench,Mike ross,Credit Card - Ramp,30.94,55552169.43
05/18/2023,Expense,Uber,Mike ross,Credit Card - Ramp,10.51,55552179.94
05/18/2023,Expense,Uber,Mike ross,Credit Card - Ramp,12.05,55552191.99
05/18/2023,Expense,Reclaim.ai,,Tools & Subscription - G&A,8,55552199.99
05/18/2023,Expense,Segment,,Tools & Subscription - G&A,120,55552319.99
05/19/2023,Expense,Twitter,,Tools & Subscription - G&A,8.11,55552328.1
05/19/2023,Expense,Inventus Law,"INVENTUS LAW, PC",Account1,2150,55554478.1
05/19/2023,Expense,Twitter,Harvey Spector,Credit Card - Ramp,8.11,55554486.21
05/19/2023,Expense,Inventus Law,"INVENTUS LAW, PC",Account1,2150,55556636.21
05/19/2023,Expense,Lenny Rachitsky,,General business expenses:Memberships & subscriptions,150,55556786.21
05/19/2023,Expense,Lenny Rachitsky,,General business expenses:Memberships & subscriptions,150,55556936.21
05/19/2023,Expense,Twitter,,Tools & Subscription - G&A,8.11,55556944.32
05/19/2023,Expense,Twitter,Harvey Spector,Credit Card - Ramp,8.11,55556952.43
05/19/2023,Expense,Lenny Rachitsky,,General business expenses:Memberships & subscriptions,150,55557102.43
05/19/2023,Expense,Lenny Rachitsky,Mike ross,Credit Card - Ramp,150,55557252.43
05/19/2023,Expense,Inventus Law,"INVENTUS LAW, PC",Legal & accounting services,-2150,55555102.43
05/19/2023,Expense,Twitter,,Tools & Subscription - G&A,8.11,55555110.54
05/19/2023,Expense,Lenny Rachitsky,Mike ross,Credit Card - Ramp,150,55555260.54
05/19/2023,Expense,Inventus Law,"INVENTUS LAW, PC",Account1,2150,55557410.54
05/19/2023,Expense,Twitter,,Tools & Subscription - G&A,8.11,55557418.65
05/19/2023,Expense,Twitter,Harvey Spector,Credit Card - Ramp,8.11,55557426.76
05/19/2023,Expense,Inventus Law,"INVENTUS LAW, PC",Legal & accounting services,-2150,55555276.76
05/19/2023,Expense,Lenny Rachitsky,,General business expenses:Memberships & subscriptions,150,55555426.76
05/19/2023,Expense,Lenny Rachitsky,Mike ross,Credit Card - Ramp,150,55555576.76
05/19/2023,Expense,Inventus Law,"INVENTUS LAW, PC",Legal & accounting services,-2150,55553426.76
05/19/2023,Expense,Inventus Law,"INVENTUS LAW, PC",Account1,2150,55555576.76
05/19/2023,Expense,Inventus Law,"INVENTUS LAW, PC",Legal & accounting services,-2150,55553426.76
05/19/2023,Expense,Lenny Rachitsky,Mike ross,Credit Card - Ramp,150,55553576.76
05/20/2023,Expense,RAMP BUSINESS CO,RAMP STATEMENT,Account1,-4155.22,55549421.54
05/20/2023,Expense,RAMP BUSINESS CO,RAMP STATEMENT,Credit Card - Ramp,-4155.22,55545266.32
05/20/2023,Expense,RAMP BUSINESS CO,RAMP STATEMENT,Credit Card - Ramp,-4155.22,55541111.1
05/20/2023,Expense,Dubai Taxi,Harvey Spector,Credit Card - Ramp,13.75,55541124.85
05/20/2023,Expense,RAMP BUSINESS CO,RAMP STATEMENT,Account1,-4155.22,55536969.63
05/20/2023,Expense,RAMP BUSINESS CO,RAMP STATEMENT,Account1,-4155.22,55532814.41
05/20/2023,Expense,Dubai Taxi,,Travelling Expenses,13.75,55532828.16
05/20/2023,Expense,Dubai Taxi,Harvey Spector,Credit Card - Ramp,13.75,55532841.91
05/20/2023,Expense,Dubai Taxi,,Travelling Expenses,13.75,55532855.66
05/20/2023,Expense,RAMP BUSINESS CO,RAMP STATEMENT,Account1,-4155.22,55528700.44
05/20/2023,Expense,RAMP BUSINESS CO,RAMP STATEMENT,Credit Card - Ramp,-4155.22,55524545.22
05/20/2023,Expense,RAMP BUSINESS CO,RAMP STATEMENT,Credit Card - Ramp,-4155.22,55520390
05/20/2023,Expense,Dubai Taxi,Harvey Spector,Credit Card - Ramp,13.75,55520403.75
05/20/2023,Expense,Dubai Taxi,,Travelling Expenses,13.75,55520417.5
05/20/2023,Expense,Dubai Taxi,,Travelling Expenses,13.75,55520431.25
05/22/2023,Expense,Archie's All Day,Mike ross,Meals & Entertainment,39.24,55520470.49
05/22/2023,Expense,Dovetail,,Tools & Subscription - G&A,70,55520540.49
05/22/2023,Expense,Uber,,Travelling Expenses,41.38,55520581.87
05/22/2023,Expense,Dovetail,,Tools & Subscription - G&A,70,55520651.87
05/22/2023,Expense,Uber,Mike ross,Credit Card - Ramp,41.38,55520693.25
05/22/2023,Expense,Uber,Mike ross,Credit Card - Ramp,22.8,55520716.05
05/22/2023,Expense,Uber,,Travelling Expenses,41.38,55520757.43
05/22/2023,Expense,Dovetail,,Tools & Subscription - G&A,70,55520827.43
05/22/2023,Expense,OpenAI,,Tools & Subscription - G&A,20,55520847.43
05/22/2023,Expense,Dovetail,Harvey Spector,Credit Card - Ramp,70,55520917.43
05/22/2023,Expense,OpenAI,,Tools & Subscription - G&A,20,55520937.43
05/22/2023,Expense,Uber,Mike ross,Credit Card - Ramp,22.8,55520960.23
05/22/2023,Expense,Dovetail,Harvey Spector,Credit Card - Ramp,70,55521030.23
05/22/2023,Expense,Notion Labs,Mike ross,Credit Card - Ramp,87.35,55521117.58
05/22/2023,Expense,OpenAI,Harvey Spector,Credit Card - Ramp,20,55521137.58
05/22/2023,Expense,Notion Labs,Mike ross,Credit Card - Ramp,87.35,55521224.93
05/22/2023,Expense,Archie's All Day,Mike ross,Credit Card - Ramp,39.24,55521264.17
05/22/2023,Expense,Archie's All Day,Mike ross,Credit Card - Ramp,39.24,55521303.41
05/22/2023,Expense,OpenAI,Harvey Spector,Credit Card - Ramp,20,55521323.41
05/22/2023,Expense,Uber,,Travelling Expenses,22.8,55521346.21
05/22/2023,Expense,Uber,,Travelling Expenses,22.8,55521369.01
05/22/2023,Expense,OpenAI,Harvey Spector,Credit Card - Ramp,20,55521389.01
05/22/2023,Expense,Notion Labs,Mike ross,Credit Card - Ramp,87.35,55521476.36
05/22/2023,Expense,Archie's All Day,Mike ross,Meals & Entertainment,39.24,55521515.6
05/22/2023,Expense,Archie's All Day,Mike ross,Meals & Entertainment,39.24,55521554.84
05/22/2023,Expense,OpenAI,,Tools & Subscription - G&A,20,55521574.84
05/22/2023,Expense,Dovetail,,Tools & Subscription - G&A,70,55521644.84
05/22/2023,Expense,Uber,,Travelling Expenses,41.38,55521686.22
05/22/2023,Expense,OpenAI,,Tools & Subscription - G&A,20,55521706.22
05/22/2023,Expense,Notion Labs,,Tools & Subscription - G&A,87.35,55521793.57
05/22/2023,Expense,Archie's All Day,Mike ross,Meals & Entertainment,39.24,55521832.81
05/22/2023,Expense,Uber,Mike ross,Credit Card - Ramp,22.8,55521855.61
05/22/2023,Expense,Uber,,Travelling Expenses,41.38,55521896.99
05/22/2023,Expense,Uber,Mike ross,Credit Card - Ramp,41.38,55521938.37
05/22/2023,Expense,Notion Labs,,Tools & Subscription - G&A,87.35,55522025.72
05/22/2023,Expense,Uber,,Travelling Expenses,22.8,55522048.52
05/22/2023,Expense,Archie's All Day,Mike ross,Credit Card - Ramp,39.24,55522087.76
05/22/2023,Expense,Uber,,Travelling Expenses,22.8,55522110.56
05/22/2023,Expense,Notion Labs,,Tools & Subscription - G&A,87.35,55522197.91
05/22/2023,Expense,Notion Labs,,Tools & Subscription - G&A,87.35,55522285.26
05/22/2023,Expense,Archie's All Day,Mike ross,Credit Card - Ramp,39.24,55522324.5
05/22/2023,Expense,Uber,Mike ross,Credit Card - Ramp,41.38,55522365.88
05/22/2023,Expense,Dovetail,Harvey Spector,Credit Card - Ramp,70,55522435.88
05/23/2023,Bill Payment (Check),Big Company ,,Accounts Payable (A/P),-9554,55512881.88
05/23/2023,Expense,InstaShop,Harvey Spector,Credit Card - Ramp,17.33,55512899.21
05/23/2023,Expense,Oti',Mike ross,Credit Card - Ramp,20.15,55512919.36
05/23/2023,Bill Payment (Check),Big Company ,,Account1,-9554,55503365.36
05/23/2023,Expense,Sendinblue,Balapavan Tirumani,Credit Card - Ramp,1.29,55503366.65
05/23/2023,Expense,Superhuman,Mike ross,Credit Card - Ramp,60,55503426.65
05/23/2023,Bill Payment (Check),Big Company ,,Accounts Payable (A/P),-9554,55493872.65
05/23/2023,Bill Payment (Check),Big Company ,,Accounts Payable (A/P),-9554,55484318.65
05/23/2023,Bill Payment (Check),Big Company ,,Account1,-9554,55474764.65
05/23/2023,Bill Payment (Check),Big Company ,,Account1,-9554,55465210.65
05/23/2023,Expense,InstaShop,,Meals & Entertainment,17.33,55465227.98
05/23/2023,Expense,Superhuman,Mike ross,Credit Card - Ramp,60,55465287.98
05/23/2023,Bill Payment (Check),Big Company ,,Account1,-9554,55455733.98
05/23/2023,Expense,Sendinblue,,Tools & Subscription - G&A,1.29,55455735.27
05/23/2023,Expense,InstaShop,,Meals & Entertainment,17.33,55455752.6
05/23/2023,Expense,Super,Harvey Spector,Credit Card - Ramp,12,55455764.6
05/23/2023,Expense,InstaShop,Harvey Spector,Credit Card - Ramp,17.33,55455781.93
05/23/2023,Expense,Oti',Mike ross,Credit Card - Ramp,20.15,55455802.08
05/23/2023,Expense,Sendinblue,,Tools & Subscription - G&A,1.29,55455803.37
05/23/2023,Expense,Superhuman,Mike ross,Credit Card - Ramp,60,55455863.37
05/23/2023,Expense,Sendinblue,,Tools & Subscription - G&A,1.29,55455864.66
05/23/2023,Bill Payment (Check),Big Company ,,Accounts Payable (A/P),-9554,55446310.66
05/23/2023,Expense,Sendinblue,Balapavan Tirumani,Credit Card - Ramp,1.29,55446311.95
05/23/2023,Expense,Super,,Tools & Subscription - G&A,12,55446323.95
05/23/2023,Expense,Oti',,Meals & Entertainment,20.15,55446344.1
05/23/2023,Expense,Super,,Tools & Subscription - G&A,12,55446356.1
05/23/2023,Expense,Superhuman,,Professional Service Charges,60,55446416.1
05/23/2023,Expense,Oti',,Meals & Entertainment,20.15,55446436.25
05/23/2023,Expense,Superhuman,Mike ross,Credit Card - Ramp,60,55446496.25
05/23/2023,Expense,Super,Harvey Spector,Credit Card - Ramp,12,55446508.25
05/23/2023,Expense,Oti',,Meals & Entertainment,20.15,55446528.4
05/23/2023,Expense,Superhuman,,Professional Service Charges,60,55446588.4
05/23/2023,Expense,Super,,Tools & Subscription - G&A,12,55446600.4
05/23/2023,Expense,InstaShop,,Meals & Entertainment,17.33,55446617.73
05/23/2023,Expense,InstaShop,,Meals & Entertainment,17.33,55446635.06
05/23/2023,Expense,Super,Harvey Spector,Credit Card - Ramp,12,55446647.06
05/23/2023,Expense,Oti',Mike ross,Credit Card - Ramp,20.15,55446667.21
05/23/2023,Expense,InstaShop,Harvey Spector,Credit Card - Ramp,17.33,55446684.54
05/23/2023,Expense,InstaShop,Harvey Spector,Credit Card - Ramp,17.33,55446701.87
05/23/2023,Expense,Superhuman,,Professional Service Charges,60,55446761.87
05/23/2023,Expense,Oti',,Meals & Entertainment,20.15,55446782.02
05/23/2023,Expense,Oti',Mike ross,Credit Card - Ramp,20.15,55446802.17
05/23/2023,Expense,Sendinblue,Balapavan Tirumani,Credit Card - Ramp,1.29,55446803.46
05/23/2023,Expense,Super,,Tools & Subscription - G&A,12,55446815.46
05/23/2023,Expense,Superhuman,,Professional Service Charges,60,55446875.46
05/23/2023,Expense,Sendinblue,,Tools & Subscription - G&A,1.29,55446876.75
05/24/2023,Expense,Benedict Evans,Harvey Spector,Professional Service Charges,10,55446886.75
05/24/2023,Deposit,zamp finance,Zamp Finance,Account1,-10,55446876.75
05/24/2023,Expense,Uber,Mike ross,Credit Card - Ramp,14.98,55446891.73
05/24/2023,Expense,Uber,,Travelling Expenses,14.98,55446906.71
05/24/2023,Expense,Uber,,Travelling Expenses,14.98,55446921.69
05/24/2023,Expense,Benedict Evans,Harvey Spector,Professional Service Charges,10,55446931.69
05/24/2023,Expense,Joga,Harvey Spector,Meals & Entertainment,18.8,55446950.49
05/24/2023,Expense,Joga,Harvey Spector,Meals & Entertainment,18.8,55446969.29
05/24/2023,Expense,zamp finance,Zamp Finance,Account1,10,55446979.29
05/24/2023,Expense,Benedict Evans,Harvey Spector,Credit Card - Ramp,10,55446989.29
05/24/2023,Expense,Benedict Evans,Harvey Spector,Credit Card - Ramp,10,55446999.29
05/24/2023,Deposit,zamp finance,Zamp Finance,Account1,-10,55446989.29
05/24/2023,Expense,zamp finance,Zamp Finance,Zamp Investments - Other,-10,55446979.29
05/24/2023,Deposit,zamp finance,Zamp Finance,Zamp Investments - Other,10,55446989.29
05/24/2023,Expense,Joga,Harvey Spector,Credit Card - Ramp,18.8,55447008.09
05/24/2023,Expense,zamp finance,Zamp Finance,Zamp Investments - Other,-10,55446998.09
05/24/2023,Expense,Uber,Mike ross,Credit Card - Ramp,14.98,55447013.07
05/24/2023,Expense,Uber,,Travelling Expenses,14.98,55447028.05
05/24/2023,Expense,Joga,Harvey Spector,Credit Card - Ramp,18.8,55447046.85
05/24/2023,Expense,Joga,Harvey Spector,Meals & Entertainment,18.8,55447065.65
05/24/2023,Expense,zamp finance,Zamp Finance,Account1,10,55447075.65
05/24/2023,Expense,Benedict Evans,Harvey Spector,Credit Card - Ramp,10,55447085.65
05/24/2023,Deposit,zamp finance,Zamp Finance,Zamp Investments - Other,10,55447095.65
05/24/2023,Expense,Benedict Evans,Harvey Spector,Credit Card - Ramp,10,55447105.65
05/24/2023,Expense,Joga,Harvey Spector,Credit Card - Ramp,18.8,55447124.45
05/24/2023,Expense,Uber,Mike ross,Credit Card - Ramp,14.98,55447139.43
05/24/2023,Expense,Benedict Evans,Harvey Spector,Professional Service Charges,10,55447149.43
05/24/2023,Expense,zamp finance,Zamp Finance,Account1,10,55447159.43
05/24/2023,Expense,zamp finance,Zamp Finance,Zamp Investments - Other,-10,55447149.43
05/24/2023,Expense,Joga,Harvey Spector,Meals & Entertainment,18.8,55447168.23
05/24/2023,Expense,zamp finance,Zamp Finance,Zamp Investments - Other,-10,55447158.23
05/24/2023,Deposit,zamp finance,Zamp Finance,Zamp Investments - Other,10,55447168.23
05/24/2023,Deposit,zamp finance,Zamp Finance,Account1,-10,55447158.23
05/24/2023,Deposit,zamp finance,Zamp Finance,Account1,-10,55447148.23
05/24/2023,Expense,Benedict Evans,Harvey Spector,Professional Service Charges,10,55447158.23
05/24/2023,Expense,zamp finance,Zamp Finance,Account1,10,55447168.23
05/24/2023,Deposit,zamp finance,Zamp Finance,Zamp Investments - Other,10,55447178.23
05/24/2023,Expense,Joga,Harvey Spector,Credit Card - Ramp,18.8,55447197.03
05/24/2023,Expense,Uber,,Travelling Expenses,14.98,55447212.01
05/25/2023,Expense,Miro,,Tools & Subscription - G&A,107.54,55447319.55
05/25/2023,Expense,Cycle App License,,Tools & Subscription - G&A,220,55447539.55
05/25/2023,Expense,Zoom,Chad Blumenthal,Credit Card - Ramp,15.99,55447555.54
05/25/2023,Expense,Cycle App License,Chad Blumenthal,Credit Card - Ramp,220,55447775.54
05/25/2023,Expense,Zoom,Chad Blumenthal,Credit Card - Ramp,15.99,55447791.53
05/25/2023,Expense,Zoom,Chad Blumenthal,Credit Card - Ramp,15.99,55447807.52
05/25/2023,Expense,Miro,,Tools & Subscription - G&A,107.54,55447915.06
05/25/2023,Expense,Zoom,,Tools & Subscription - G&A,15.99,55447931.05
05/25/2023,Expense,Zoom,,Tools & Subscription - G&A,15.99,55447947.04
05/25/2023,Expense,Cycle App License,,Tools & Subscription - G&A,220,55448167.04
05/25/2023,Expense,Sang by Mabasa,Mike ross,Meals & Entertainment,51.23,55448218.27
05/25/2023,Expense,Zoom,,Tools & Subscription - G&A,15.99,55448234.26
05/25/2023,Expense,Sang by Mabasa,Mike ross,Credit Card - Ramp,51.23,55448285.49
05/25/2023,Expense,Zoom,,Tools & Subscription - G&A,15.99,55448301.48
05/25/2023,Expense,Miro,Mike ross,Credit Card - Ramp,107.54,55448409.02
05/25/2023,Expense,Miro,,Tools & Subscription - G&A,107.54,55448516.56
05/25/2023,Expense,Sang by Mabasa,Mike ross,Credit Card - Ramp,51.23,55448567.79
05/25/2023,Expense,Sang by Mabasa,Mike ross,Meals & Entertainment,51.23,55448619.02
05/25/2023,Expense,Cycle App License,,Tools & Subscription - G&A,220,55448839.02
05/25/2023,Expense,Sang by Mabasa,Mike ross,Credit Card - Ramp,51.23,55448890.25
05/25/2023,Expense,Cycle App License,Chad Blumenthal,Credit Card - Ramp,220,55449110.25
05/25/2023,Expense,Cycle App License,Chad Blumenthal,Credit Card - Ramp,220,55449330.25
05/25/2023,Expense,Miro,Mike ross,Credit Card - Ramp,107.54,55449437.79
05/25/2023,Expense,Miro,Mike ross,Credit Card - Ramp,107.54,55449545.33
05/25/2023,Expense,Miro,,Tools & Subscription - G&A,107.54,55449652.87
05/25/2023,Expense,Sang by Mabasa,Mike ross,Credit Card - Ramp,51.23,55449704.1
05/25/2023,Expense,Sang by Mabasa,Mike ross,Meals & Entertainment,51.23,55449755.33
05/25/2023,Expense,Sang by Mabasa,Mike ross,Meals & Entertainment,51.23,55449806.56
05/25/2023,Expense,Cycle App License,,Tools & Subscription - G&A,220,55450026.56
05/26/2023,Expense,Semi Permanent,Mike ross,Professional Service Charges,455.76,55450482.32
05/26/2023,Expense,Semi Permanent,Mike ross,Professional Service Charges,455.76,55450938.08
05/26/2023,Expense,Careem,,Travelling Expenses,9.22,55450947.3
05/26/2023,Expense,Man-made,Harvey Spector,Professional Service Charges,19,55450966.3
05/26/2023,Expense,Careem,,Travelling Expenses,9.22,55450975.52
05/26/2023,Expense,Careem,,Travelling Expenses,9.22,55450984.74
05/26/2023,Expense,Man-made,Harvey Spector,Professional Service Charges,19,55451003.74
05/26/2023,Expense,Man-made,Harvey Spector,Credit Card - Ramp,19,55451022.74
05/26/2023,Expense,Semi Permanent,Mike ross,Professional Service Charges,455.76,55451478.5
05/26/2023,Expense,Man-made,Harvey Spector,Professional Service Charges,19,55451497.5
05/26/2023,Expense,Semi Permanent,Mike ross,Credit Card - Ramp,455.76,55451953.26
05/26/2023,Expense,Careem,Harvey Spector,Credit Card - Ramp,9.22,55451962.48
05/26/2023,Expense,Man-made,Harvey Spector,Credit Card - Ramp,19,55451981.48
05/26/2023,Expense,Semi Permanent,Mike ross,Credit Card - Ramp,455.76,55452437.24
05/26/2023,Expense,Careem,Harvey Spector,Credit Card - Ramp,9.22,55452446.46
05/26/2023,Expense,Man-made,Harvey Spector,Credit Card - Ramp,19,55452465.46
05/26/2023,Expense,Careem,,Travelling Expenses,9.22,55452474.68
05/26/2023,Expense,Semi Permanent,Mike ross,Professional Service Charges,455.76,55452930.44
05/26/2023,Expense,Semi Permanent,Mike ross,Credit Card - Ramp,455.76,55453386.2
05/26/2023,Expense,Man-made,Harvey Spector,Credit Card - Ramp,19,55453405.2
05/26/2023,Expense,Careem,Harvey Spector,Credit Card - Ramp,9.22,55453414.42
05/26/2023,Expense,Semi Permanent,Mike ross,Credit Card - Ramp,455.76,55453870.18
05/26/2023,Expense,Man-made,Harvey Spector,Professional Service Charges,19,55453889.18
05/27/2023,Expense,Splitbee,,Tools & Subscription - G&A,16.52,55453905.7
05/27/2023,Expense,Sentry,,Tools & Subscription - G&A,29,55453934.7
05/27/2023,Expense,Sendinblue,Balapavan Tirumani,Credit Card - Ramp,88.27,55454022.97
05/27/2023,Expense,Sendinblue,Balapavan Tirumani,Credit Card - Ramp,88.27,55454111.24
05/27/2023,Expense,Sentry,Balapavan Tirumani,Credit Card - Ramp,29,55454140.24
05/27/2023,Expense,Splitbee,Harris Jose,Credit Card - Ramp,16.52,55454156.76
05/27/2023,Expense,Sentry,Balapavan Tirumani,Credit Card - Ramp,29,55454185.76
05/27/2023,Expense,Sendinblue,,Tools & Subscription - G&A,88.27,55454274.03
05/27/2023,Expense,Sendinblue,,Tools & Subscription - G&A,88.27,55454362.3
05/27/2023,Expense,Sentry,,Tools & Subscription - G&A,29,55454391.3
05/27/2023,Expense,Sentry,,Tools & Subscription - G&A,29,55454420.3
05/27/2023,Expense,Splitbee,Harris Jose,Credit Card - Ramp,16.52,55454436.82
05/27/2023,Expense,Splitbee,,Tools & Subscription - G&A,16.52,55454453.34
05/27/2023,Expense,Sentry,Balapavan Tirumani,Credit Card - Ramp,29,55454482.34
05/27/2023,Expense,Splitbee,,Tools & Subscription - G&A,16.52,55454498.86
05/27/2023,Expense,Sendinblue,Balapavan Tirumani,Credit Card - Ramp,88.27,55454587.13
05/27/2023,Expense,Sentry,,Tools & Subscription - G&A,29,55454616.13
05/27/2023,Expense,Splitbee,,Tools & Subscription - G&A,16.52,55454632.65
05/27/2023,Expense,Sendinblue,,Tools & Subscription - G&A,88.27,55454720.92
05/27/2023,Expense,Splitbee,Harris Jose,Credit Card - Ramp,16.52,55454737.44
05/27/2023,Expense,Sendinblue,,Tools & Subscription - G&A,88.27,55454825.71
05/28/2023,Expense,Github,Balapavan Tirumani,Credit Card - Ramp,44,55454869.71
05/28/2023,Expense,Github,Balapavan Tirumani,Credit Card - Ramp,44,55454913.71
05/28/2023,Expense,Github,Balapavan Tirumani,Credit Card - Ramp,44,55454957.71
05/28/2023,Expense,Github,Balapavan Tirumani,Credit Card - Ramp,10,55454967.71
05/28/2023,Expense,Github,,Tools & Subscription - G&A,10,55454977.71
05/28/2023,Expense,Github,Balapavan Tirumani,Credit Card - Ramp,10,55454987.71
05/28/2023,Expense,Github,,Tools & Subscription - G&A,44,55455031.71
05/28/2023,Expense,Github,,Tools & Subscription - G&A,10,55455041.71
05/28/2023,Expense,Github,,Tools & Subscription - G&A,44,55455085.71
05/28/2023,Expense,Github,,Tools & Subscription - G&A,10,55455095.71
05/28/2023,Expense,Github,,Tools & Subscription - G&A,44,55455139.71
05/28/2023,Expense,Github,,Tools & Subscription - G&A,10,55455149.71
05/28/2023,Expense,Github,Balapavan Tirumani,Credit Card - Ramp,10,55455159.71
05/28/2023,Expense,Github,,Tools & Subscription - G&A,44,55455203.71
05/29/2023,Expense,Netlify,,Tools & Subscription - G&A,19,55455222.71
05/29/2023,Expense,SLANT System,,Tools & Subscription - G&A,49,55455271.71
05/29/2023,Expense,Netlify,Balapavan Tirumani,Credit Card - Ramp,19,55455290.71
05/29/2023,Expense,SLANT System,,Tools & Subscription - G&A,49,55455339.71
05/29/2023,Expense,Lucky Pickle Dumpling Co,Mike ross,Meals & Entertainment,21.86,55455361.57
05/29/2023,Expense,Netlify,,Tools & Subscription - G&A,19,55455380.57
05/29/2023,Expense,Lucky Pickle Dumpling Co,Mike ross,Credit Card - Ramp,21.86,55455402.43
05/29/2023,Expense,Lucky Pickle Dumpling Co,Mike ross,Meals & Entertainment,21.86,55455424.29
05/29/2023,Expense,Lucky Pickle Dumpling Co,Mike ross,Meals & Entertainment,21.86,55455446.15
05/29/2023,Expense,Netlify,,Tools & Subscription - G&A,19,55455465.15
05/29/2023,Expense,Lucky Pickle Dumpling Co,Mike ross,Credit Card - Ramp,21.86,55455487.01
05/29/2023,Expense,Lucky Pickle Dumpling Co,Mike ross,Credit Card - Ramp,21.86,55455508.87
05/29/2023,Expense,Lucky Pickle Dumpling Co,Mike ross,Meals & Entertainment,21.86,55455530.73
05/29/2023,Expense,Netlify,Balapavan Tirumani,Credit Card - Ramp,19,55455549.73
05/29/2023,Expense,Lucky Pickle Dumpling Co,Mike ross,Credit Card - Ramp,21.86,55455571.59
05/29/2023,Expense,SLANT System,Pradeep Kumar,Credit Card - Ramp,49,55455620.59
05/29/2023,Expense,SLANT System,Pradeep Kumar,Credit Card - Ramp,49,55455669.59
05/29/2023,Expense,SLANT System,,Tools & Subscription - G&A,49,55455718.59
05/29/2023,Expense,SLANT System,,Tools & Subscription - G&A,49,55455767.59
05/29/2023,Expense,Netlify,,Tools & Subscription - G&A,19,55455786.59
05/29/2023,Expense,Netlify,Balapavan Tirumani,Credit Card - Ramp,19,55455805.59
05/29/2023,Expense,SLANT System,Pradeep Kumar,Credit Card - Ramp,49,55455854.59
05/30/2023,Expense,Semi Permanent,Mike ross,Credit Card - Ramp,227.74,55456082.33
05/30/2023,Expense,Rocket Sports Internet,Harvey Spector,Credit Card - Ramp,30,55456112.33
05/30/2023,Expense,Rocket Sports Internet,Harvey Spector,Office expenses:Office supplies,30,55456142.33
05/30/2023,Expense,The Carrington,,Meals & Entertainment,24.51,55456166.84
05/30/2023,Expense,Semi Permanent,Mike ross,Professional Service Charges,227.74,55456394.58
05/30/2023,Expense,The Carrington,,Meals & Entertainment,24.51,55456419.09
05/30/2023,Expense,Medium,Mike ross,Credit Card - Ramp,50,55456469.09
05/30/2023,Expense,Medium,,General business expenses:Memberships & subscriptions,50,55456519.09
05/30/2023,Expense,The Carrington,Mike ross,Credit Card - Ramp,24.51,55456543.6
05/30/2023,Expense,Medium,Mike ross,Credit Card - Ramp,50,55456593.6
05/30/2023,Expense,Medium,Mike ross,Credit Card - Ramp,50,55456643.6
05/30/2023,Expense,Rocket Sports Internet,Harvey Spector,Credit Card - Ramp,30,55456673.6
05/30/2023,Expense,The Carrington,Mike ross,Credit Card - Ramp,24.51,55456698.11
05/30/2023,Expense,Rocket Sports Internet,Harvey Spector,Credit Card - Ramp,30,55456728.11
05/30/2023,Expense,Medium,,General business expenses:Memberships & subscriptions,50,55456778.11
05/30/2023,Expense,Semi Permanent,Mike ross,Professional Service Charges,227.74,55457005.85
05/30/2023,Expense,Semi Permanent,Mike ross,Credit Card - Ramp,227.74,55457233.59
05/30/2023,Expense,Rocket Sports Internet,Harvey Spector,Office expenses:Office supplies,30,55457263.59
05/30/2023,Expense,The Carrington,Mike ross,Credit Card - Ramp,24.51,55457288.1
05/30/2023,Expense,Semi Permanent,Mike ross,Professional Service Charges,227.74,55457515.84
05/30/2023,Expense,The Carrington,,Meals & Entertainment,24.51,55457540.35
05/30/2023,Expense,Rocket Sports Internet,Harvey Spector,Office expenses:Office supplies,30,55457570.35
05/30/2023,Expense,Rocket Sports Internet,Harvey Spector,Credit Card - Ramp,30,55457600.35
05/30/2023,Expense,Semi Permanent,Mike ross,Professional Service Charges,227.74,55457828.09
05/30/2023,Expense,The Carrington,Mike ross,Credit Card - Ramp,24.51,55457852.6
05/30/2023,Expense,Medium,,General business expenses:Memberships & subscriptions,50,55457902.6
05/30/2023,Expense,Rocket Sports Internet,Harvey Spector,Office expenses:Office supplies,30,55457932.6
05/30/2023,Expense,Medium,Mike ross,Credit Card - Ramp,50,55457982.6
05/30/2023,Expense,Semi Permanent,Mike ross,Credit Card - Ramp,227.74,55458210.34
05/30/2023,Expense,Semi Permanent,Mike ross,Credit Card - Ramp,227.74,55458438.08
05/30/2023,Expense,Medium,,General business expenses:Memberships & subscriptions,50,55458488.08
05/30/2023,Expense,The Carrington,,Meals & Entertainment,24.51,55458512.59
05/31/2023,Bill,Big Company ,,Outsources Services - India,27535.19,55486047.78
05/31/2023,Expense,Adobe,Mike ross,Credit Card - Ramp,14.86,55486062.64
05/31/2023,Expense,Meggykenny Pty Ltd,Mike ross,Meals & Entertainment,40.27,55486102.91
05/31/2023,Expense,Meggykenny Pty Ltd,Mike ross,Credit Card - Ramp,40.27,55486143.18
05/31/2023,Expense,Lenny Rachitsky,Harvey Spector,Credit Card - Ramp,150,55486293.18
05/31/2023,Expense,Adobe,,Tools & Subscription - S&M,14.86,55486308.04
05/31/2023,Expense,Adobe,Mike ross,Credit Card - Ramp,14.86,55486322.9
05/31/2023,Expense,Lenny Rachitsky,Harvey Spector,Credit Card - Ramp,150,55486472.9
05/31/2023,Expense,Meggykenny Pty Ltd,Mike ross,Credit Card - Ramp,40.27,55486513.17
05/31/2023,Bill,Big Company ,,Outsources Services - India,27535.19,55514048.36
05/31/2023,Expense,Lenny Rachitsky,,General business expenses:Memberships & subscriptions,150,55514198.36
05/31/2023,Expense,Adobe,,Tools & Subscription - S&M,14.86,55514213.22
05/31/2023,Expense,Meggykenny Pty Ltd,Mike ross,Meals & Entertainment,40.27,55514253.49
05/31/2023,Expense,Uber,,Travelling Expenses,12.57,55514266.06
05/31/2023,Expense,Lenny Rachitsky,,General business expenses:Memberships & subscriptions,150,55514416.06
05/31/2023,Expense,Meggykenny Pty Ltd,Mike ross,Meals & Entertainment,40.27,55514456.33
05/31/2023,Bill,Big Company ,"Service Expenses for the month of May 2023 
INR     22,76,607      @   82.680",Accounts Payable (A/P),27535.19,55541991.52
05/31/2023,Expense,Adobe,,Tools & Subscription - S&M,14.86,55542006.38
05/31/2023,Bill,Big Company ,"Service Expenses for the month of May 2023 
INR     22,76,607      @   82.680",Accounts Payable (A/P),27535.19,55569541.57
05/31/2023,Expense,Lenny Rachitsky,,General business expenses:Memberships & subscriptions,150,55569691.57
05/31/2023,Bill,Big Company ,"Service Expenses for the month of May 2023 
INR     22,76,607      @   82.680",Accounts Payable (A/P),27535.19,55597226.76
05/31/2023,Expense,Uber,Mike ross,Credit Card - Ramp,12.57,55597239.33
05/31/2023,Expense,Uber,Mike ross,Credit Card - Ramp,12.57,55597251.9
05/31/2023,Bill,Big Company ,,Outsources Services - India,27535.19,55624787.09
05/31/2023,Expense,Lenny Rachitsky,Harvey Spector,Credit Card - Ramp,150,55624937.09
05/31/2023,Bill,Big Company ,"Service Expenses for the month of May 2023 
INR     22,76,607      @   82.680",Accounts Payable (A/P),27535.19,55652472.28
05/31/2023,Expense,Meggykenny Pty Ltd,Mike ross,Credit Card - Ramp,40.27,55652512.55
05/31/2023,Expense,Uber,,Travelling Expenses,12.57,55652525.12
05/31/2023,Expense,Lenny Rachitsky,,General business expenses:Memberships & subscriptions,150,55652675.12
05/31/2023,Expense,Lenny Rachitsky,Harvey Spector,Credit Card - Ramp,150,55652825.12
05/31/2023,Expense,Meggykenny Pty Ltd,Mike ross,Meals & Entertainment,40.27,55652865.39
05/31/2023,Expense,Uber,,Travelling Expenses,12.57,55652877.96
05/31/2023,Expense,Uber,Mike ross,Credit Card - Ramp,12.57,55652890.53
05/31/2023,Expense,Adobe,,Tools & Subscription - S&M,14.86,55652905.39
05/31/2023,Expense,Adobe,Mike ross,Credit Card - Ramp,14.86,55652920.25
05/31/2023,Bill,Big Company ,,Outsources Services - India,27535.19,55680455.44
05/31/2023,Expense,Meggykenny Pty Ltd,Mike ross,Credit Card - Ramp,40.27,55680495.71
05/31/2023,Expense,Uber,,Travelling Expenses,12.57,55680508.28
06/01/2023,Expense,Render,Balapavan Tirumani,Credit Card - Ramp,232.46,55680740.74
06/01/2023,Expense,zamp finance,Zamp Finance,Account1,50,55680790.74
06/01/2023,Expense,Render,Balapavan Tirumani,Credit Card - Ramp,232.46,55681023.2
06/01/2023,Expense,zamp finance,Zamp Finance,Account1,50,55681073.2
06/01/2023,Expense,Google G Suite,,Tools & Subscription - G&A,126.76,55681199.96
06/01/2023,Expense,Render,,Tools & Subscription - G&A,232.46,55681432.42
06/01/2023,Expense,Google G Suite,Mike ross,Credit Card - Ramp,126.76,55681559.18
06/01/2023,Expense,Google G Suite,,Tools & Subscription - G&A,126.76,55681685.94
06/01/2023,Expense,zamp finance,Zamp Finance,Zamp Investments - Other,-50,55681635.94
06/01/2023,Expense,Render,,Tools & Subscription - G&A,232.46,55681868.4
06/01/2023,Expense,zamp finance,Zamp Finance,Account1,50,55681918.4
06/01/2023,Expense,Google G Suite,,Tools & Subscription - G&A,126.76,55682045.16
06/01/2023,Expense,Render,,Tools & Subscription - G&A,232.46,55682277.62
06/01/2023,Expense,zamp finance,Zamp Finance,Zamp Investments - Other,-50,55682227.62
06/01/2023,Expense,Render,Balapavan Tirumani,Credit Card - Ramp,232.46,55682460.08
06/01/2023,Expense,Render,,Tools & Subscription - G&A,232.46,55682692.54
06/01/2023,Expense,Google G Suite,,Tools & Subscription - G&A,126.76,55682819.3
06/01/2023,Expense,zamp finance,Zamp Finance,Zamp Investments - Other,-50,55682769.3
06/01/2023,Expense,zamp finance,Zamp Finance,Account1,50,55682819.3
06/01/2023,Expense,zamp finance,Zamp Finance,Zamp Investments - Other,-50,55682769.3
06/01/2023,Expense,Google G Suite,Mike ross,Credit Card - Ramp,126.76,55682896.06
06/01/2023,Expense,Google G Suite,Mike ross,Credit Card - Ramp,126.76,55683022.82
06/02/2023,Expense,Perimeter Books,Mike ross,Credit Card - Ramp,71.2,55683094.02
06/02/2023,Expense,Perimeter Books,Mike ross,Credit Card - Ramp,71.2,55683165.22
06/02/2023,Expense,Comfy Shrooms,Mike ross,Office expenses,13.57,55683178.79
06/02/2023,Expense,Cohab Coffee,Mike ross,Meals & Entertainment,12.21,55683191
06/02/2023,Deposit,,Interest Accrual INTEREST,Interest Received,4.15,55683195.15
06/02/2023,Expense,June,Balapavan Tirumani,Credit Card - Ramp,254,55683449.15
06/02/2023,Expense,June,Balapavan Tirumani,Credit Card - Ramp,254,55683703.15
06/02/2023,Expense,Formist,Mike ross,Credit Card - Ramp,47.47,55683750.62
06/02/2023,Expense,Cohab Coffee,Mike ross,Credit Card - Ramp,12.21,55683762.83
06/02/2023,Expense,Comfy Shrooms,Mike ross,Office expenses,13.57,55683776.4
06/02/2023,Expense,Perimeter Books,,General business expenses:Memberships & subscriptions,71.2,55683847.6
06/02/2023,Deposit,,Interest Accrual INTEREST,Interest Received,4.15,55683851.75
06/02/2023,Expense,Perimeter Books,,General business expenses:Memberships & subscriptions,71.2,55683922.95
06/02/2023,Expense,Cohab Coffee,Mike ross,Meals & Entertainment,12.21,55683935.16
06/02/2023,Expense,Perimeter Books,,General business expenses:Memberships & subscriptions,71.2,55684006.36
06/02/2023,Expense,Comfy Shrooms,Mike ross,Office expenses,13.57,55684019.93
06/02/2023,Expense,Cohab Coffee,Mike ross,Meals & Entertainment,12.21,55684032.14
06/02/2023,Expense,Formist,Mike ross,Office expenses:Office supplies,47.47,55684079.61
06/02/2023,Expense,Perimeter Books,Mike ross,Credit Card - Ramp,71.2,55684150.81
06/02/2023,Expense,Comfy Shrooms,Mike ross,Credit Card - Ramp,13.57,55684164.38
06/02/2023,Expense,Formist,Mike ross,Credit Card - Ramp,47.47,55684211.85
06/02/2023,Expense,Perimeter Books,Mike ross,Credit Card - Ramp,71.2,55684283.05
06/02/2023,Deposit,,Interest Accrual INTEREST,Interest Received,4.15,55684287.2
06/02/2023,Expense,Formist,Mike ross,Office expenses:Office supplies,47.47,55684334.67
06/02/2023,Expense,Perimeter Books,,General business expenses:Memberships & subscriptions,71.2,55684405.87
06/02/2023,Expense,June,,Tools & Subscription - G&A,254,55684659.87
06/02/2023,Expense,Formist,Mike ross,Office expenses:Office supplies,47.47,55684707.34
06/02/2023,Expense,June,,Tools & Subscription - G&A,254,55684961.34
06/02/2023,Expense,Cohab Coffee,Mike ross,Credit Card - Ramp,12.21,55684973.55
06/02/2023,Expense,Perimeter Books,,General business expenses:Memberships & subscriptions,71.2,55685044.75
06/02/2023,Expense,Formist,Mike ross,Office expenses:Office supplies,47.47,55685092.22
06/02/2023,Expense,Perimeter Books,,General business expenses:Memberships & subscriptions,71.2,55685163.42
06/02/2023,Deposit,,Interest Accrual INTEREST,Interest Received,4.15,55685167.57
06/02/2023,Expense,Comfy Shrooms,Mike ross,Office expenses,13.57,55685181.14
06/02/2023,Expense,Cohab Coffee,Mike ross,Meals & Entertainment,12.21,55685193.35
06/02/2023,Expense,June,,Tools & Subscription - G&A,254,55685447.35
06/02/2023,Expense,Perimeter Books,,General business expenses:Memberships & subscriptions,71.2,55685518.55
06/02/2023,Expense,Cohab Coffee,Mike ross,Credit Card - Ramp,12.21,55685530.76
06/02/2023,Expense,Formist,Mike ross,Credit Card - Ramp,47.47,55685578.23
06/02/2023,Deposit,,Interest Accrual INTEREST,Savings (6977),4.15,55685582.38
06/02/2023,Deposit,,Interest Accrual INTEREST,Savings (6977),4.15,55685586.53
06/02/2023,Expense,Perimeter Books,,General business expenses:Memberships & subscriptions,71.2,55685657.73
06/02/2023,Expense,Perimeter Books,Mike ross,Credit Card - Ramp,71.2,55685728.93
06/02/2023,Expense,Comfy Shrooms,Mike ross,Credit Card - Ramp,13.57,55685742.5
06/02/2023,Expense,June,,Tools & Subscription - G&A,254,55685996.5
06/02/2023,Expense,Comfy Shrooms,Mike ross,Credit Card - Ramp,13.57,55686010.07
06/02/2023,Expense,Formist,Mike ross,Credit Card - Ramp,47.47,55686057.54
06/02/2023,Deposit,,Interest Accrual INTEREST,Savings (6977),4.15,55686061.69
06/02/2023,Expense,Cohab Coffee,Mike ross,Credit Card - Ramp,12.21,55686073.9
06/02/2023,Expense,June,Balapavan Tirumani,Credit Card - Ramp,254,55686327.9
06/02/2023,Expense,Perimeter Books,Mike ross,Credit Card - Ramp,71.2,55686399.1
06/02/2023,Expense,Perimeter Books,Mike ross,Credit Card - Ramp,71.2,55686470.3
06/02/2023,Expense,Perimeter Books,Mike ross,Credit Card - Ramp,71.2,55686541.5
06/02/2023,Expense,Comfy Shrooms,Mike ross,Credit Card - Ramp,13.57,55686555.07
06/03/2023,Expense,Uber,Harvey Spector,Credit Card - Ramp,0.49,55686555.56
06/03/2023,Expense,Uber,Harvey Spector,Credit Card - Ramp,3.51,55686559.07
06/03/2023,Expense,VirtualPostMail,Harvey Spector,Credit Card - Ramp,35,55686594.07
06/03/2023,Expense,Uber,,Travelling Expenses,61.72,55686655.79
06/03/2023,Expense,Uber,,Travelling Expenses,3.51,55686659.3
06/03/2023,Expense,VirtualPostMail,,General business expenses:Memberships & subscriptions,35,55686694.3
06/03/2023,Expense,Uber,,Travelling Expenses,0.49,55686694.79
06/03/2023,Expense,VirtualPostMail,,General business expenses:Memberships & subscriptions,35,55686729.79
06/03/2023,Expense,VirtualPostMail,,General business expenses:Memberships & subscriptions,35,55686764.79
06/03/2023,Expense,Uber,,Travelling Expenses,0.49,55686765.28
06/03/2023,Expense,Uber,,Travelling Expenses,3.51,55686768.79
06/03/2023,Expense,Uber,Harvey Spector,Credit Card - Ramp,3.51,55686772.3
06/03/2023,Expense,Uber,,Travelling Expenses,61.72,55686834.02
06/03/2023,Expense,Uber,Mike ross,Credit Card - Ramp,61.72,55686895.74
06/03/2023,Expense,VirtualPostMail,Harvey Spector,Credit Card - Ramp,35,55686930.74
06/03/2023,Expense,Uber,,Travelling Expenses,0.49,55686931.23
06/03/2023,Expense,Uber,Mike ross,Credit Card - Ramp,61.72,55686992.95
06/03/2023,Expense,Uber,Harvey Spector,Credit Card - Ramp,3.51,55686996.46
06/03/2023,Expense,Uber,Mike ross,Credit Card - Ramp,61.72,55687058.18
06/03/2023,Expense,VirtualPostMail,Harvey Spector,Credit Card - Ramp,35,55687093.18
06/03/2023,Expense,VirtualPostMail,Harvey Spector,Credit Card - Ramp,35,55687128.18
06/03/2023,Expense,Uber,,Travelling Expenses,3.51,55687131.69
06/03/2023,Expense,VirtualPostMail,,General business expenses:Memberships & subscriptions,35,55687166.69
06/03/2023,Expense,Uber,,Travelling Expenses,0.49,55687167.18
06/03/2023,Expense,Uber,,Travelling Expenses,3.51,55687170.69
06/03/2023,Expense,Uber,Harvey Spector,Credit Card - Ramp,0.49,55687171.18
06/03/2023,Expense,Uber,,Travelling Expenses,61.72,55687232.9
06/03/2023,Expense,Uber,Harvey Spector,Credit Card - Ramp,0.49,55687233.39
06/03/2023,Expense,Uber,,Travelling Expenses,61.72,55687295.11
06/04/2023,Expense,Uber,,Travelling Expenses,12.23,55687307.34
06/04/2023,Expense,Uber,,Travelling Expenses,12.23,55687319.57
06/04/2023,Expense,Uber,,Travelling Expenses,12.23,55687331.8
06/04/2023,Expense,Uber,Mike ross,Credit Card - Ramp,12.23,55687344.03
06/04/2023,Expense,Uber,Mike ross,Credit Card - Ramp,12.23,55687356.26
06/04/2023,Expense,Uber,,Travelling Expenses,12.23,55687368.49
06/04/2023,Expense,Uber,Mike ross,Credit Card - Ramp,12.23,55687380.72
06/05/2023,Expense,Cuckoo Callay,Mike ross,Meals & Entertainment,12.49,55687393.21
06/05/2023,Expense,Usersnap,,Tools & Subscription - G&A,9.7,55687402.91
06/05/2023,Expense,The Commons Surry Hil,,Travel:Hotels,3.76,55687406.67
06/05/2023,Expense,Cuckoo Callay,Mike ross,Meals & Entertainment,12.49,55687419.16
06/05/2023,Expense,Usersnap,Harris Jose,Credit Card - Ramp,9.7,55687428.86
06/05/2023,Expense,Cuckoo Callay,Mike ross,Credit Card - Ramp,12.49,55687441.35
06/05/2023,Expense,Usersnap,,Tools & Subscription - G&A,9.7,55687451.05
06/05/2023,Expense,The Commons Surry Hil,Mike ross,Credit Card - Ramp,3.76,55687454.81
06/05/2023,Expense,The Commons Surry Hil,,Travel:Hotels,3.76,55687458.57
06/05/2023,Expense,Cuckoo Callay,Mike ross,Credit Card - Ramp,12.49,55687471.06
06/05/2023,Expense,Cuckoo Callay,Mike ross,Meals & Entertainment,12.49,55687483.55
06/05/2023,Expense,The Commons Surry Hil,,Travel:Hotels,3.76,55687487.31
06/05/2023,Expense,Cuckoo Callay,Mike ross,Meals & Entertainment,12.49,55687499.8
06/05/2023,Expense,Usersnap,,Tools & Subscription - G&A,9.7,55687509.5
06/05/2023,Expense,Usersnap,,Tools & Subscription - G&A,9.7,55687519.2
06/05/2023,Expense,The Commons Surry Hil,Mike ross,Credit Card - Ramp,3.76,55687522.96
06/05/2023,Expense,Cuckoo Callay,Mike ross,Credit Card - Ramp,12.49,55687535.45
06/05/2023,Expense,The Commons Surry Hil,,Travel:Hotels,3.76,55687539.21
06/05/2023,Expense,Usersnap,Harris Jose,Credit Card - Ramp,9.7,55687548.91
06/05/2023,Expense,The Commons Surry Hil,Mike ross,Credit Card - Ramp,3.76,55687552.67
06/05/2023,Expense,Cuckoo Callay,Mike ross,Credit Card - Ramp,12.49,55687565.16
06/05/2023,Expense,Usersnap,Harris Jose,Credit Card - Ramp,9.7,55687574.86
06/06/2023,Expense,Adobe,,Tools & Subscription - S&M,83.43,55687658.29
06/06/2023,Expense,Adobe,,Tools & Subscription - S&M,83.43,55687741.72
06/06/2023,Expense,Vodafone Australia,Max Kausman,Office expenses,31.05,55687772.77
06/06/2023,Expense,Sandoitchi Cafe,Mike ross,Meals & Entertainment,38.69,55687811.46
06/06/2023,Expense,Adobe,Mike ross,Credit Card - Ramp,83.43,55687894.89
06/06/2023,Expense,Vodafone Australia,Max Kausman,Credit Card - Ramp,31.05,55687925.94
06/06/2023,Expense,Vodafone Australia,Max Kausman,Credit Card - Ramp,31.05,55687956.99
06/06/2023,Expense,Vodafone Australia,Max Kausman,Credit Card - Ramp,31.05,55687988.04
06/06/2023,Expense,Sandoitchi Cafe,Mike ross,Meals & Entertainment,38.69,55688026.73
06/06/2023,Expense,Vodafone Australia,Max Kausman,Office expenses,31.05,55688057.78
06/06/2023,Expense,Sandoitchi Cafe,Mike ross,Meals & Entertainment,38.69,55688096.47
06/06/2023,Expense,Adobe,Mike ross,Credit Card - Ramp,83.43,55688179.9
06/06/2023,Expense,Sandoitchi Cafe,Mike ross,Credit Card - Ramp,38.69,55688218.59
06/06/2023,Expense,Sandoitchi Cafe,Mike ross,Credit Card - Ramp,38.69,55688257.28
06/06/2023,Expense,Vodafone Australia,Max Kausman,Office expenses,31.05,55688288.33
06/06/2023,Expense,Adobe,,Tools & Subscription - S&M,83.43,55688371.76
06/06/2023,Expense,Sandoitchi Cafe,Mike ross,Credit Card - Ramp,38.69,55688410.45
06/06/2023,Expense,Vodafone Australia,Max Kausman,Credit Card - Ramp,31.05,55688441.5
06/06/2023,Expense,Vodafone Australia,Max Kausman,Office expenses,31.05,55688472.55
06/06/2023,Expense,Sandoitchi Cafe,Mike ross,Meals & Entertainment,38.69,55688511.24
06/06/2023,Expense,Adobe,,Tools & Subscription - S&M,83.43,55688594.67
06/06/2023,Expense,Adobe,Mike ross,Credit Card - Ramp,83.43,55688678.1
06/06/2023,Expense,Sandoitchi Cafe,Mike ross,Credit Card - Ramp,38.69,55688716.79
06/07/2023,Expense,Uber,Mike ross,Credit Card - Ramp,13.43,55688730.22
06/07/2023,Expense,Uber,Mike ross,Credit Card - Ramp,24.72,55688754.94
06/07/2023,Transfer,,ChronicleHQ HSBC US ��������,HSBC A/c,-50,55688704.94
06/07/2023,Transfer,,ChronicleHQ HSBC US ��������,Account1,50,55688754.94
06/07/2023,Transfer,,ChronicleHQ HSBC US ��������,HSBC A/c,-50,55688704.94
06/07/2023,Expense,Mailchimp,Mike ross,Credit Card - Ramp,22.02,55688726.96
06/07/2023,Expense,Mailchimp,Mike ross,Credit Card - Ramp,22.02,55688748.98
06/07/2023,Transfer,,ChronicleHQ HSBC US ��������,HSBC A/c,-50,55688698.98
06/07/2023,Expense,Uber,Mike ross,Credit Card - Ramp,15.29,55688714.27
06/07/2023,Expense,Uber,Mike ross,Credit Card - Ramp,24.72,55688738.99
06/07/2023,Expense,Uber,Mike ross,Credit Card - Ramp,15.29,55688754.28
06/07/2023,Expense,Uber,Mike ross,Credit Card - Ramp,13.43,55688767.71
06/07/2023,Transfer,,ChronicleHQ HSBC US ��������,Account1,50,55688817.71
06/07/2023,Expense,Uber,,Travelling Expenses,24.72,55688842.43
06/07/2023,Expense,Uber,,Travelling Expenses,13.43,55688855.86
06/07/2023,Expense,Heroku,Balapavan Tirumani,Tools & Subscription - S&M,85,55688940.86
06/07/2023,Transfer,,ChronicleHQ HSBC US ��������,Account1,50,55688990.86
06/07/2023,Transfer,,ChronicleHQ HSBC US ��������,HSBC A/c,-50,55688940.86
06/07/2023,Expense,Mailchimp,,Tools & Subscription - G&A,22.02,55688962.88
06/07/2023,Expense,Heroku,Balapavan Tirumani,Credit Card - Ramp,85,55689047.88
06/07/2023,Expense,Mailchimp,Mike ross,Credit Card - Ramp,22.02,55689069.9
06/07/2023,Expense,Uber,,Travelling Expenses,15.29,55689085.19
06/07/2023,Expense,Heroku,Balapavan Tirumani,Tools & Subscription - S&M,85,55689170.19
06/07/2023,Expense,Uber,,Travelling Expenses,24.72,55689194.91
06/07/2023,Expense,Uber,Mike ross,Credit Card - Ramp,24.72,55689219.63
06/07/2023,Expense,Uber,Mike ross,Credit Card - Ramp,15.29,55689234.92
06/07/2023,Expense,Heroku,Balapavan Tirumani,Tools & Subscription - S&M,85,55689319.92
06/07/2023,Expense,Uber,,Travelling Expenses,13.43,55689333.35
06/07/2023,Expense,Heroku,Balapavan Tirumani,Credit Card - Ramp,85,55689418.35
06/07/2023,Expense,Uber,Mike ross,Credit Card - Ramp,13.43,55689431.78
06/07/2023,Expense,Mailchimp,,Tools & Subscription - G&A,22.02,55689453.8
06/07/2023,Expense,Heroku,Balapavan Tirumani,Credit Card - Ramp,85,55689538.8
06/07/2023,Transfer,,ChronicleHQ HSBC US ��������,Account1,50,55689588.8
06/07/2023,Expense,Uber,,Travelling Expenses,13.43,55689602.23
06/07/2023,Expense,Heroku,Balapavan Tirumani,Tools & Subscription - S&M,85,55689687.23
06/07/2023,Expense,Uber,,Travelling Expenses,24.72,55689711.95
06/07/2023,Expense,Mailchimp,,Tools & Subscription - G&A,22.02,55689733.97
06/07/2023,Expense,Uber,,Travelling Expenses,15.29,55689749.26
06/07/2023,Expense,Uber,,Travelling Expenses,13.43,55689762.69
06/07/2023,Expense,Uber,,Travelling Expenses,15.29,55689777.98
06/07/2023,Expense,Mailchimp,,Tools & Subscription - G&A,22.02,55689800
06/07/2023,Expense,Uber,,Travelling Expenses,24.72,55689824.72
06/07/2023,Expense,Uber,,Travelling Expenses,15.29,55689840.01
06/08/2023,Expense,Userflow,Max Kausman,Credit Card - Ramp,250,55690090.01
06/08/2023,Expense,Userflow,,Tools & Subscription - G&A,250,55690340.01
06/08/2023,Expense,Sandoitchi Cafe,Mike ross,Credit Card - Ramp,22.37,55690362.38
06/08/2023,Expense,Sandoitchi Cafe,Mike ross,Credit Card - Ramp,22.37,55690384.75
06/08/2023,Expense,Sandoitchi Cafe,Mike ross,Meals & Entertainment,22.37,55690407.12
06/08/2023,Expense,Sandoitchi Cafe,Mike ross,Meals & Entertainment,22.37,55690429.49
06/08/2023,Expense,Userflow,Max Kausman,Credit Card - Ramp,250,55690679.49
06/08/2023,Expense,Userflow,,Tools & Subscription - G&A,250,55690929.49
06/08/2023,Expense,Userflow,,Tools & Subscription - G&A,250,55691179.49
06/08/2023,Expense,Sandoitchi Cafe,Mike ross,Meals & Entertainment,22.37,55691201.86
06/08/2023,Expense,Userflow,,Tools & Subscription - G&A,250,55691451.86
06/08/2023,Expense,Userflow,Max Kausman,Credit Card - Ramp,250,55691701.86
06/08/2023,Expense,Sandoitchi Cafe,Mike ross,Credit Card - Ramp,22.37,55691724.23
06/08/2023,Expense,Sandoitchi Cafe,Mike ross,Credit Card - Ramp,22.37,55691746.6
06/08/2023,Expense,Sandoitchi Cafe,Mike ross,Meals & Entertainment,22.37,55691768.97
06/09/2023,Expense,Usersnap,Harris Jose,Credit Card - Ramp,99,55691867.97
06/09/2023,Expense,Usersnap,Harris Jose,Credit Card - Ramp,99,55691966.97
06/09/2023,Expense,Taplio,,Tools & Subscription - G&A,39,55692005.97
06/09/2023,Expense,Taplio,,Tools & Subscription - G&A,39,55692044.97
06/09/2023,Expense,Usersnap,,Tools & Subscription - G&A,99,55692143.97
06/09/2023,Expense,Taplio,Harvey Spector,Credit Card - Ramp,39,55692182.97
06/09/2023,Expense,Usersnap,,Tools & Subscription - G&A,99,55692281.97
06/09/2023,Expense,Taplio,Harvey Spector,Credit Card - Ramp,39,55692320.97
06/09/2023,Expense,Taplio,Harvey Spector,Credit Card - Ramp,39,55692359.97
06/09/2023,Expense,Usersnap,Harris Jose,Credit Card - Ramp,99,55692458.97
06/09/2023,Expense,Taplio,,Tools & Subscription - G&A,39,55692497.97
06/09/2023,Expense,Usersnap,,Tools & Subscription - G&A,99,55692596.97
06/09/2023,Expense,Taplio,,Tools & Subscription - G&A,39,55692635.97
06/09/2023,Expense,Usersnap,,Tools & Subscription - G&A,99,55692734.97
06/10/2023,Expense,Pause Cafe,Harvey Spector,Credit Card - Ramp,13,55692747.97
06/10/2023,Expense,Pause Cafe,Harvey Spector,Credit Card - Ramp,13,55692760.97
06/10/2023,Expense,Pause Cafe,Harvey Spector,Meals & Entertainment,13,55692773.97
06/10/2023,Expense,Pause Cafe,Harvey Spector,Meals & Entertainment,13,55692786.97
06/10/2023,Expense,Pause Cafe,Harvey Spector,Credit Card - Ramp,13,55692799.97
06/10/2023,Expense,Pause Cafe,Harvey Spector,Credit Card - Ramp,13,55692812.97
06/10/2023,Expense,Pause Cafe,Harvey Spector,Meals & Entertainment,13,55692825.97
06/10/2023,Expense,Pause Cafe,Harvey Spector,Meals & Entertainment,13,55692838.97
06/11/2023,Expense,Careem,Harvey Spector,Credit Card - Ramp,9.94,55692848.91
06/11/2023,Expense,The New York Times,,General business expenses:Memberships & subscriptions,8.34,55692857.25
06/11/2023,Expense,Careem,Harvey Spector,Credit Card - Ramp,9.94,55692867.19
06/11/2023,Expense,The New York Times,Mike ross,Credit Card - Ramp,8.34,55692875.53
06/11/2023,Expense,Careem,,Travelling Expenses,9.94,55692885.47
06/11/2023,Expense,The New York Times,,General business expenses:Memberships & subscriptions,8.34,55692893.81
06/11/2023,Expense,Careem,Harvey Spector,Credit Card - Ramp,9.94,55692903.75
06/11/2023,Expense,Careem,,Travelling Expenses,9.94,55692913.69
06/11/2023,Expense,The New York Times,,General business expenses:Memberships & subscriptions,8.34,55692922.03
06/11/2023,Expense,Careem,,Travelling Expenses,9.94,55692931.97
06/11/2023,Expense,The New York Times,Mike ross,Credit Card - Ramp,8.34,55692940.31
06/11/2023,Expense,Careem,,Travelling Expenses,9.94,55692950.25
06/11/2023,Expense,The New York Times,Mike ross,Credit Card - Ramp,8.34,55692958.59
06/11/2023,Expense,The New York Times,Mike ross,Credit Card - Ramp,8.34,55692966.93
06/11/2023,Expense,The New York Times,,General business expenses:Memberships & subscriptions,8.34,55692975.27
06/12/2023,Expense,Adobe,,Tools & Subscription - S&M,20.99,55692996.26
06/12/2023,Expense,Adobe,Chris George,Credit Card - Ramp,20.99,55693017.25
06/12/2023,Expense,Uber,,Travelling Expenses,49.34,55693066.59
06/12/2023,Expense,WordPress,,Tools & Subscription - G&A,15.75,55693082.34
06/12/2023,Expense,Uber,Mike ross,Credit Card - Ramp,49.34,55693131.68
06/12/2023,Deposit,,PaymentServiceB Savings **6977,Savings (6977),100000,55793131.68
06/12/2023,Deposit,,PaymentServiceB Savings **6977,Account1,-100000,55693131.68
06/12/2023,Expense,Uber,,Travelling Expenses,49.34,55693181.02
06/12/2023,Expense,Adobe,,Tools & Subscription - S&M,20.99,55693202.01
06/12/2023,Expense,WordPress,,Tools & Subscription - G&A,15.75,55693217.76
06/12/2023,Expense,Uber,,Travelling Expenses,49.34,55693267.1
06/12/2023,Expense,Adobe,,Tools & Subscription - S&M,20.99,55693288.09
06/12/2023,Expense,Uber,,Travelling Expenses,49.34,55693337.43
06/12/2023,Expense,Uber,Mike ross,Credit Card - Ramp,49.34,55693386.77
06/12/2023,Expense,Uber,,Travelling Expenses,42.85,55693429.62
06/12/2023,Expense,Adobe,Chris George,Credit Card - Ramp,20.99,55693450.61
06/12/2023,Expense,Uber,,Travelling Expenses,42.85,55693493.46
06/12/2023,Deposit,,PaymentServiceB Savings **6977,Account1,-500000,55193493.46
06/12/2023,Deposit,,PaymentServiceB Savings **6977,Savings (6977),100000,55293493.46
06/12/2023,Expense,WordPress,,Tools & Subscription - G&A,15.75,55293509.21
06/12/2023,Deposit,,PaymentServiceB Savings **6977,Savings (6977),500000,55793509.21
06/12/2023,Expense,Uber,Mike ross,Credit Card - Ramp,42.85,55793552.06
06/12/2023,Expense,WordPress,Harris Jose,Credit Card - Ramp,15.75,55793567.81
06/12/2023,Expense,WordPress,Harris Jose,Credit Card - Ramp,15.75,55793583.56
06/12/2023,Expense,Uber,Mike ross,Credit Card - Ramp,42.85,55793626.41
06/12/2023,Expense,Uber,Mike ross,Credit Card - Ramp,49.34,55793675.75
06/12/2023,Deposit,,PaymentServiceB Savings **6977,Account1,-500000,55293675.75
06/12/2023,Deposit,,PaymentServiceB Savings **6977,Savings (6977),500000,55793675.75
06/12/2023,Expense,Uber,,Travelling Expenses,42.85,55793718.6
06/12/2023,Expense,WordPress,,Tools & Subscription - G&A,15.75,55793734.35
06/12/2023,Expense,Adobe,,Tools & Subscription - S&M,20.99,55793755.34
06/12/2023,Deposit,,PaymentServiceB Savings **6977,Savings (6977),100000,55893755.34
06/12/2023,Expense,Uber,Mike ross,Credit Card - Ramp,42.85,55893798.19
06/12/2023,Deposit,,PaymentServiceB Savings **6977,Account1,-100000,55793798.19
06/12/2023,Expense,Adobe,Chris George,Credit Card - Ramp,20.99,55793819.18
06/12/2023,Deposit,,PaymentServiceB Savings **6977,Account1,-100000,55693819.18
06/12/2023,Deposit,,PaymentServiceB Savings **6977,Account1,-500000,55193819.18
06/12/2023,Deposit,,PaymentServiceB Savings **6977,Savings (6977),500000,55693819.18
06/12/2023,Deposit,,PaymentServiceB Savings **6977,Account1,-100000,55593819.18
06/12/2023,Deposit,,PaymentServiceB Savings **6977,Account1,-500000,55093819.18
06/12/2023,Deposit,,PaymentServiceB Savings **6977,Savings (6977),100000,55193819.18
06/12/2023,Deposit,,PaymentServiceB Savings **6977,Savings (6977),500000,55693819.18
06/12/2023,Expense,WordPress,Harris Jose,Credit Card - Ramp,15.75,55693834.93
06/12/2023,Expense,Uber,,Travelling Expenses,42.85,55693877.78
06/13/2023,Expense,Lenny Rachitsky,,General business expenses:Memberships & subscriptions,15,55693892.78
06/13/2023,Transfer,,ChronicleHQ HSBC US ��������,Account1,500000,56193892.78
06/13/2023,Expense,Lenny Rachitsky,Max Kausman,Credit Card - Ramp,15,56193907.78
06/13/2023,Expense,Lenny Rachitsky,Max Kausman,Credit Card - Ramp,15,56193922.78
06/13/2023,Expense,The Commons Surry Hil,Mike ross,Credit Card - Ramp,3.84,56193926.62
06/13/2023,Expense,Figma,,Tools & Subscription - G&A,250,56194176.62
06/13/2023,Expense,Interact32,Harvey Spector,Tools & Subscription - G&A,10.18,56194186.8
06/13/2023,Expense,Figma,Mike ross,Credit Card - Ramp,250,56194436.8
06/13/2023,Transfer,,ChronicleHQ HSBC US ��������,Account1,500000,56694436.8
06/13/2023,Expense,Interact32,Harvey Spector,Credit Card - Ramp,10.18,56694446.98
06/13/2023,Expense,The Commons Surry Hil,Mike ross,Credit Card - Ramp,3.84,56694450.82
06/13/2023,Expense,Interact32,Harvey Spector,Tools & Subscription - G&A,10.18,56694461
06/13/2023,Expense,Interact32,Harvey Spector,Tools & Subscription - G&A,10.18,56694471.18
06/13/2023,Expense,Lenny Rachitsky,Max Kausman,Credit Card - Ramp,15,56694486.18
06/13/2023,Expense,The Commons Surry Hil,,Travel:Hotels,3.84,56694490.02
06/13/2023,Expense,Vercel,,Tools & Subscription - G&A,240,56694730.02
06/13/2023,Expense,Lenny Rachitsky,,General business expenses:Memberships & subscriptions,15,56694745.02
06/13/2023,Expense,PocketSmith,,Tools & Subscription - G&A,9.95,56694754.97
06/13/2023,Transfer,,ChronicleHQ HSBC US ��������,HSBC A/c,-500000,56194754.97
06/13/2023,Expense,The Commons Surry Hil,,Travel:Hotels,3.84,56194758.81
06/13/2023,Expense,PocketSmith,Harvey Spector,Credit Card - Ramp,9.95,56194768.76
06/13/2023,Expense,PocketSmith,,Tools & Subscription - G&A,9.95,56194778.71
06/13/2023,Expense,Vercel,,Tools & Subscription - G&A,240,56195018.71
06/13/2023,Expense,Figma,,Tools & Subscription - G&A,250,56195268.71
06/13/2023,Expense,PocketSmith,Harvey Spector,Credit Card - Ramp,9.95,56195278.66
06/13/2023,Expense,Lenny Rachitsky,,General business expenses:Memberships & subscriptions,15,56195293.66
06/13/2023,Transfer,,ChronicleHQ HSBC US ��������,HSBC A/c,-500000,55695293.66
06/13/2023,Transfer,,ChronicleHQ HSBC US ��������,Account1,500000,56195293.66
06/13/2023,Expense,Interact32,Harvey Spector,Tools & Subscription - G&A,10.18,56195303.84
06/13/2023,Expense,PocketSmith,,Tools & Subscription - G&A,9.95,56195313.79
06/13/2023,Expense,Interact32,Harvey Spector,Credit Card - Ramp,10.18,56195323.97
06/13/2023,Expense,Figma,Mike ross,Credit Card - Ramp,250,56195573.97
06/13/2023,Expense,Interact32,Harvey Spector,Credit Card - Ramp,10.18,56195584.15
06/13/2023,Expense,The Commons Surry Hil,,Travel:Hotels,3.84,56195587.99
06/13/2023,Expense,Lenny Rachitsky,Max Kausman,Credit Card - Ramp,15,56195602.99
06/13/2023,Expense,PocketSmith,Harvey Spector,Credit Card - Ramp,9.95,56195612.94
06/13/2023,Expense,Vercel,Harris Jose,Credit Card - Ramp,240,56195852.94
06/13/2023,Expense,Figma,Mike ross,Credit Card - Ramp,250,56196102.94
06/13/2023,Expense,Figma,,Tools & Subscription - G&A,250,56196352.94
06/13/2023,Transfer,,ChronicleHQ HSBC US ��������,Account1,500000,56696352.94
06/13/2023,Expense,The Commons Surry Hil,,Travel:Hotels,3.84,56696356.78
06/13/2023,Expense,Vercel,,Tools & Subscription - G&A,240,56696596.78
06/13/2023,Expense,Lenny Rachitsky,,General business expenses:Memberships & subscriptions,15,56696611.78
06/13/2023,Expense,PocketSmith,,Tools & Subscription - G&A,9.95,56696621.73
06/13/2023,Expense,Vercel,Harris Jose,Credit Card - Ramp,240,56696861.73
06/13/2023,Expense,Figma,,Tools & Subscription - G&A,250,56697111.73
06/13/2023,Expense,Vercel,,Tools & Subscription - G&A,240,56697351.73
06/13/2023,Expense,Vercel,Harris Jose,Credit Card - Ramp,240,56697591.73
06/13/2023,Expense,The Commons Surry Hil,Mike ross,Credit Card - Ramp,3.84,56697595.57
06/13/2023,Transfer,,ChronicleHQ HSBC US ��������,HSBC A/c,-500000,56197595.57
06/13/2023,Transfer,,ChronicleHQ HSBC US ��������,HSBC A/c,-500000,55697595.57
06/14/2023,Expense,Intuit,Harvey Spector,Credit Card - Ramp,55,55697650.57
06/14/2023,Expense,Intuit,,Tools & Subscription - G&A,55,55697705.57
06/14/2023,Expense,Maloneys Grocer,,Meals & Entertainment,24.54,55697730.11
06/14/2023,Expense,Dabang,Mike ross,Meals & Entertainment,7.75,55697737.86
06/14/2023,Expense,Intuit,Harvey Spector,Credit Card - Ramp,55,55697792.86
06/14/2023,Expense,Intuit,,Tools & Subscription - G&A,55,55697847.86
06/14/2023,Expense,Maloneys Grocer,Mike ross,Credit Card - Ramp,24.54,55697872.4
06/14/2023,Expense,Dabang,Mike ross,Credit Card - Ramp,7.75,55697880.15
06/14/2023,Expense,Intuit,Harvey Spector,Credit Card - Ramp,55,55697935.15
06/14/2023,Expense,Maloneys Grocer,,Meals & Entertainment,24.54,55697959.69
06/14/2023,Expense,Maloneys Grocer,Mike ross,Credit Card - Ramp,24.54,55697984.23
06/14/2023,Expense,Dabang,Mike ross,Credit Card - Ramp,7.75,55697991.98
06/14/2023,Expense,Dabang,Mike ross,Meals & Entertainment,7.75,55697999.73
06/14/2023,Expense,Intuit,,Tools & Subscription - G&A,55,55698054.73
06/14/2023,Expense,Maloneys Grocer,,Meals & Entertainment,24.54,55698079.27
06/14/2023,Expense,Maloneys Grocer,Mike ross,Credit Card - Ramp,24.54,55698103.81
06/14/2023,Expense,Maloneys Grocer,Mike ross,Credit Card - Ramp,24.54,55698128.35
06/14/2023,Expense,Dabang,Mike ross,Meals & Entertainment,7.75,55698136.1
06/14/2023,Expense,Dabang,Mike ross,Meals & Entertainment,7.75,55698143.85
06/14/2023,Expense,Dabang,Mike ross,Credit Card - Ramp,7.75,55698151.6
06/14/2023,Expense,Intuit,,Tools & Subscription - G&A,55,55698206.6
06/14/2023,Expense,Dabang,Mike ross,Credit Card - Ramp,7.75,55698214.35
06/14/2023,Expense,Maloneys Grocer,,Meals & Entertainment,24.54,55698238.89
06/15/2023,Expense,Four Ate Five,Mike ross,Credit Card - Ramp,37.82,55698276.71
06/15/2023,Expense,Four Ate Five,Mike ross,Meals & Entertainment,37.82,55698314.53
06/15/2023,Expense,Four Ate Five,Mike ross,Meals & Entertainment,37.82,55698352.35
06/15/2023,Expense,Four Ate Five,Mike ross,Credit Card - Ramp,37.82,55698390.17
06/15/2023,Expense,Four Ate Five,Mike ross,Meals & Entertainment,37.82,55698427.99
06/15/2023,Expense,Four Ate Five,Mike ross,Meals & Entertainment,37.82,55698465.81
06/15/2023,Expense,Four Ate Five,Mike ross,Credit Card - Ramp,37.82,55698503.63
06/15/2023,Expense,Four Ate Five,Mike ross,Credit Card - Ramp,37.82,55698541.45
06/16/2023,Expense,Zapier,,Tools & Subscription - G&A,29.99,55698571.44
06/16/2023,Expense,zamp finance,Zamp Finance,Account1,50000,55748571.44
06/16/2023,Expense,Linear,,Tools & Subscription - G&A,170,55748741.44
06/16/2023,Expense,zamp finance,Zamp Finance,Zamp Investments - Other,-50000,55698741.44
06/16/2023,Expense,Zapier,,Tools & Subscription - G&A,29.99,55698771.43
06/16/2023,Expense,Zapier,,Tools & Subscription - G&A,29.99,55698801.42
06/16/2023,Expense,The Commons Surry Hil,,Travel:Hotels,4.97,55698806.39
06/16/2023,Expense,The Commons Surry Hil,Mike ross,Credit Card - Ramp,4.97,55698811.36
06/16/2023,Expense,zamp finance,Zamp Finance,Zamp Investments - Other,-50000,55648811.36
06/16/2023,Expense,Linear,,Tools & Subscription - G&A,170,55648981.36
06/16/2023,Expense,zamp finance,Zamp Finance,Zamp Investments - Other,-50000,55598981.36
06/16/2023,Expense,The Commons Surry Hil,,Travel:Hotels,4.97,55598986.33
06/16/2023,Expense,The Commons Surry Hil,,Travel:Hotels,4.97,55598991.3
06/16/2023,Expense,Linear,Chad Blumenthal,Credit Card - Ramp,170,55599161.3
06/16/2023,Expense,Zapier,,Tools & Subscription - G&A,29.99,55599191.29
06/16/2023,Expense,The Commons Surry Hil,,Travel:Hotels,4.97,55599196.26
06/16/2023,Expense,Linear,Chad Blumenthal,Credit Card - Ramp,170,55599366.26
06/16/2023,Expense,Zapier,Harvey Spector,Credit Card - Ramp,29.99,55599396.25
06/16/2023,Expense,zamp finance,Zamp Finance,Account1,50000,55649396.25
06/16/2023,Expense,zamp finance,Zamp Finance,Account1,50000,55699396.25
06/16/2023,Expense,Linear,,Tools & Subscription - G&A,170,55699566.25
06/16/2023,Expense,zamp finance,Zamp Finance,Account1,50000,55749566.25
06/16/2023,Expense,Zapier,Harvey Spector,Credit Card - Ramp,29.99,55749596.24
06/16/2023,Expense,Linear,Chad Blumenthal,Credit Card - Ramp,170,55749766.24
06/16/2023,Expense,Linear,,Tools & Subscription - G&A,170,55749936.24
06/16/2023,Expense,Zapier,Harvey Spector,Credit Card - Ramp,29.99,55749966.23
06/16/2023,Expense,The Commons Surry Hil,Mike ross,Credit Card - Ramp,4.97,55749971.2
06/16/2023,Expense,The Commons Surry Hil,Mike ross,Credit Card - Ramp,4.97,55749976.17
06/16/2023,Expense,zamp finance,Zamp Finance,Zamp Investments - Other,-50000,55699976.17
06/17/2023,Expense,Kinokuniya Book Stores,Mike ross,General business expenses:Continuing education,191.92,55700168.09
06/17/2023,Expense,Kinokuniya Book Stores,Mike ross,Credit Card - Ramp,191.92,55700360.01
06/17/2023,Expense,Kinokuniya Book Stores,Mike ross,General business expenses:Continuing education,191.92,55700551.93
06/17/2023,Expense,Kinokuniya Book Stores,Mike ross,General business expenses:Continuing education,191.92,55700743.85
06/17/2023,Expense,Kinokuniya Book Stores,Mike ross,Credit Card - Ramp,191.92,55700935.77
06/17/2023,Expense,Kinokuniya Book Stores,Mike ross,Credit Card - Ramp,191.92,55701127.69
06/17/2023,Expense,Kinokuniya Book Stores,Mike ross,General business expenses:Continuing education,191.92,55701319.61
06/17/2023,Expense,Kinokuniya Book Stores,Mike ross,Credit Card - Ramp,191.92,55701511.53
06/18/2023,Expense,Reclaim.ai,,Tools & Subscription - G&A,8,55701519.53
06/18/2023,Expense,Linkedin Recruiter,,General business expenses:Memberships & subscriptions,159.95,55701679.48
06/18/2023,Expense,Segment,,Tools & Subscription - G&A,120,55701799.48
06/18/2023,Expense,Segment,Balapavan Tirumani,Credit Card - Ramp,120,55701919.48
06/18/2023,Expense,Linkedin Recruiter,Mike ross,Credit Card - Ramp,159.95,55702079.43
06/18/2023,Expense,Reclaim.ai,,Tools & Subscription - G&A,8,55702087.43
06/18/2023,Expense,Segment,,Tools & Subscription - G&A,120,55702207.43
06/18/2023,Expense,Linkedin Recruiter,Mike ross,Credit Card - Ramp,159.95,55702367.38
06/18/2023,Expense,Linkedin Recruiter,,General business expenses:Memberships & subscriptions,159.95,55702527.33
06/18/2023,Expense,Segment,,Tools & Subscription - G&A,120,55702647.33
06/18/2023,Expense,Reclaim.ai,,Tools & Subscription - G&A,8,55702655.33
06/18/2023,Expense,Reclaim.ai,,Tools & Subscription - G&A,8,55702663.33
06/18/2023,Expense,Segment,,Tools & Subscription - G&A,120,55702783.33
06/18/2023,Expense,Linkedin Recruiter,,General business expenses:Memberships & subscriptions,159.95,55702943.28
06/18/2023,Expense,Linkedin Recruiter,Mike ross,Credit Card - Ramp,159.95,55703103.23
06/18/2023,Expense,Segment,Balapavan Tirumani,Credit Card - Ramp,120,55703223.23
06/18/2023,Expense,Linkedin Recruiter,Mike ross,Credit Card - Ramp,159.95,55703383.18
06/18/2023,Expense,Linkedin Recruiter,,General business expenses:Memberships & subscriptions,159.95,55703543.13
06/18/2023,Expense,Reclaim.ai,Max Kausman,Credit Card - Ramp,8,55703551.13
06/18/2023,Expense,Segment,Balapavan Tirumani,Credit Card - Ramp,120,55703671.13
06/18/2023,Expense,Reclaim.ai,Max Kausman,Credit Card - Ramp,8,55703679.13
06/18/2023,Expense,Reclaim.ai,Max Kausman,Credit Card - Ramp,8,55703687.13
06/19/2023,Expense,Twitter,,Tools & Subscription - G&A,8.18,55703695.31
06/19/2023,Expense,,Fees MONTHLY CHARGE Bank Charges for the per 01MAY2023 TO 31MAY2023 Invoice No 1629602,General business expenses:Bank fees & service charges,-35.1,55703660.21
06/19/2023,Expense,,Fees MONTHLY CHARGE Bank Charges for the per 01MAY2023 TO 31MAY2023 Invoice No 1629602,General business expenses:Bank fees & service charges,-35.1,55703625.11
06/19/2023,Expense,,Fees,HSBC A/c,35.1,55703660.21
06/19/2023,Expense,,Fees,HSBC A/c,35.1,55703695.31
06/19/2023,Expense,Twitter,,Tools & Subscription - G&A,8.18,55703703.49
06/19/2023,Expense,,Fees MONTHLY CHARGE Bank Charges for the per 01MAY2023 TO 31MAY2023 Invoice No 1629602,General business expenses:Bank fees & service charges,-35.1,55703668.39
06/19/2023,Expense,Twitter,Harvey Spector,Credit Card - Ramp,8.18,55703676.57
06/19/2023,Expense,Twitter,,Tools & Subscription - G&A,8.18,55703684.75
06/19/2023,Expense,Twitter,,Tools & Subscription - G&A,8.18,55703692.93
06/19/2023,Expense,,Fees,HSBC A/c,35.1,55703728.03
06/19/2023,Expense,Twitter,Harvey Spector,Credit Card - Ramp,8.18,55703736.21
06/19/2023,Expense,,Fees,HSBC A/c,35.1,55703771.31
06/19/2023,Expense,,Fees MONTHLY CHARGE Bank Charges for the per 01MAY2023 TO 31MAY2023 Invoice No 1629602,General business expenses:Bank fees & service charges,-35.1,55703736.21
06/19/2023,Expense,Twitter,Harvey Spector,Credit Card - Ramp,8.18,55703744.39
06/20/2023,Expense,Bourke Street Bakery,Mike ross,Credit Card - Ramp,10.41,55703754.8
06/20/2023,Expense,RAMP BUSINESS CO,RAMP STATEMENT,Credit Card - Ramp,-5597.45,55698157.35
06/20/2023,Expense,Uber,,Travelling Expenses,11.55,55698168.9
06/20/2023,Expense,Uber,,Travelling Expenses,10.82,55698179.72
06/20/2023,Expense,Uber,,Travelling Expenses,10.57,55698190.29
06/20/2023,Expense,RAMP BUSINESS CO,RAMP STATEMENT,Account1,-5597.45,55692592.84
06/20/2023,Bill Payment (Check),Big Company ,,Account1,-10887.34,55681705.5
06/20/2023,Expense,Uber,Mike ross,Credit Card - Ramp,10.57,55681716.07
06/20/2023,Bill Payment (Check),Big Company ,,Account1,-10887.34,55670828.73
06/20/2023,Bill Payment (Check),Big Company ,,Account1,-10887.34,55659941.39
06/20/2023,Expense,Uber,,Travelling Expenses,10.82,55659952.21
06/20/2023,Expense,Uber,Mike ross,Credit Card - Ramp,10.82,55659963.03
06/20/2023,Bill Payment (Check),Big Company ,,Accounts Payable (A/P),-10887.34,55649075.69
06/20/2023,Expense,RAMP BUSINESS CO,RAMP STATEMENT,Credit Card - Ramp,-5597.45,55643478.24
06/20/2023,Expense,Uber,,Travelling Expenses,11.55,55643489.79
06/20/2023,Expense,Bourke Street Bakery,Mike ross,Meals & Entertainment,10.41,55643500.2
06/20/2023,Expense,Uber,,Travelling Expenses,10.57,55643510.77
06/20/2023,Expense,Uber,,Travelling Expenses,10.82,55643521.59
06/20/2023,Expense,Bourke Street Bakery,Mike ross,Credit Card - Ramp,10.41,55643532
06/20/2023,Expense,Uber,,Travelling Expenses,11.55,55643543.55
06/20/2023,Expense,RAMP BUSINESS CO,RAMP STATEMENT,Credit Card - Ramp,-5597.45,55637946.1
06/20/2023,Expense,Uber,Mike ross,Credit Card - Ramp,11.55,55637957.65
06/20/2023,Expense,Bourke Street Bakery,Mike ross,Meals & Entertainment,10.41,55637968.06
06/20/2023,Bill Payment (Check),Big Company ,,Accounts Payable (A/P),-10887.34,55627080.72
06/20/2023,Bill Payment (Check),Big Company ,,Accounts Payable (A/P),-10887.34,55616193.38
06/20/2023,Expense,RAMP BUSINESS CO,RAMP STATEMENT,Account1,-5597.45,55610595.93
06/20/2023,Expense,Bourke Street Bakery,Mike ross,Credit Card - Ramp,10.41,55610606.34
06/20/2023,Expense,Uber,Mike ross,Credit Card - Ramp,11.55,55610617.89
06/20/2023,Expense,Uber,,Travelling Expenses,10.82,55610628.71
06/20/2023,Expense,Uber,Mike ross,Credit Card - Ramp,10.82,55610639.53
06/20/2023,Expense,Uber,,Travelling Expenses,11.55,55610651.08
06/20/2023,Expense,Uber,Mike ross,Credit Card - Ramp,10.57,55610661.65
06/20/2023,Expense,Uber,Mike ross,Credit Card - Ramp,11.55,55610673.2
06/20/2023,Expense,Uber,Mike ross,Credit Card - Ramp,10.82,55610684.02
06/20/2023,Expense,Uber,,Travelling Expenses,10.57,55610694.59
06/20/2023,Expense,RAMP BUSINESS CO,RAMP STATEMENT,Account1,-5597.45,55605097.14
06/20/2023,Expense,Uber,Mike ross,Credit Card - Ramp,10.57,55605107.71
06/20/2023,Bill Payment (Check),Big Company ,,Accounts Payable (A/P),-10887.34,55594220.37
06/20/2023,Expense,RAMP BUSINESS CO,RAMP STATEMENT,Credit Card - Ramp,-5597.45,55588622.92
06/20/2023,Expense,RAMP BUSINESS CO,RAMP STATEMENT,Account1,-5597.45,55583025.47
06/20/2023,Expense,Bourke Street Bakery,Mike ross,Credit Card - Ramp,10.41,55583035.88
06/20/2023,Expense,Bourke Street Bakery,Mike ross,Meals & Entertainment,10.41,55583046.29
06/20/2023,Expense,Uber,,Travelling Expenses,10.57,55583056.86
06/20/2023,Expense,Bourke Street Bakery,Mike ross,Meals & Entertainment,10.41,55583067.27
06/20/2023,Bill Payment (Check),Big Company ,,Account1,-10887.34,55572179.93
06/21/2023,Expense,Uber,,Travelling Expenses,10.85,55572190.78
06/21/2023,Expense,Uber,,Travelling Expenses,10.85,55572201.63
06/21/2023,Expense,Uber,,Travelling Expenses,11.52,55572213.15
06/21/2023,Expense,Uber,Mike ross,Credit Card - Ramp,10.85,55572224
06/21/2023,Expense,Uber,,Travelling Expenses,10.85,55572234.85
06/21/2023,Expense,Uber,,Travelling Expenses,11.52,55572246.37
06/21/2023,Expense,Uber,Mike ross,Credit Card - Ramp,11.52,55572257.89
06/21/2023,Expense,Uber,Mike ross,Credit Card - Ramp,10.85,55572268.74
06/21/2023,Expense,Uber,,Travelling Expenses,11.52,55572280.26
06/21/2023,Expense,Uber,Mike ross,Credit Card - Ramp,11.52,55572291.78
06/21/2023,Expense,Uber,Mike ross,Credit Card - Ramp,11.52,55572303.3
06/21/2023,Expense,Uber,,Travelling Expenses,10.85,55572314.15
06/21/2023,Expense,Uber,,Travelling Expenses,11.52,55572325.67
06/21/2023,Expense,Uber,Mike ross,Credit Card - Ramp,10.85,55572336.52
06/22/2023,Expense,Dovetail,Harvey Spector,Credit Card - Ramp,70,55572406.52
06/22/2023,Expense,Docusign,Harvey Spector,Credit Card - Ramp,15,55572421.52
06/22/2023,Expense,Docusign,Harvey Spector,Credit Card - Ramp,15,55572436.52
06/22/2023,Expense,Docusign,,Tools & Subscription - G&A,15,55572451.52
06/22/2023,Expense,Docusign,,Tools & Subscription - G&A,15,55572466.52
06/22/2023,Expense,Dovetail,,Tools & Subscription - G&A,70,55572536.52
06/22/2023,Expense,Dovetail,Harvey Spector,Credit Card - Ramp,70,55572606.52
06/22/2023,Expense,Dovetail,,Tools & Subscription - G&A,70,55572676.52
06/22/2023,Expense,Docusign,,Tools & Subscription - G&A,15,55572691.52
06/22/2023,Expense,Dovetail,,Tools & Subscription - G&A,70,55572761.52
06/22/2023,Expense,Dovetail,,Tools & Subscription - G&A,70,55572831.52
06/22/2023,Expense,Dovetail,Harvey Spector,Credit Card - Ramp,70,55572901.52
06/22/2023,Expense,Docusign,Harvey Spector,Credit Card - Ramp,15,55572916.52
06/22/2023,Expense,Docusign,,Tools & Subscription - G&A,15,55572931.52
06/23/2023,Expense,Superhuman,,Professional Service Charges,60,55572991.52
06/23/2023,Expense,Super,,Tools & Subscription - G&A,12,55573003.52
06/23/2023,Expense,The Carrington,,Meals & Entertainment,29.05,55573032.57
06/23/2023,Expense,Superhuman,,Professional Service Charges,60,55573092.57
06/23/2023,Expense,The Carrington,Mike ross,Credit Card - Ramp,29.05,55573121.62
06/23/2023,Expense,The Carrington,,Meals & Entertainment,29.05,55573150.67
06/23/2023,Expense,Superhuman,Mike ross,Credit Card - Ramp,60,55573210.67
06/23/2023,Expense,Superhuman,Mike ross,Credit Card - Ramp,60,55573270.67
06/23/2023,Expense,Super,Harvey Spector,Credit Card - Ramp,12,55573282.67
06/23/2023,Expense,Super,,Tools & Subscription - G&A,12,55573294.67
06/23/2023,Expense,Superhuman,Mike ross,Credit Card - Ramp,60,55573354.67
06/23/2023,Expense,Super,Harvey Spector,Credit Card - Ramp,12,55573366.67
06/23/2023,Expense,Super,,Tools & Subscription - G&A,12,55573378.67
06/23/2023,Expense,Superhuman,,Professional Service Charges,60,55573438.67
06/23/2023,Expense,Super,,Tools & Subscription - G&A,12,55573450.67
06/23/2023,Expense,The Carrington,,Meals & Entertainment,29.05,55573479.72
06/23/2023,Expense,Superhuman,Mike ross,Credit Card - Ramp,60,55573539.72
06/23/2023,Expense,Super,Harvey Spector,Credit Card - Ramp,12,55573551.72
06/23/2023,Expense,Superhuman,,Professional Service Charges,60,55573611.72
06/23/2023,Expense,The Carrington,Mike ross,Credit Card - Ramp,29.05,55573640.77
06/23/2023,Expense,The Carrington,Mike ross,Credit Card - Ramp,29.05,55573669.82
06/23/2023,Expense,The Carrington,,Meals & Entertainment,29.05,55573698.87
06/23/2023,Expense,The Carrington,Mike ross,Credit Card - Ramp,29.05,55573727.92
06/24/2023,Expense,Uber,,Travelling Expenses,11.48,55573739.4
06/24/2023,Expense,Uber,Mike ross,Credit Card - Ramp,11.49,55573750.89
06/24/2023,Expense,Uber,Mike ross,Credit Card - Ramp,11.48,55573762.37
06/24/2023,Expense,Benedict Evans,Harvey Spector,Credit Card - Ramp,10,55573772.37
06/24/2023,Expense,Uber,Mike ross,Credit Card - Ramp,11.49,55573783.86
06/24/2023,Expense,Benedict Evans,Harvey Spector,Professional Service Charges,10,55573793.86
06/24/2023,Expense,Uber,Mike ross,Credit Card - Ramp,11.48,55573805.34
06/24/2023,Expense,Uber,,Travelling Expenses,11.48,55573816.82
06/24/2023,Expense,Benedict Evans,Harvey Spector,Professional Service Charges,10,55573826.82
06/24/2023,Expense,Benedict Evans,Harvey Spector,Professional Service Charges,10,55573836.82
06/24/2023,Expense,Benedict Evans,Harvey Spector,Credit Card - Ramp,10,55573846.82
06/24/2023,Expense,Uber,,Travelling Expenses,11.49,55573858.31
06/24/2023,Expense,Uber,Mike ross,Credit Card - Ramp,11.48,55573869.79
06/24/2023,Expense,Benedict Evans,Harvey Spector,Credit Card - Ramp,10,55573879.79
06/24/2023,Expense,Uber,,Travelling Expenses,11.48,55573891.27
06/24/2023,Expense,Benedict Evans,Harvey Spector,Professional Service Charges,10,55573901.27
06/24/2023,Expense,Benedict Evans,Harvey Spector,Credit Card - Ramp,10,55573911.27
06/24/2023,Expense,Uber,,Travelling Expenses,11.49,55573922.76
06/24/2023,Expense,Uber,,Travelling Expenses,11.49,55573934.25
06/24/2023,Expense,Uber,,Travelling Expenses,11.49,55573945.74
06/24/2023,Expense,Uber,Mike ross,Credit Card - Ramp,11.49,55573957.23
06/24/2023,Expense,Uber,,Travelling Expenses,11.48,55573968.71
06/25/2023,Expense,Miro,Mike ross,Credit Card - Ramp,100,55574068.71
06/25/2023,Expense,Zoom,,Tools & Subscription - G&A,15.99,55574084.7
06/25/2023,Expense,Cycle App License,,Tools & Subscription - G&A,220,55574304.7
06/25/2023,Expense,Zoom,,Tools & Subscription - G&A,15.99,55574320.69
06/25/2023,Expense,Cycle App License,,Tools & Subscription - G&A,220,55574540.69
06/25/2023,Expense,Miro,Mike ross,Credit Card - Ramp,100,55574640.69
06/25/2023,Expense,Miro,,Tools & Subscription - G&A,100,55574740.69
06/25/2023,Expense,Zoom,,Tools & Subscription - G&A,15.99,55574756.68
06/25/2023,Expense,Cycle App License,,Tools & Subscription - G&A,220,55574976.68
06/25/2023,Expense,Cycle App License,Chad Blumenthal,Credit Card - Ramp,220,55575196.68
06/25/2023,Expense,Zoom,Chad Blumenthal,Credit Card - Ramp,15.99,55575212.67
06/25/2023,Expense,Zoom,,Tools & Subscription - G&A,15.99,55575228.66
06/25/2023,Expense,Cycle App License,Chad Blumenthal,Credit Card - Ramp,220,55575448.66
06/25/2023,Expense,Miro,,Tools & Subscription - G&A,100,55575548.66
06/25/2023,Expense,Cycle App License,,Tools & Subscription - G&A,220,55575768.66
06/25/2023,Expense,Miro,,Tools & Subscription - G&A,100,55575868.66
06/25/2023,Expense,Zoom,Chad Blumenthal,Credit Card - Ramp,15.99,55575884.65
06/25/2023,Expense,Miro,Mike ross,Credit Card - Ramp,100,55575984.65
06/25/2023,Expense,Cycle App License,Chad Blumenthal,Credit Card - Ramp,220,55576204.65
06/25/2023,Expense,Zoom,Chad Blumenthal,Credit Card - Ramp,15.99,55576220.64
06/25/2023,Expense,Miro,,Tools & Subscription - G&A,100,55576320.64
06/26/2023,Bill Payment (Check),ANSR Dubai,BOOK TRANSFER DEBIT 45BOOK DEBIT CHRONICLEHQ INC.*BNF:ANSR (EMEA) GLOBAL SERVICES LIM ITED*BBI:/DAS/REF:44226MS0075Q*STBOOK*TIME:1206*YOUR REF:TEST PAY MENT*OUR REF:177639276,Accounts Payable (A/P),-20,55576300.64
06/26/2023,Expense,Virgin,Chris George,Credit Card - Ramp,236.6,55576537.24
06/26/2023,Expense,Virgin,Chris George,Credit Card - Ramp,2.3,55576539.54
06/26/2023,Expense,Super,Chris George,Credit Card - Ramp,559.65,55577099.19
06/26/2023,Expense,Man-made,Harvey Spector,Professional Service Charges,19,55577118.19
06/26/2023,Expense,Super,,Tools & Subscription - G&A,559.65,55577677.84
06/26/2023,Expense,Virgin,Chris George,Travelling Expenses,236.6,55577914.44
06/26/2023,Expense,Big Company ,,Accounts Payable (A/P),-25.07,55577889.37
06/26/2023,Expense,Virgin,Chris George,Travelling Expenses,2.3,55577891.67
06/26/2023,Expense,Virgin,Chris George,Travelling Expenses,2.3,55577893.97
06/26/2023,Expense,The Commons Surry Hil,,Travel:Hotels,4.18,55577898.15
06/26/2023,Expense,Man-made,Harvey Spector,Professional Service Charges,19,55577917.15
06/26/2023,Bill Payment (Check),ANSR Dubai,,HSBC A/c,-20,55577897.15
06/26/2023,Expense,Man-made,Harvey Spector,Professional Service Charges,19,55577916.15
06/26/2023,Expense,Super,,Tools & Subscription - G&A,559.65,55578475.8
06/26/2023,Expense,Virgin,Chris George,Travelling Expenses,2.3,55578478.1
06/26/2023,Expense,Big Company ,Testing payment BOOK TRANSFER DEBIT 45BOOK DEBIT CHRONICLEHQ INC.*BNF:Big Company *BBI /DAS/REF:17206MR009W6*EXCH:INR 2000.00 AT 0.0125326*STBOOK*TIME: 0955*YOUR REF:TEST TRANSFER*OUR REF:177604750*TMS:2023-06-26T13:5 5:00 GMT*MID:0.01219312,HSBC A/c,-25.07,55578453.03
06/26/2023,Bill Payment (Check),ANSR Dubai,BOOK TRANSFER DEBIT 45BOOK DEBIT CHRONICLEHQ INC.*BNF:ANSR (EMEA) GLOBAL SERVICES LIM ITED*BBI:/DAS/REF:44226MS0075Q*STBOOK*TIME:1206*YOUR REF:TEST PAY MENT*OUR REF:177639276,Accounts Payable (A/P),-20,55578433.03
06/26/2023,Expense,Big Company ,,Accounts Payable (A/P),-25.07,55578407.96
06/26/2023,Expense,The Commons Surry Hil,,Travel:Hotels,4.18,55578412.14
06/26/2023,Expense,The Commons Surry Hil,Mike ross,Credit Card - Ramp,4.18,55578416.32
06/26/2023,Expense,Man-made,Harvey Spector,Credit Card - Ramp,19,55578435.32
06/26/2023,Expense,Big Company ,Testing payment BOOK TRANSFER DEBIT 45BOOK DEBIT CHRONICLEHQ INC.*BNF:Big Company *BBI /DAS/REF:17206MR009W6*EXCH:INR 2000.00 AT 0.0125326*STBOOK*TIME: 0955*YOUR REF:TEST TRANSFER*OUR REF:177604750*TMS:2023-06-26T13:5 5:00 GMT*MID:0.01219312,HSBC A/c,-25.07,55578410.25
06/26/2023,Expense,Big Company ,Testing payment BOOK TRANSFER DEBIT 45BOOK DEBIT CHRONICLEHQ INC.*BNF:Big Company *BBI /DAS/REF:17206MR009W6*EXCH:INR 2000.00 AT 0.0125326*STBOOK*TIME: 0955*YOUR REF:TEST TRANSFER*OUR REF:177604750*TMS:2023-06-26T13:5 5:00 GMT*MID:0.01219312,HSBC A/c,-25.07,55578385.18
06/26/2023,Expense,Virgin,Chris George,Travelling Expenses,236.6,55578621.78
06/26/2023,Expense,Super,,Tools & Subscription - G&A,559.65,55579181.43
06/26/2023,Expense,Man-made,Harvey Spector,Credit Card - Ramp,19,55579200.43
06/26/2023,Expense,Virgin,Chris George,Travelling Expenses,236.6,55579437.03
06/26/2023,Expense,Virgin,Chris George,Travelling Expenses,236.6,55579673.63
06/26/2023,Expense,The Commons Surry Hil,Mike ross,Credit Card - Ramp,4.18,55579677.81
06/26/2023,Expense,Man-made,Harvey Spector,Credit Card - Ramp,19,55579696.81
06/26/2023,Expense,The Commons Surry Hil,Mike ross,Credit Card - Ramp,4.18,55579700.99
06/26/2023,Expense,The Commons Surry Hil,,Travel:Hotels,4.18,55579705.17
06/26/2023,Expense,Super,,Tools & Subscription - G&A,559.65,55580264.82
06/26/2023,Bill Payment (Check),ANSR Dubai,,HSBC A/c,-20,55580244.82
06/26/2023,Bill Payment (Check),ANSR Dubai,,HSBC A/c,-20,55580224.82
06/26/2023,Expense,The Commons Surry Hil,,Travel:Hotels,4.18,55580229
06/26/2023,Expense,Big Company ,,Accounts Payable (A/P),-25.07,55580203.93
06/26/2023,Expense,Man-made,Harvey Spector,Credit Card - Ramp,19,55580222.93
06/26/2023,Expense,Super,Chris George,Credit Card - Ramp,559.65,55580782.58
06/26/2023,Bill Payment (Check),ANSR Dubai,BOOK TRANSFER DEBIT 45BOOK DEBIT CHRONICLEHQ INC.*BNF:ANSR (EMEA) GLOBAL SERVICES LIM ITED*BBI:/DAS/REF:44226MS0075Q*STBOOK*TIME:1206*YOUR REF:TEST PAY MENT*OUR REF:177639276,Accounts Payable (A/P),-20,55580762.58
06/26/2023,Expense,Super,Chris George,Credit Card - Ramp,559.65,55581322.23
06/26/2023,Expense,Virgin,Chris George,Credit Card - Ramp,236.6,55581558.83
06/26/2023,Expense,Man-made,Harvey Spector,Professional Service Charges,19,55581577.83
06/26/2023,Expense,Virgin,Chris George,Travelling Expenses,2.3,55581580.13
06/26/2023,Expense,Virgin,Chris George,Credit Card - Ramp,236.6,55581816.73
06/26/2023,Expense,Virgin,Chris George,Credit Card - Ramp,2.3,55581819.03
06/26/2023,Expense,Big Company ,,Accounts Payable (A/P),-25.07,55581793.96
06/26/2023,Expense,Big Company ,Testing payment BOOK TRANSFER DEBIT 45BOOK DEBIT CHRONICLEHQ INC.*BNF:Big Company *BBI /DAS/REF:17206MR009W6*EXCH:INR 2000.00 AT 0.0125326*STBOOK*TIME: 0955*YOUR REF:TEST TRANSFER*OUR REF:177604750*TMS:2023-06-26T13:5 5:00 GMT*MID:0.01219312,HSBC A/c,-25.07,55581768.89
06/26/2023,Bill Payment (Check),ANSR Dubai,,HSBC A/c,-20,55581748.89
06/26/2023,Bill Payment (Check),ANSR Dubai,BOOK TRANSFER DEBIT 45BOOK DEBIT CHRONICLEHQ INC.*BNF:ANSR (EMEA) GLOBAL SERVICES LIM ITED*BBI:/DAS/REF:44226MS0075Q*STBOOK*TIME:1206*YOUR REF:TEST PAY MENT*OUR REF:177639276,Accounts Payable (A/P),-20,55581728.89
06/26/2023,Expense,Virgin,Chris George,Credit Card - Ramp,2.3,55581731.19
06/27/2023,Expense,TenTo,Mike ross,Meals & Entertainment,16.07,55581747.26
06/27/2023,Expense,Sentry,Balapavan Tirumani,Credit Card - Ramp,29,55581776.26
06/27/2023,Expense,TenTo,Mike ross,Meals & Entertainment,16.07,55581792.33
06/27/2023,Expense,Splitbee,Harris Jose,Credit Card - Ramp,16.52,55581808.85
06/27/2023,Expense,Sendinblue,Balapavan Tirumani,Credit Card - Ramp,75.86,55581884.71
06/27/2023,Expense,Splitbee,,Tools & Subscription - G&A,16.52,55581901.23
06/27/2023,Expense,TenTo,Mike ross,Credit Card - Ramp,16.07,55581917.3
06/27/2023,Expense,Lucky Pickle Dumpling Co,Mike ross,Credit Card - Ramp,22.35,55581939.65
06/27/2023,Expense,TenTo,Mike ross,Meals & Entertainment,16.07,55581955.72
06/27/2023,Expense,Lucky Pickle Dumpling Co,Mike ross,Meals & Entertainment,22.35,55581978.07
06/27/2023,Bill Payment (Check),EntityA,,Bank account - Airwallex,-188322.26,55393655.81
06/27/2023,Credit Card Credit,Uber,,Travelling Expenses,-11.48,55393644.33
06/27/2023,Bill Payment (Check),EntityA,,Account2,-200000,55193644.33
06/27/2023,Expense,Sendinblue,,Tools & Subscription - G&A,75.86,55193720.19
06/27/2023,Expense,Lucky Pickle Dumpling Co,Mike ross,Meals & Entertainment,22.35,55193742.54
06/27/2023,Expense,Sendinblue,Balapavan Tirumani,Credit Card - Ramp,75.86,55193818.4
06/27/2023,Bill Payment (Check),EntityA,Exchange Gain Or Loss,Bank account - Airwallex,11677.74,55205496.14
06/27/2023,Expense,Lucky Pickle Dumpling Co,Mike ross,Credit Card - Ramp,22.35,55205518.49
06/27/2023,Expense,Splitbee,Harris Jose,Credit Card - Ramp,16.52,55205535.01
06/27/2023,Expense,TenTo,Mike ross,Credit Card - Ramp,16.07,55205551.08
06/27/2023,Expense,TenTo,Mike ross,Credit Card - Ramp,16.07,55205567.15
06/27/2023,Credit Card Credit,Uber,Mike ross,Credit Card - Ramp,-11.48,55205555.67
06/27/2023,Credit Card Credit,Uber,Mike ross,Credit Card - Ramp,-11.48,55205544.19
06/27/2023,Expense,Lucky Pickle Dumpling Co,Mike ross,Credit Card - Ramp,22.35,55205566.54
06/27/2023,Expense,Lucky Pickle Dumpling Co,Mike ross,Meals & Entertainment,22.35,55205588.89
06/27/2023,Expense,Sentry,,Tools & Subscription - G&A,29,55205617.89
06/27/2023,Credit Card Credit,Uber,,Travelling Expenses,-11.48,55205606.41
06/27/2023,Expense,Sendinblue,,Tools & Subscription - G&A,75.86,55205682.27
06/27/2023,Expense,Sentry,,Tools & Subscription - G&A,29,55205711.27
06/27/2023,Expense,TenTo,Mike ross,Credit Card - Ramp,16.07,55205727.34
06/27/2023,Expense,Lucky Pickle Dumpling Co,Mike ross,Credit Card - Ramp,22.35,55205749.69
06/27/2023,Expense,Sendinblue,,Tools & Subscription - G&A,75.86,55205825.55
06/27/2023,Bill Payment (Check),EntityA,Exchange Gain Or Loss,Bank account - Airwallex,11677.74,55217503.29
06/27/2023,Bill Payment (Check),EntityA,,Account2,-200000,55017503.29
06/27/2023,Expense,Splitbee,,Tools & Subscription - G&A,16.52,55017519.81
06/27/2023,Bill Payment (Check),EntityA,,Bank account - Airwallex,-188322.26,54829197.55
06/27/2023,Expense,TenTo,Mike ross,Meals & Entertainment,16.07,54829213.62
06/27/2023,Bill Payment (Check),EntityA,,Account2,-200000,54629213.62
06/27/2023,Bill Payment (Check),EntityA,Exchange Gain Or Loss,Bank account - Airwallex,11677.74,54640891.36
06/27/2023,Credit Card Credit,Uber,Mike ross,Credit Card - Ramp,-11.48,54640879.88
06/27/2023,Expense,Sendinblue,Balapavan Tirumani,Credit Card - Ramp,75.86,54640955.74
06/27/2023,Expense,Sentry,,Tools & Subscription - G&A,29,54640984.74
06/27/2023,Expense,Splitbee,Harris Jose,Credit Card - Ramp,16.52,54641001.26
06/27/2023,Expense,Sentry,Balapavan Tirumani,Credit Card - Ramp,29,54641030.26
06/27/2023,Bill Payment (Check),EntityA,,Account2,-200000,54441030.26
06/27/2023,Expense,Sentry,Balapavan Tirumani,Credit Card - Ramp,29,54441059.26
06/27/2023,Bill Payment (Check),EntityA,,Bank account - Airwallex,-188322.26,54252737
06/27/2023,Expense,Sendinblue,,Tools & Subscription - G&A,75.86,54252812.86
06/27/2023,Expense,Sentry,,Tools & Subscription - G&A,29,54252841.86
06/27/2023,Expense,Lucky Pickle Dumpling Co,Mike ross,Meals & Entertainment,22.35,54252864.21
06/27/2023,Credit Card Credit,Uber,,Travelling Expenses,-11.48,54252852.73
06/27/2023,Expense,Splitbee,,Tools & Subscription - G&A,16.52,54252869.25
06/27/2023,Expense,Splitbee,,Tools & Subscription - G&A,16.52,54252885.77
06/27/2023,Bill Payment (Check),EntityA,,Bank account - Airwallex,-188322.26,54064563.51
06/27/2023,Credit Card Credit,Uber,,Travelling Expenses,-11.48,54064552.03
06/28/2023,Expense,The Commons Surry Hil,Mike ross,Credit Card - Ramp,4.14,54064556.17
06/28/2023,Expense,Apple,Mike ross,Credit Card - Ramp,1938.5,54066494.67
06/28/2023,Expense,Github,Balapavan Tirumani,Credit Card - Ramp,44,54066538.67
06/28/2023,Expense,Github,Balapavan Tirumani,Credit Card - Ramp,10,54066548.67
06/28/2023,Expense,The Commons Surry Hil,Mike ross,Credit Card - Ramp,4.14,54066552.81
06/28/2023,Expense,Uber,,Travelling Expenses,10.92,54066563.73
06/28/2023,Expense,Github,,Tools & Subscription - G&A,44,54066607.73
06/28/2023,Expense,Uber,Mike ross,Credit Card - Ramp,10.92,54066618.65
06/28/2023,Expense,Apple,Mike ross,laptop - Macbook,1938.5,54068557.15
06/28/2023,Expense,Github,Balapavan Tirumani,Credit Card - Ramp,44,54068601.15
06/28/2023,Expense,Uber,Mike ross,Credit Card - Ramp,10.92,54068612.07
06/28/2023,Expense,Github,Balapavan Tirumani,Credit Card - Ramp,44,54068656.07
06/28/2023,Expense,Github,,Tools & Subscription - G&A,10,54068666.07
06/28/2023,Expense,Apple,Mike ross,Credit Card - Ramp,1938.5,54070604.57
06/28/2023,Expense,Github,,Tools & Subscription - G&A,10,54070614.57
06/28/2023,Expense,The Commons Surry Hil,,Travel:Hotels,4.14,54070618.71
06/28/2023,Expense,Github,,Tools & Subscription - G&A,10,54070628.71
06/28/2023,Expense,Github,Balapavan Tirumani,Credit Card - Ramp,10,54070638.71
06/28/2023,Expense,The Commons Surry Hil,,Travel:Hotels,4.14,54070642.85
06/28/2023,Expense,The Commons Surry Hil,,Travel:Hotels,4.14,54070646.99
06/28/2023,Expense,Github,Balapavan Tirumani,Credit Card - Ramp,10,54070656.99
06/28/2023,Expense,Apple,Mike ross,Credit Card - Ramp,1938.5,54072595.49
06/28/2023,Expense,Uber,,Travelling Expenses,10.92,54072606.41
06/28/2023,Expense,Github,,Tools & Subscription - G&A,44,54072650.41
06/28/2023,Expense,Uber,Mike ross,Credit Card - Ramp,10.92,54072661.33
06/28/2023,Expense,Github,,Tools & Subscription - G&A,44,54072705.33
06/28/2023,Expense,Apple,Mike ross,Credit Card - Ramp,1938.5,54074643.83
06/28/2023,Expense,Apple,Mike ross,laptop - Macbook,1938.5,54076582.33
06/28/2023,Expense,The Commons Surry Hil,Mike ross,Credit Card - Ramp,4.14,54076586.47
06/28/2023,Expense,Apple,Mike ross,laptop - Macbook,1938.5,54078524.97
06/28/2023,Expense,Uber,,Travelling Expenses,10.92,54078535.89
06/28/2023,Expense,The Commons Surry Hil,,Travel:Hotels,4.14,54078540.03
06/28/2023,Expense,Github,,Tools & Subscription - G&A,44,54078584.03
06/28/2023,Expense,Apple,Mike ross,laptop - Macbook,1938.5,54080522.53
06/28/2023,Expense,Uber,,Travelling Expenses,10.92,54080533.45
06/28/2023,Expense,Github,,Tools & Subscription - G&A,10,54080543.45
06/29/2023,Expense,Netlify,,Tools & Subscription - G&A,38,54080581.45
06/29/2023,Expense,Netlify,Balapavan Tirumani,Credit Card - Ramp,38,54080619.45
06/29/2023,Expense,Netlify,Balapavan Tirumani,Credit Card - Ramp,38,54080657.45
06/29/2023,Expense,Pieno,Mike ross,Meals & Entertainment,29.51,54080686.96
06/29/2023,Expense,Netlify,,Tools & Subscription - G&A,38,54080724.96
06/29/2023,Expense,Netlify,,Tools & Subscription - G&A,38,54080762.96
06/29/2023,Expense,Pieno,Mike ross,Meals & Entertainment,29.51,54080792.47
06/29/2023,Expense,Pieno,Mike ross,Credit Card - Ramp,29.51,54080821.98
06/29/2023,Expense,Netlify,Balapavan Tirumani,Credit Card - Ramp,38,54080859.98
06/29/2023,Expense,Pieno,Mike ross,Credit Card - Ramp,29.51,54080889.49
06/29/2023,Expense,Pieno,Mike ross,Meals & Entertainment,29.51,54080919
06/29/2023,Expense,Pieno,Mike ross,Meals & Entertainment,29.51,54080948.51
06/29/2023,Expense,Netlify,,Tools & Subscription - G&A,38,54080986.51
06/29/2023,Expense,Pieno,Mike ross,Credit Card - Ramp,29.51,54081016.02
06/29/2023,Expense,Pieno,Mike ross,Credit Card - Ramp,29.51,54081045.53
06/30/2023,Expense,inkle,,Tools & Subscription - G&A,99,54081144.53
06/30/2023,Expense,inkle,,Tools & Subscription - G&A,30,54081174.53
06/30/2023,Expense,Adobe,,Tools & Subscription - S&M,15.05,54081189.58
06/30/2023,Expense,Harvey's Hot Sandwiches,Mike ross,Credit Card - Ramp,22.58,54081212.16
06/30/2023,Bill,Big Company ,,Outsources Services - India,30427.9,54111640.06
06/30/2023,Expense,inkle,Harvey Spector,Credit Card - Ramp,99,54111739.06
06/30/2023,Expense,Harvey's Hot Sandwiches,Mike ross,Credit Card - Ramp,22.58,54111761.64
06/30/2023,Expense,inkle,Harvey Spector,Credit Card - Ramp,30,54111791.64
06/30/2023,Expense,inkle,Harvey Spector,Credit Card - Ramp,99,54111890.64
06/30/2023,Bill,ANSR Dubai,Service Fees for June 2023,Accounts Payable (A/P),12000,54123890.64
06/30/2023,Expense,inkle,,Tools & Subscription - G&A,30,54123920.64
06/30/2023,Bill,EntityA,June2023 Quarter expenses incurred plus 10% mark up per the MSA,Account2,139290.32,54263210.96
06/30/2023,Expense,Big Company ,,Accounts Payable (A/P),-25000,54238210.96
06/30/2023,Expense,Big Company ,,Accounts Payable (A/P),-25000,54213210.96
06/30/2023,Expense,Adobe,,Tools & Subscription - S&M,15.05,54213226.01
06/30/2023,Expense,Paramount Coffee Proj Restaurant,Mike ross,Meals & Entertainment,15.92,54213241.93
06/30/2023,Expense,Big Company ,"ADVANCE Q2
BOOK TRANSFER DEBIT 45BOOK DEBIT CHRONICLEHQ INC.*BNF:Big Company *BBI /DAS/REF:68486MU01GWC*STBOOK*TIME:0603*YOUR REF:ADVANCE Q2*OUR R EF:181307519",HSBC A/c,-25000,54188241.93
06/30/2023,Expense,Big Company ,"ADVANCE Q2
BOOK TRANSFER DEBIT 45BOOK DEBIT CHRONICLEHQ INC.*BNF:Big Company *BBI /DAS/REF:68486MU01GWC*STBOOK*TIME:0603*YOUR REF:ADVANCE Q2*OUR R EF:181307519",HSBC A/c,-25000,54163241.93
06/30/2023,Bill,EntityA,,outsources Services - Australia,139290.32,54302532.25
06/30/2023,Bill,ANSR Dubai,Service Fees for June 2023,Accounts Payable (A/P),12000,54314532.25
06/30/2023,Expense,Big Company ,,Accounts Payable (A/P),-25000,54289532.25
06/30/2023,Expense,Paramount Coffee Proj Restaurant,Mike ross,Credit Card - Ramp,15.92,54289548.17
06/30/2023,Expense,Adobe,Mike ross,Credit Card - Ramp,15.05,54289563.22
06/30/2023,Expense,Big Company ,"ADVANCE Q2
BOOK TRANSFER DEBIT 45BOOK DEBIT CHRONICLEHQ INC.*BNF:Big Company *BBI /DAS/REF:68486MU01GWC*STBOOK*TIME:0603*YOUR REF:ADVANCE Q2*OUR R EF:181307519",HSBC A/c,-25000,54264563.22
06/30/2023,Expense,Harvey's Hot Sandwiches,Mike ross,Meals & Entertainment,22.58,54264585.8
06/30/2023,Bill,Big Company ,,Outsources Services - India,30427.9,54295013.7
06/30/2023,Bill,Big Company ,,Outsources Services - India,30427.9,54325441.6
06/30/2023,Bill,EntityA,,outsources Services - Australia,139290.32,54464731.92
06/30/2023,Bill,Big Company ,"Service Expenses for the month of June 2023 
INR      24,96,901       @   82.0596",Accounts Payable (A/P),30427.9,54495159.82
06/30/2023,Bill,EntityA,June2023 Quarter expenses incurred plus 10% mark up per the MSA,Account2,139290.32,54634450.14
06/30/2023,Bill,EntityA,,outsources Services - Australia,139290.32,54773740.46
06/30/2023,Expense,Big Company ,,Accounts Payable (A/P),-25000,54748740.46
06/30/2023,Expense,Adobe,Mike ross,Credit Card - Ramp,15.05,54748755.51
06/30/2023,Expense,Big Company ,"ADVANCE Q2
BOOK TRANSFER DEBIT 45BOOK DEBIT CHRONICLEHQ INC.*BNF:Big Company *BBI /DAS/REF:68486MU01GWC*STBOOK*TIME:0603*YOUR REF:ADVANCE Q2*OUR R EF:181307519",HSBC A/c,-25000,54723755.51
06/30/2023,Expense,Harvey's Hot Sandwiches,Mike ross,Meals & Entertainment,22.58,54723778.09
06/30/2023,Bill,ANSR Dubai,,Professional Service Charges,12000,54735778.09
06/30/2023,Expense,Harvey's Hot Sandwiches,Mike ross,Credit Card - Ramp,22.58,54735800.67
06/30/2023,Expense,Paramount Coffee Proj Restaurant,Mike ross,Credit Card - Ramp,15.92,54735816.59
06/30/2023,Bill,ANSR Dubai,Service Fees for June 2023,Accounts Payable (A/P),12000,54747816.59
06/30/2023,Bill,ANSR Dubai,Service Fees for June 2023,Accounts Payable (A/P),12000,54759816.59
06/30/2023,Bill,Big Company ,,Outsources Services - India,30427.9,54790244.49
06/30/2023,Expense,inkle,Harvey Spector,Credit Card - Ramp,30,54790274.49
06/30/2023,Bill,EntityA,June2023 Quarter expenses incurred plus 10% mark up per the MSA,Account2,139290.32,54929564.81
06/30/2023,Bill,EntityA,,outsources Services - Australia,139290.32,55068855.13
06/30/2023,Bill,ANSR Dubai,,Professional Service Charges,12000,55080855.13
06/30/2023,Expense,Adobe,Mike ross,Credit Card - Ramp,15.05,55080870.18
06/30/2023,Expense,Adobe,,Tools & Subscription - S&M,15.05,55080885.23
06/30/2023,Bill,EntityA,June2023 Quarter expenses incurred plus 10% mark up per the MSA,Account2,139290.32,55220175.55
06/30/2023,Bill,Big Company ,"Service Expenses for the month of June 2023 
INR      24,96,901       @   82.0596",Accounts Payable (A/P),30427.9,55250603.45
06/30/2023,Bill,Big Company ,"Service Expenses for the month of June 2023 
INR      24,96,901       @   82.0596",Accounts Payable (A/P),30427.9,55281031.35
06/30/2023,Expense,inkle,Harvey Spector,Credit Card - Ramp,30,55281061.35
06/30/2023,Expense,Paramount Coffee Proj Restaurant,Mike ross,Meals & Entertainment,15.92,55281077.27
06/30/2023,Bill,Big Company ,"Service Expenses for the month of June 2023 
INR      24,96,901       @   82.0596",Accounts Payable (A/P),30427.9,55311505.17
06/30/2023,Expense,inkle,,Tools & Subscription - G&A,30,55311535.17
06/30/2023,Expense,Paramount Coffee Proj Restaurant,Mike ross,Credit Card - Ramp,15.92,55311551.09
06/30/2023,Expense,inkle,Harvey Spector,Credit Card - Ramp,99,55311650.09
06/30/2023,Bill,ANSR Dubai,,Professional Service Charges,12000,55323650.09
06/30/2023,Expense,Harvey's Hot Sandwiches,Mike ross,Meals & Entertainment,22.58,55323672.67
06/30/2023,Expense,Harvey's Hot Sandwiches,Mike ross,Meals & Entertainment,22.58,55323695.25
06/30/2023,Expense,Paramount Coffee Proj Restaurant,Mike ross,Meals & Entertainment,15.92,55323711.17
06/30/2023,Expense,inkle,,Tools & Subscription - G&A,99,55323810.17
06/30/2023,Expense,inkle,,Tools & Subscription - G&A,99,55323909.17
06/30/2023,Expense,Adobe,,Tools & Subscription - S&M,15.05,55323924.22
06/30/2023,Bill,ANSR Dubai,,Professional Service Charges,12000,55335924.22
06/30/2023,Expense,Harvey's Hot Sandwiches,Mike ross,Credit Card - Ramp,22.58,55335946.8
06/30/2023,Expense,Paramount Coffee Proj Restaurant,Mike ross,Credit Card - Ramp,15.92,55335962.72
06/30/2023,Expense,Paramount Coffee Proj Restaurant,Mike ross,Meals & Entertainment,15.92,55335978.64
06/30/2023,Expense,inkle,,Tools & Subscription - G&A,99,55336077.64
06/30/2023,Expense,inkle,,Tools & Subscription - G&A,30,55336107.64
07/01/2023,Expense,Google G Suite,,Tools & Subscription - G&A,140.27,55336247.91
07/01/2023,Expense,Google G Suite,,Tools & Subscription - G&A,140.27,55336388.18
07/01/2023,Expense,Google G Suite,Mike ross,Credit Card - Ramp,140.27,55336528.45
07/01/2023,Expense,Google G Suite,Mike ross,Credit Card - Ramp,140.27,55336668.72
07/01/2023,Expense,Google G Suite,,Tools & Subscription - G&A,140.27,55336808.99
07/01/2023,Expense,Google G Suite,,Tools & Subscription - G&A,140.27,55336949.26
07/01/2023,Expense,Google G Suite,Mike ross,Credit Card - Ramp,140.27,55337089.53
07/03/2023,Expense,Uber,,Travelling Expenses,8.26,55337097.79
07/03/2023,Expense,Uber,Mike ross,Credit Card - Ramp,8.26,55337106.05
07/03/2023,Expense,VirtualPostMail,Harvey Spector,Credit Card - Ramp,35,55337141.05
07/03/2023,Bill Payment (Check),ANSR Dubai,,HSBC A/c,-28450,55308691.05
07/03/2023,Bill Payment (Check),ANSR Dubai,,Accounts Payable (A/P),-28450,55280241.05
07/03/2023,Expense,VirtualPostMail,,General business expenses:Memberships & subscriptions,35,55280276.05
07/03/2023,Expense,VirtualPostMail,Harvey Spector,Credit Card - Ramp,35,55280311.05
07/03/2023,Bill Payment (Check),ANSR Dubai,,Accounts Payable (A/P),-28450,55251861.05
07/03/2023,Expense,Uber,Mike ross,Credit Card - Ramp,8.26,55251869.31
07/03/2023,Bill Payment (Check),ANSR Dubai,,HSBC A/c,-28450,55223419.31
07/03/2023,Expense,Uber,,Travelling Expenses,7.79,55223427.1
07/03/2023,Expense,VirtualPostMail,,General business expenses:Memberships & subscriptions,35,55223462.1
07/03/2023,Expense,Uber,,Travelling Expenses,8.26,55223470.36
07/03/2023,Bill Payment (Check),ANSR Dubai,,Accounts Payable (A/P),-28450,55195020.36
07/03/2023,Expense,VirtualPostMail,Harvey Spector,Credit Card - Ramp,35,55195055.36
07/03/2023,Expense,Uber,,Travelling Expenses,7.79,55195063.15
07/03/2023,Expense,Uber,,Travelling Expenses,7.79,55195070.94
07/03/2023,Expense,Uber,Mike ross,Credit Card - Ramp,7.79,55195078.73
07/03/2023,Expense,Uber,Mike ross,Credit Card - Ramp,7.79,55195086.52
07/03/2023,Expense,Uber,,Travelling Expenses,8.26,55195094.78
07/03/2023,Bill Payment (Check),ANSR Dubai,,HSBC A/c,-28450,55166644.78
07/03/2023,Bill Payment (Check),ANSR Dubai,,HSBC A/c,-28450,55138194.78
07/03/2023,Expense,VirtualPostMail,Harvey Spector,Credit Card - Ramp,35,55138229.78
07/03/2023,Expense,VirtualPostMail,,General business expenses:Memberships & subscriptions,35,55138264.78
07/03/2023,Expense,Uber,Mike ross,Credit Card - Ramp,7.79,55138272.57
07/03/2023,Expense,Uber,,Travelling Expenses,7.79,55138280.36
07/03/2023,Bill Payment (Check),ANSR Dubai,,Accounts Payable (A/P),-28450,55109830.36
07/03/2023,Expense,Uber,,Travelling Expenses,8.26,55109838.62
07/03/2023,Expense,VirtualPostMail,,General business expenses:Memberships & subscriptions,35,55109873.62
07/03/2023,Expense,Uber,Mike ross,Credit Card - Ramp,8.26,55109881.88
07/04/2023,Expense,June,Balapavan Tirumani,Credit Card - Ramp,149,55110030.88
07/04/2023,Expense,Surry Hills Post,Mike ross,Office expenses,51.1,55110081.98
07/04/2023,Expense,June,,Tools & Subscription - G&A,149,55110230.98
07/04/2023,Expense,June,,Tools & Subscription - G&A,149,55110379.98
07/04/2023,Expense,Surry Hills Post,Mike ross,Credit Card - Ramp,51.1,55110431.08
07/04/2023,Expense,Surry Hills Post,Mike ross,Credit Card - Ramp,51.1,55110482.18
07/04/2023,Expense,Surry Hills Post,Mike ross,Office expenses,51.1,55110533.28
07/04/2023,Expense,Surry Hills Post,Mike ross,Credit Card - Ramp,51.1,55110584.38
07/04/2023,Expense,Apple,Mike ross,Credit Card - Ramp,2757.65,55113342.03
07/04/2023,Expense,Apple,Mike ross,laptop - Macbook,2757.65,55116099.68
07/04/2023,Expense,Surry Hills Post,Mike ross,Office expenses,51.1,55116150.78
07/04/2023,Expense,Apple,Mike ross,laptop - Macbook,2757.65,55118908.43
07/04/2023,Expense,June,,Tools & Subscription - G&A,149,55119057.43
07/04/2023,Expense,Apple,Mike ross,laptop - Macbook,2757.65,55121815.08
07/04/2023,Expense,June,,Tools & Subscription - G&A,149,55121964.08
07/04/2023,Expense,June,Balapavan Tirumani,Credit Card - Ramp,149,55122113.08
07/04/2023,Expense,Apple,Mike ross,Credit Card - Ramp,2757.65,55124870.73
07/04/2023,Expense,June,Balapavan Tirumani,Credit Card - Ramp,149,55125019.73
07/04/2023,Expense,Surry Hills Post,Mike ross,Credit Card - Ramp,51.1,55125070.83
07/04/2023,Expense,Apple,Mike ross,Credit Card - Ramp,2757.65,55127828.48
07/04/2023,Expense,Apple,Mike ross,Credit Card - Ramp,2757.65,55130586.13
07/04/2023,Expense,Apple,Mike ross,laptop - Macbook,2757.65,55133343.78
07/04/2023,Expense,Surry Hills Post,Mike ross,Office expenses,51.1,55133394.88
07/05/2023,Deposit,,Interest Accrual INTEREST,Savings (6977),3.7,55133398.58
07/05/2023,Deposit,,Interest Accrual INTEREST,Savings (6977),3.7,55133402.28
07/05/2023,Expense,Maloneys Grocer,Mike ross,Credit Card - Ramp,11.05,55133413.33
07/05/2023,Expense,Maloneys Grocer,Mike ross,Credit Card - Ramp,11.05,55133424.38
07/05/2023,Deposit,,Interest Accrual INTEREST,Interest Received,3.7,55133428.08
07/05/2023,Deposit,,Interest Accrual INTEREST,Interest Received,3.7,55133431.78
07/05/2023,Expense,Maloneys Grocer,,Meals & Entertainment,11.05,55133442.83
07/05/2023,Expense,Maloneys Grocer,Mike ross,Credit Card - Ramp,11.05,55133453.88
07/05/2023,Expense,Maloneys Grocer,,Meals & Entertainment,11.05,55133464.93
07/05/2023,Expense,Render,,Tools & Subscription - G&A,248.99,55133713.92
07/05/2023,Deposit,,Interest Accrual INTEREST,Interest Received,3.7,55133717.62
07/05/2023,Expense,Render,Balapavan Tirumani,Credit Card - Ramp,248.99,55133966.61
07/05/2023,Deposit,,Interest Accrual INTEREST,Savings (6977),3.7,55133970.31
07/05/2023,Expense,Render,,Tools & Subscription - G&A,248.99,55134219.3
07/05/2023,Expense,Maloneys Grocer,,Meals & Entertainment,11.05,55134230.35
07/05/2023,Expense,Render,,Tools & Subscription - G&A,248.99,55134479.34
07/05/2023,Expense,Render,Balapavan Tirumani,Credit Card - Ramp,248.99,55134728.33
07/05/2023,Expense,Render,,Tools & Subscription - G&A,248.99,55134977.32
07/05/2023,Expense,Render,Balapavan Tirumani,Credit Card - Ramp,248.99,55135226.31
07/05/2023,Deposit,,Interest Accrual INTEREST,Interest Received,3.7,55135230.01
07/05/2023,Expense,Maloneys Grocer,Mike ross,Credit Card - Ramp,11.05,55135241.06
07/05/2023,Expense,Maloneys Grocer,,Meals & Entertainment,11.05,55135252.11
07/06/2023,Expense,Midjourney,Chris George,Credit Card - Ramp,96,55135348.11
07/06/2023,Expense,Graphics Press,,Tools & Subscription - G&A,120,55135468.11
07/06/2023,Expense,The Sweet Chick,Mike ross,Credit Card - Ramp,11.93,55135480.04
07/06/2023,Expense,Graphics Press,Mike ross,Credit Card - Ramp,120,55135600.04
07/06/2023,Expense,Midjourney,,Tools & Subscription - G&A,96,55135696.04
07/06/2023,Expense,Adobe,,Tools & Subscription - S&M,84.23,55135780.27
07/06/2023,Expense,The Sweet Chick,,Meals & Entertainment,11.93,55135792.2
07/06/2023,Expense,The Dolphin Hotel,Mike ross,Credit Card - Ramp,46.31,55135838.51
07/06/2023,Expense,Graphics Press,,Tools & Subscription - G&A,120,55135958.51
07/06/2023,Expense,Adobe,,Tools & Subscription - S&M,84.23,55136042.74
07/06/2023,Expense,Graphics Press,Mike ross,Credit Card - Ramp,120,55136162.74
07/06/2023,Expense,Midjourney,,Tools & Subscription - G&A,96,55136258.74
07/06/2023,Expense,The Commons Surry Hil,,Travel:Hotels,7.59,55136266.33
07/06/2023,Expense,The Commons Surry Hil,Mike ross,Credit Card - Ramp,7.59,55136273.92
07/06/2023,Expense,The Dolphin Hotel,,Meals & Entertainment,46.31,55136320.23
07/06/2023,Expense,The Sweet Chick,Mike ross,Credit Card - Ramp,11.93,55136332.16
07/06/2023,Expense,Midjourney,Chris George,Credit Card - Ramp,96,55136428.16
07/06/2023,Expense,Graphics Press,Mike ross,Credit Card - Ramp,120,55136548.16
07/06/2023,Expense,The Dolphin Hotel,Mike ross,Credit Card - Ramp,46.31,55136594.47
07/06/2023,Expense,Adobe,Mike ross,Credit Card - Ramp,84.23,55136678.7
07/06/2023,Expense,The Dolphin Hotel,,Meals & Entertainment,46.31,55136725.01
07/06/2023,Expense,The Sweet Chick,,Meals & Entertainment,11.93,55136736.94
07/06/2023,Expense,Graphics Press,,Tools & Subscription - G&A,120,55136856.94
07/06/2023,Expense,The Commons Surry Hil,,Travel:Hotels,7.59,55136864.53
07/06/2023,Expense,Midjourney,Chris George,Credit Card - Ramp,96,55136960.53
07/06/2023,Expense,The Commons Surry Hil,,Travel:Hotels,7.59,55136968.12
07/06/2023,Expense,Midjourney,,Tools & Subscription - G&A,96,55137064.12
07/06/2023,Expense,The Dolphin Hotel,,Meals & Entertainment,46.31,55137110.43
07/06/2023,Expense,Adobe,,Tools & Subscription - S&M,84.23,55137194.66
07/06/2023,Expense,The Sweet Chick,,Meals & Entertainment,11.93,55137206.59
07/06/2023,Expense,The Commons Surry Hil,Mike ross,Credit Card - Ramp,7.59,55137214.18
07/06/2023,Expense,Adobe,,Tools & Subscription - S&M,84.23,55137298.41
07/06/2023,Expense,The Sweet Chick,Mike ross,Credit Card - Ramp,11.93,55137310.34
07/06/2023,Expense,Graphics Press,,Tools & Subscription - G&A,120,55137430.34
07/06/2023,Expense,The Commons Surry Hil,,Travel:Hotels,7.59,55137437.93
07/06/2023,Expense,The Dolphin Hotel,Mike ross,Credit Card - Ramp,46.31,55137484.24
07/06/2023,Expense,Midjourney,,Tools & Subscription - G&A,96,55137580.24
07/06/2023,Expense,The Dolphin Hotel,,Meals & Entertainment,46.31,55137626.55
07/06/2023,Expense,The Commons Surry Hil,Mike ross,Credit Card - Ramp,7.59,55137634.14
07/06/2023,Expense,Adobe,Mike ross,Credit Card - Ramp,84.23,55137718.37
07/06/2023,Expense,The Sweet Chick,Mike ross,Credit Card - Ramp,11.93,55137730.3
07/06/2023,Expense,The Sweet Chick,,Meals & Entertainment,11.93,55137742.23
07/06/2023,Expense,The Dolphin Hotel,Mike ross,Credit Card - Ramp,46.31,55137788.54
07/06/2023,Expense,Adobe,Mike ross,Credit Card - Ramp,84.23,55137872.77
07/07/2023,Expense,Lucky Pickle Dumpling Co,Mike ross,Meals & Entertainment,22.34,55137895.11
07/07/2023,Expense,Vodafone Australia,Max Kausman,Office expenses,42.05,55137937.16
07/07/2023,Expense,Vodafone Australia,Max Kausman,Office expenses,42.05,55137979.21
07/07/2023,Expense,Vodafone Australia,Max Kausman,Office expenses,42.05,55138021.26
07/07/2023,Expense,Lucky Pickle Dumpling Co,Mike ross,Credit Card - Ramp,22.34,55138043.6
07/07/2023,Expense,Lucky Pickle Dumpling Co,Mike ross,Meals & Entertainment,22.34,55138065.94
07/07/2023,Expense,Vodafone Australia,Max Kausman,Credit Card - Ramp,42.05,55138107.99
07/07/2023,Expense,Lucky Pickle Dumpling Co,Mike ross,Credit Card - Ramp,22.34,55138130.33
07/07/2023,Expense,Vodafone Australia,Max Kausman,Credit Card - Ramp,42.05,55138172.38
07/07/2023,Expense,Vodafone Australia,Max Kausman,Credit Card - Ramp,42.05,55138214.43
07/07/2023,Expense,Lucky Pickle Dumpling Co,Mike ross,Credit Card - Ramp,22.34,55138236.77
07/07/2023,Expense,Lucky Pickle Dumpling Co,Mike ross,Credit Card - Ramp,22.34,55138259.11
07/07/2023,Expense,Lucky Pickle Dumpling Co,Mike ross,Meals & Entertainment,22.34,55138281.45
07/07/2023,Expense,Vodafone Australia,Max Kausman,Credit Card - Ramp,42.05,55138323.5
07/07/2023,Expense,Lucky Pickle Dumpling Co,Mike ross,Meals & Entertainment,22.34,55138345.84
07/07/2023,Expense,Vodafone Australia,Max Kausman,Office expenses,42.05,55138387.89
07/08/2023,Expense,Dubai Taxi,Harvey Spector,Credit Card - Ramp,14.03,55138401.92
07/08/2023,Expense,Dubai Taxi,Harvey Spector,Credit Card - Ramp,14.03,55138415.95
07/08/2023,Expense,Userflow,,Tools & Subscription - G&A,250,55138665.95
07/08/2023,Expense,Dubai Taxi,,Travelling Expenses,14.03,55138679.98
07/08/2023,Expense,Dubai Taxi,,Travelling Expenses,14.03,55138694.01
07/08/2023,Expense,Userflow,Max Kausman,Credit Card - Ramp,250,55138944.01
07/08/2023,Expense,Userflow,Max Kausman,Credit Card - Ramp,250,55139194.01
07/08/2023,Expense,Userflow,Max Kausman,Credit Card - Ramp,250,55139444.01
07/08/2023,Expense,Userflow,,Tools & Subscription - G&A,250,55139694.01
07/08/2023,Expense,Dubai Taxi,Harvey Spector,Credit Card - Ramp,14.03,55139708.04
07/08/2023,Expense,Userflow,,Tools & Subscription - G&A,250,55139958.04
07/08/2023,Expense,Dubai Taxi,,Travelling Expenses,14.03,55139972.07
07/08/2023,Expense,Userflow,,Tools & Subscription - G&A,250,55140222.07
07/08/2023,Expense,Dubai Taxi,,Travelling Expenses,14.03,55140236.1
07/09/2023,Expense,Taplio,Harvey Spector,Credit Card - Ramp,39,55140275.1
07/09/2023,Expense,Taplio,,Tools & Subscription - G&A,39,55140314.1
07/09/2023,Expense,Usersnap,Harris Jose,Credit Card - Ramp,99,55140413.1
07/09/2023,Expense,Usersnap,,Tools & Subscription - G&A,99,55140512.1
07/09/2023,Expense,The New York Times,,General business expenses:Memberships & subscriptions,8.29,55140520.39
07/09/2023,Expense,Taplio,,Tools & Subscription - G&A,39,55140559.39
07/09/2023,Expense,Usersnap,,Tools & Subscription - G&A,99,55140658.39
07/09/2023,Expense,Taplio,,Tools & Subscription - G&A,39,55140697.39
07/09/2023,Expense,The New York Times,Mike ross,Credit Card - Ramp,8.29,55140705.68
07/09/2023,Expense,The New York Times,,General business expenses:Memberships & subscriptions,8.29,55140713.97
07/09/2023,Expense,Usersnap,,Tools & Subscription - G&A,99,55140812.97
07/09/2023,Expense,Taplio,Harvey Spector,Credit Card - Ramp,39,55140851.97
07/09/2023,Expense,Taplio,Harvey Spector,Credit Card - Ramp,39,55140890.97
07/09/2023,Expense,The New York Times,,General business expenses:Memberships & subscriptions,8.29,55140899.26
07/09/2023,Expense,Taplio,,Tools & Subscription - G&A,39,55140938.26
07/09/2023,Expense,Usersnap,,Tools & Subscription - G&A,99,55141037.26
07/09/2023,Expense,Usersnap,Harris Jose,Credit Card - Ramp,99,55141136.26
07/09/2023,Expense,The New York Times,,General business expenses:Memberships & subscriptions,8.29,55141144.55
07/09/2023,Expense,Usersnap,Harris Jose,Credit Card - Ramp,99,55141243.55
07/09/2023,Expense,The New York Times,Mike ross,Credit Card - Ramp,8.29,55141251.84
07/09/2023,Expense,The New York Times,Mike ross,Credit Card - Ramp,8.29,55141260.13
07/09/2023,Expense,The New York Times,Mike ross,Credit Card - Ramp,8.29,55141268.42
07/10/2023,Expense,Maadhya Pty Ltd,,Meals & Entertainment,10.98,55141279.4
07/10/2023,Expense,The Commons Surry Hil,,Travel:Hotels,3.8,55141283.2
07/10/2023,Expense,The Commons Surry Hil,,Travel:Hotels,3.8,55141287
07/10/2023,Expense,The Carrington,,Meals & Entertainment,65.92,55141352.92
07/10/2023,Expense,Maadhya Pty Ltd,,Meals & Entertainment,10.98,55141363.9
07/10/2023,Expense,The Commons Surry Hil,,Travel:Hotels,2.76,55141366.66
07/10/2023,Expense,Maadhya Pty Ltd,,Meals & Entertainment,10.98,55141377.64
07/10/2023,Expense,Pause Cafe,Harvey Spector,Credit Card - Ramp,14.91,55141392.55
07/10/2023,Expense,Heroku,Balapavan Tirumani,Credit Card - Ramp,85,55141477.55
07/10/2023,Expense,Heroku,Balapavan Tirumani,Tools & Subscription - S&M,85,55141562.55
07/10/2023,Expense,The Carrington,,Meals & Entertainment,65.92,55141628.47
07/10/2023,Expense,The Commons Surry Hil,,Travel:Hotels,2.76,55141631.23
07/10/2023,Expense,The Commons Surry Hil,,Travel:Hotels,2.76,55141633.99
07/10/2023,Expense,Maadhya Pty Ltd,Mike ross,Credit Card - Ramp,10.98,55141644.97
07/10/2023,Expense,The Carrington,Mike ross,Credit Card - Ramp,65.92,55141710.89
07/10/2023,Expense,The Commons Surry Hil,,Travel:Hotels,2.76,55141713.65
07/10/2023,Expense,The Commons Surry Hil,,Travel:Hotels,2.76,55141716.41
07/10/2023,Expense,Heroku,Balapavan Tirumani,Tools & Subscription - S&M,85,55141801.41
07/10/2023,Expense,The Carrington,,Meals & Entertainment,65.92,55141867.33
07/10/2023,Expense,Pause Cafe,Harvey Spector,Meals & Entertainment,14.91,55141882.24
07/10/2023,Expense,The Commons Surry Hil,,Travel:Hotels,3.8,55141886.04
07/10/2023,Expense,The Commons Surry Hil,,Travel:Hotels,2.76,55141888.8
07/10/2023,Expense,Pause Cafe,Harvey Spector,Credit Card - Ramp,14.91,55141903.71
07/10/2023,Expense,Heroku,Balapavan Tirumani,Tools & Subscription - S&M,85,55141988.71
07/10/2023,Expense,Heroku,Balapavan Tirumani,Tools & Subscription - S&M,85,55142073.71
07/10/2023,Expense,The Carrington,,Meals & Entertainment,65.92,55142139.63
07/10/2023,Expense,The Commons Surry Hil,Mike ross,Credit Card - Ramp,2.76,55142142.39
07/10/2023,Expense,Maadhya Pty Ltd,Mike ross,Credit Card - Ramp,10.98,55142153.37
07/10/2023,Expense,The Carrington,Mike ross,Credit Card - Ramp,65.92,55142219.29
07/10/2023,Expense,The Commons Surry Hil,Mike ross,Credit Card - Ramp,2.76,55142222.05
07/10/2023,Expense,The Commons Surry Hil,Mike ross,Credit Card - Ramp,2.76,55142224.81
07/10/2023,Expense,Maadhya Pty Ltd,,Meals & Entertainment,10.98,55142235.79
07/10/2023,Expense,Pause Cafe,Harvey Spector,Credit Card - Ramp,14.91,55142250.7
07/10/2023,Expense,The Commons Surry Hil,Mike ross,Credit Card - Ramp,3.8,55142254.5
07/10/2023,Expense,Pause Cafe,Harvey Spector,Meals & Entertainment,14.91,55142269.41
07/10/2023,Expense,The Commons Surry Hil,Mike ross,Credit Card - Ramp,2.76,55142272.17
07/10/2023,Expense,Heroku,Balapavan Tirumani,Credit Card - Ramp,85,55142357.17
07/10/2023,Expense,The Carrington,Mike ross,Credit Card - Ramp,65.92,55142423.09
07/10/2023,Expense,The Commons Surry Hil,Mike ross,Credit Card - Ramp,3.8,55142426.89
07/10/2023,Expense,Maadhya Pty Ltd,Mike ross,Credit Card - Ramp,10.98,55142437.87
07/10/2023,Expense,The Commons Surry Hil,Mike ross,Credit Card - Ramp,2.76,55142440.63
07/10/2023,Expense,Pause Cafe,Harvey Spector,Credit Card - Ramp,14.91,55142455.54
07/10/2023,Expense,The Carrington,Mike ross,Credit Card - Ramp,65.92,55142521.46
07/10/2023,Expense,Maadhya Pty Ltd,Mike ross,Credit Card - Ramp,10.98,55142532.44
07/10/2023,Expense,Heroku,Balapavan Tirumani,Credit Card - Ramp,85,55142617.44
07/10/2023,Expense,The Commons Surry Hil,Mike ross,Credit Card - Ramp,3.8,55142621.24
07/10/2023,Expense,The Commons Surry Hil,,Travel:Hotels,2.76,55142624
07/10/2023,Expense,Pause Cafe,Harvey Spector,Meals & Entertainment,14.91,55142638.91
07/10/2023,Expense,Pause Cafe,Harvey Spector,Meals & Entertainment,14.91,55142653.82
07/10/2023,Expense,The Commons Surry Hil,,Travel:Hotels,2.76,55142656.58
07/10/2023,Expense,The Commons Surry Hil,,Travel:Hotels,3.8,55142660.38
07/10/2023,Expense,The Commons Surry Hil,Mike ross,Credit Card - Ramp,2.76,55142663.14
07/11/2023,Expense,HCC Medical Insurance Services,,Insurance,17.71,55142680.85
07/11/2023,Expense,HCC Medical Insurance Services,Harvey Spector,Credit Card - Ramp,17.71,55142698.56
07/11/2023,Expense,Sandoitchi Cafe,Mike ross,Credit Card - Ramp,13.94,55142712.5
07/11/2023,Expense,Sandoitchi Cafe,Mike ross,Meals & Entertainment,13.94,55142726.44
07/11/2023,Expense,Zoom,Max Kausman,Credit Card - Ramp,15.99,55142742.43
07/11/2023,Expense,Zoom,Max Kausman,Credit Card - Ramp,15.99,55142758.42
07/11/2023,Expense,Zoom,,Tools & Subscription - G&A,15.99,55142774.41
07/11/2023,Expense,Sandoitchi Cafe,Mike ross,Credit Card - Ramp,13.94,55142788.35
07/11/2023,Expense,Zoom,,Tools & Subscription - G&A,15.99,55142804.34
07/11/2023,Expense,Zoom,,Tools & Subscription - G&A,15.99,55142820.33
07/11/2023,Expense,HCC Medical Insurance Services,Harvey Spector,Credit Card - Ramp,17.71,55142838.04
07/11/2023,Expense,Sandoitchi Cafe,Mike ross,Meals & Entertainment,13.94,55142851.98
07/11/2023,Expense,HCC Medical Insurance Services,,Insurance,17.71,55142869.69
07/11/2023,Expense,Sandoitchi Cafe,Mike ross,Credit Card - Ramp,13.94,55142883.63
07/11/2023,Expense,Zoom,Max Kausman,Credit Card - Ramp,15.99,55142899.62
07/11/2023,Expense,Sandoitchi Cafe,Mike ross,Credit Card - Ramp,13.94,55142913.56
07/11/2023,Expense,Sandoitchi Cafe,Mike ross,Meals & Entertainment,13.94,55142927.5
07/11/2023,Expense,HCC Medical Insurance Services,Harvey Spector,Credit Card - Ramp,17.71,55142945.21
07/11/2023,Expense,HCC Medical Insurance Services,,Insurance,17.71,55142962.92
07/11/2023,Expense,Sandoitchi Cafe,Mike ross,Meals & Entertainment,13.94,55142976.86
07/11/2023,Expense,Zoom,,Tools & Subscription - G&A,15.99,55142992.85
07/11/2023,Expense,HCC Medical Insurance Services,Harvey Spector,Credit Card - Ramp,17.71,55143010.56
07/11/2023,Expense,HCC Medical Insurance Services,,Insurance,17.71,55143028.27
07/12/2023,Expense,WordPress,Harris Jose,Credit Card - Ramp,15.76,55143044.03
07/12/2023,Expense,Noon Al Quoz,,Meals & Entertainment,4.2,55143048.23
07/12/2023,Expense,WordPress,,Tools & Subscription - G&A,15.76,55143063.99
07/12/2023,Expense,Lokal,Mike ross,Meals & Entertainment,39.04,55143103.03
07/12/2023,Expense,Lokal,Mike ross,Credit Card - Ramp,39.04,55143142.07
07/12/2023,Expense,The Commons Surry Hil,,Travel:Hotels,6.55,55143148.62
07/12/2023,Expense,WordPress,Harris Jose,Credit Card - Ramp,15.76,55143164.38
07/12/2023,Expense,Lokal,Mike ross,Meals & Entertainment,39.04,55143203.42
07/12/2023,Expense,Lokal,Mike ross,Meals & Entertainment,39.04,55143242.46
07/12/2023,Expense,The Commons Surry Hil,Mike ross,Credit Card - Ramp,6.55,55143249.01
07/12/2023,Expense,The Commons Surry Hil,Mike ross,Credit Card - Ramp,6.55,55143255.56
07/12/2023,Expense,Adobe,Chris George,Credit Card - Ramp,20.99,55143276.55
07/12/2023,Expense,The Commons Surry Hil,,Travel:Hotels,6.55,55143283.1
07/12/2023,Expense,WordPress,Harris Jose,Credit Card - Ramp,15.76,55143298.86
07/12/2023,Expense,Noon Al Quoz,Harvey Spector,Credit Card - Ramp,4.2,55143303.06
07/12/2023,Expense,Lokal,Mike ross,Credit Card - Ramp,39.04,55143342.1
07/12/2023,Expense,Adobe,Chris George,Credit Card - Ramp,20.99,55143363.09
07/12/2023,Expense,Adobe,,Tools & Subscription - S&M,20.99,55143384.08
07/12/2023,Expense,WordPress,,Tools & Subscription - G&A,15.76,55143399.84
07/12/2023,Expense,Noon Al Quoz,Harvey Spector,Credit Card - Ramp,4.2,55143404.04
07/12/2023,Expense,Lokal,Mike ross,Credit Card - Ramp,39.04,55143443.08
07/12/2023,Expense,WordPress,,Tools & Subscription - G&A,15.76,55143458.84
07/12/2023,Expense,The Commons Surry Hil,,Travel:Hotels,6.55,55143465.39
07/12/2023,Expense,Adobe,,Tools & Subscription - S&M,20.99,55143486.38
07/12/2023,Expense,Noon Al Quoz,Harvey Spector,Credit Card - Ramp,4.2,55143490.58
07/12/2023,Expense,The Commons Surry Hil,Mike ross,Credit Card - Ramp,6.55,55143497.13
07/12/2023,Expense,Lokal,Mike ross,Meals & Entertainment,39.04,55143536.17
07/12/2023,Expense,WordPress,,Tools & Subscription - G&A,15.76,55143551.93
07/12/2023,Expense,Adobe,Chris George,Credit Card - Ramp,20.99,55143572.92
07/12/2023,Expense,The Commons Surry Hil,,Travel:Hotels,6.55,55143579.47
07/12/2023,Expense,Adobe,,Tools & Subscription - S&M,20.99,55143600.46
07/12/2023,Expense,Noon Al Quoz,,Meals & Entertainment,4.2,55143604.66
07/12/2023,Expense,Adobe,,Tools & Subscription - S&M,20.99,55143625.65
07/12/2023,Expense,Lokal,Mike ross,Credit Card - Ramp,39.04,55143664.69
07/12/2023,Expense,Noon Al Quoz,Harvey Spector,Credit Card - Ramp,4.2,55143668.89
07/12/2023,Expense,Noon Al Quoz,,Meals & Entertainment,4.2,55143673.09
07/12/2023,Expense,Noon Al Quoz,,Meals & Entertainment,4.2,55143677.29
07/13/2023,Expense,Interact32,Harvey Spector,Tools & Subscription - G&A,10.2,55143687.49
07/13/2023,Expense,Vercel,,Tools & Subscription - G&A,240,55143927.49
07/13/2023,Expense,Clay,,Tools & Subscription - G&A,70,55143997.49
07/13/2023,Expense,Vercel,,Tools & Subscription - G&A,240,55144237.49
07/13/2023,Expense,Figma,,Tools & Subscription - G&A,195,55144432.49
07/13/2023,Expense,Clay,,Tools & Subscription - G&A,70,55144502.49
07/13/2023,Expense,Figma,,Tools & Subscription - G&A,1008,55145510.49
07/13/2023,Expense,Figma,,Tools & Subscription - G&A,195,55145705.49
07/13/2023,Expense,Lenny Rachitsky,,General business expenses:Memberships & subscriptions,15,55145720.49
07/13/2023,Expense,Interact32,Harvey Spector,Tools & Subscription - G&A,10.2,55145730.69
07/13/2023,Expense,Figma,,Tools & Subscription - G&A,1008,55146738.69
07/13/2023,Expense,Lenny Rachitsky,Max Kausman,Credit Card - Ramp,15,55146753.69
07/13/2023,Expense,The Dolphin Hotel,,Meals & Entertainment,72.57,55146826.26
07/13/2023,Expense,The Dolphin Hotel,,Meals & Entertainment,72.57,55146898.83
07/13/2023,Expense,Lenny Rachitsky,,General business expenses:Memberships & subscriptions,15,55146913.83
07/13/2023,Expense,Clay,,Tools & Subscription - G&A,70,55146983.83
07/13/2023,Expense,Vercel,,Tools & Subscription - G&A,240,55147223.83
07/13/2023,Expense,Interact32,Harvey Spector,Tools & Subscription - G&A,10.2,55147234.03
07/13/2023,Expense,Lenny Rachitsky,,General business expenses:Memberships & subscriptions,15,55147249.03
07/13/2023,Expense,Interact32,Harvey Spector,Tools & Subscription - G&A,10.2,55147259.23
07/13/2023,Expense,Figma,,Tools & Subscription - G&A,195,55147454.23
07/13/2023,Expense,The Dolphin Hotel,Mike ross,Credit Card - Ramp,72.57,55147526.8
07/13/2023,Expense,Interact32,Harvey Spector,Credit Card - Ramp,10.2,55147537
07/13/2023,Expense,Clay,,Tools & Subscription - G&A,70,55147607
07/13/2023,Expense,Vercel,,Tools & Subscription - G&A,240,55147847
07/13/2023,Expense,Figma,,Tools & Subscription - G&A,1008,55148855
07/13/2023,Expense,Clay,Max Kausman,Credit Card - Ramp,70,55148925
07/13/2023,Expense,The Dolphin Hotel,,Meals & Entertainment,72.57,55148997.57
07/13/2023,Expense,Figma,Mike ross,Credit Card - Ramp,1008,55150005.57
07/13/2023,Expense,Vercel,Harris Jose,Credit Card - Ramp,240,55150245.57
07/13/2023,Expense,Clay,Max Kausman,Credit Card - Ramp,70,55150315.57
07/13/2023,Expense,Figma,Mike ross,Credit Card - Ramp,195,55150510.57
07/13/2023,Expense,Figma,Mike ross,Credit Card - Ramp,1008,55151518.57
07/13/2023,Expense,Lenny Rachitsky,Max Kausman,Credit Card - Ramp,15,55151533.57
07/13/2023,Expense,The Dolphin Hotel,Mike ross,Credit Card - Ramp,72.57,55151606.14
07/13/2023,Expense,Interact32,Harvey Spector,Credit Card - Ramp,10.2,55151616.34
07/13/2023,Expense,Figma,Mike ross,Credit Card - Ramp,195,55151811.34
07/13/2023,Expense,Vercel,Harris Jose,Credit Card - Ramp,240,55152051.34
07/13/2023,Expense,The Dolphin Hotel,Mike ross,Credit Card - Ramp,72.57,55152123.91
07/13/2023,Expense,The Dolphin Hotel,,Meals & Entertainment,72.57,55152196.48
07/13/2023,Expense,Figma,Mike ross,Credit Card - Ramp,195,55152391.48
07/13/2023,Expense,Clay,Max Kausman,Credit Card - Ramp,70,55152461.48
07/13/2023,Expense,Vercel,Harris Jose,Credit Card - Ramp,240,55152701.48
07/13/2023,Expense,Figma,Mike ross,Credit Card - Ramp,1008,55153709.48
07/13/2023,Expense,Lenny Rachitsky,,General business expenses:Memberships & subscriptions,15,55153724.48
07/13/2023,Expense,Lenny Rachitsky,Max Kausman,Credit Card - Ramp,15,55153739.48
07/13/2023,Expense,Figma,,Tools & Subscription - G&A,1008,55154747.48
07/13/2023,Expense,Figma,,Tools & Subscription - G&A,195,55154942.48
07/13/2023,Expense,Interact32,Harvey Spector,Credit Card - Ramp,10.2,55154952.68
07/13/2023,Expense,Lenny Rachitsky,Max Kausman,Credit Card - Ramp,15,55154967.68
07/13/2023,Expense,The Dolphin Hotel,Mike ross,Credit Card - Ramp,72.57,55155040.25
07/14/2023,Expense,The Dolphin Hotel,Mike ross,Credit Card - Ramp,72.91,55155113.16
07/14/2023,Expense,The Dolphin Hotel,Mike ross,Credit Card - Ramp,72.91,55155186.07
07/14/2023,Expense,The Dolphin Hotel,Mike ross,Credit Card - Ramp,72.91,55155258.98
07/14/2023,Expense,Intuit,Harvey Spector,Credit Card - Ramp,55,55155313.98
07/14/2023,Expense,Wings And Tins,Mike ross,Meals & Entertainment,37.53,55155351.51
07/14/2023,Expense,Wings And Tins,Mike ross,Credit Card - Ramp,37.53,55155389.04
07/14/2023,Expense,Intuit,Harvey Spector,Credit Card - Ramp,55,55155444.04
07/14/2023,Expense,Intuit,,Tools & Subscription - G&A,55,55155499.04
07/14/2023,Expense,The Dolphin Hotel,,Meals & Entertainment,72.91,55155571.95
07/14/2023,Expense,Wings And Tins,Mike ross,Meals & Entertainment,37.53,55155609.48
07/14/2023,Expense,lime,Harvey Spector,Credit Card - Ramp,5.42,55155614.9
07/14/2023,Expense,lime,Harvey Spector,Credit Card - Ramp,5.42,55155620.32
07/14/2023,Expense,lime,,Travelling Expenses,5.42,55155625.74
07/14/2023,Expense,Wings And Tins,Mike ross,Credit Card - Ramp,37.53,55155663.27
07/14/2023,Expense,Wings And Tins,Mike ross,Credit Card - Ramp,37.53,55155700.8
07/14/2023,Expense,Intuit,,Tools & Subscription - G&A,55,55155755.8
07/14/2023,Expense,The Dolphin Hotel,,Meals & Entertainment,72.91,55155828.71
07/14/2023,Expense,The Dolphin Hotel,Mike ross,Credit Card - Ramp,72.91,55155901.62
07/14/2023,Expense,Wings And Tins,Mike ross,Meals & Entertainment,37.53,55155939.15
07/14/2023,Expense,Intuit,,Tools & Subscription - G&A,55,55155994.15
07/14/2023,Expense,lime,,Travelling Expenses,5.42,55155999.57
07/14/2023,Expense,The Dolphin Hotel,,Meals & Entertainment,72.91,55156072.48
07/14/2023,Expense,Wings And Tins,Mike ross,Meals & Entertainment,37.53,55156110.01
07/14/2023,Expense,The Dolphin Hotel,,Meals & Entertainment,72.91,55156182.92
07/14/2023,Expense,lime,,Travelling Expenses,5.42,55156188.34
07/14/2023,Expense,Wings And Tins,Mike ross,Credit Card - Ramp,37.53,55156225.87
07/14/2023,Expense,Intuit,,Tools & Subscription - G&A,55,55156280.87
07/14/2023,Expense,lime,Harvey Spector,Credit Card - Ramp,5.42,55156286.29
07/14/2023,Expense,lime,,Travelling Expenses,5.42,55156291.71
07/14/2023,Expense,Intuit,Harvey Spector,Credit Card - Ramp,55,55156346.71
07/16/2023,Expense,Zapier,,Tools & Subscription - G&A,29.99,55156376.7
07/16/2023,Expense,Uber,Mike ross,Credit Card - Ramp,8,55156384.7
07/16/2023,Expense,Zapier,Harvey Spector,Credit Card - Ramp,29.99,55156414.69
07/16/2023,Expense,Linear,Chad Blumenthal,Credit Card - Ramp,170,55156584.69
07/16/2023,Expense,Linear,,Tools & Subscription - G&A,170,55156754.69
07/16/2023,Expense,Linear,,Tools & Subscription - G&A,170,55156924.69
07/16/2023,Expense,Uber,,Travelling Expenses,8,55156932.69
07/16/2023,Expense,Linear,,Tools & Subscription - G&A,170,55157102.69
07/16/2023,Expense,Uber,,Travelling Expenses,8,55157110.69
07/16/2023,Expense,Uber,Mike ross,Credit Card - Ramp,8,55157118.69
07/16/2023,Expense,Uber,,Travelling Expenses,8,55157126.69
07/16/2023,Expense,Uber,Mike ross,Credit Card - Ramp,8,55157134.69
07/16/2023,Expense,Zapier,,Tools & Subscription - G&A,29.99,55157164.68
07/16/2023,Expense,Zapier,Harvey Spector,Credit Card - Ramp,29.99,55157194.67
07/16/2023,Expense,Linear,Chad Blumenthal,Credit Card - Ramp,170,55157364.67
07/16/2023,Expense,Zapier,,Tools & Subscription - G&A,29.99,55157394.66
07/16/2023,Expense,Linear,Chad Blumenthal,Credit Card - Ramp,170,55157564.66
07/16/2023,Expense,Linear,,Tools & Subscription - G&A,170,55157734.66
07/16/2023,Expense,Zapier,Harvey Spector,Credit Card - Ramp,29.99,55157764.65
07/16/2023,Expense,Zapier,,Tools & Subscription - G&A,29.99,55157794.64
07/16/2023,Expense,Uber,,Travelling Expenses,8,55157802.64
07/17/2023,Expense,Kiss My Axe,Max Kausman,Credit Card - Ramp,224.77,55158027.41
07/17/2023,Expense,,MONTHLY CHARGE Bank Charges for the per 01JUN2023 TO 30JUN2023 Invoice No 1648832,General business expenses:Bank fees & service charges,-32.01,55157995.4
07/17/2023,Expense,The Commons Surry Hil,Mike ross,Credit Card - Ramp,4.26,55157999.66
07/17/2023,Expense,Graphics Press,Mike ross,Credit Card - Ramp,188,55158187.66
07/17/2023,Expense,,Fees,HSBC A/c,32.01,55158219.67
07/17/2023,Expense,,Fees,HSBC A/c,32.01,55158251.68
07/17/2023,Expense,Lucky Pickle Dumpling Co,Mike ross,Credit Card - Ramp,23.03,55158274.71
07/17/2023,Expense,The Commons Surry Hil,Mike ross,Credit Card - Ramp,4.26,55158278.97
07/17/2023,Expense,Graphics Press,Mike ross,Credit Card - Ramp,188,55158466.97
07/17/2023,Expense,Kiss My Axe,,Meals & Entertainment,224.77,55158691.74
07/17/2023,Expense,Graphics Press,,Tools & Subscription - G&A,188,55158879.74
07/17/2023,Expense,The Commons Surry Hil,Mike ross,Credit Card - Ramp,4.26,55158884
07/17/2023,Expense,,MONTHLY CHARGE Bank Charges for the per 01JUN2023 TO 30JUN2023 Invoice No 1648832,General business expenses:Bank fees & service charges,-32.01,55158851.99
07/17/2023,Expense,The Commons Surry Hil,,Travel:Hotels,4.26,55158856.25
07/17/2023,Expense,,MONTHLY CHARGE Bank Charges for the per 01JUN2023 TO 30JUN2023 Invoice No 1648832,General business expenses:Bank fees & service charges,-32.01,55158824.24
07/17/2023,Expense,Graphics Press,Mike ross,Credit Card - Ramp,188,55159012.24
07/17/2023,Expense,,Fees,HSBC A/c,32.01,55159044.25
07/17/2023,Expense,Lucky Pickle Dumpling Co,Mike ross,Meals & Entertainment,23.03,55159067.28
07/17/2023,Expense,Kiss My Axe,Max Kausman,Credit Card - Ramp,224.77,55159292.05
07/17/2023,Expense,Lucky Pickle Dumpling Co,Mike ross,Credit Card - Ramp,23.03,55159315.08
07/17/2023,Expense,The Commons Surry Hil,,Travel:Hotels,4.26,55159319.34
07/17/2023,Expense,Kiss My Axe,Max Kausman,Credit Card - Ramp,224.77,55159544.11
07/17/2023,Expense,Kiss My Axe,,Meals & Entertainment,224.77,55159768.88
07/17/2023,Expense,Graphics Press,,Tools & Subscription - G&A,188,55159956.88
07/17/2023,Expense,Lucky Pickle Dumpling Co,Mike ross,Credit Card - Ramp,23.03,55159979.91
07/17/2023,Expense,Kiss My Axe,Max Kausman,Credit Card - Ramp,224.77,55160204.68
07/17/2023,Expense,,MONTHLY CHARGE Bank Charges for the per 01JUN2023 TO 30JUN2023 Invoice No 1648832,General business expenses:Bank fees & service charges,-32.01,55160172.67
07/17/2023,Expense,,Fees,HSBC A/c,32.01,55160204.68
07/17/2023,Expense,Lucky Pickle Dumpling Co,Mike ross,Credit Card - Ramp,23.03,55160227.71
07/17/2023,Expense,Lucky Pickle Dumpling Co,Mike ross,Meals & Entertainment,23.03,55160250.74
07/17/2023,Expense,Graphics Press,,Tools & Subscription - G&A,188,55160438.74
07/17/2023,Expense,Kiss My Axe,,Meals & Entertainment,224.77,55160663.51
07/17/2023,Expense,The Commons Surry Hil,,Travel:Hotels,4.26,55160667.77
07/17/2023,Expense,Graphics Press,,Tools & Subscription - G&A,188,55160855.77
07/17/2023,Expense,Kiss My Axe,,Meals & Entertainment,224.77,55161080.54
07/17/2023,Expense,Lucky Pickle Dumpling Co,Mike ross,Meals & Entertainment,23.03,55161103.57
07/17/2023,Expense,Lucky Pickle Dumpling Co,Mike ross,Meals & Entertainment,23.03,55161126.6
07/17/2023,Expense,The Commons Surry Hil,,Travel:Hotels,4.26,55161130.86
07/18/2023,Expense,Segment,,Tools & Subscription - G&A,120,55161250.86
07/18/2023,Expense,Jane Surry Hills Restaurant,,Meals & Entertainment,483.51,55161734.37
07/18/2023,Expense,Jane Surry Hills Restaurant,,Meals & Entertainment,483.51,55162217.88
07/18/2023,Expense,Linkedin Recruiter,,General business expenses:Memberships & subscriptions,158.97,55162376.85
07/18/2023,Expense,Jane Surry Hills Restaurant,Mike ross,Credit Card - Ramp,483.51,55162860.36
07/18/2023,Expense,Linkedin Recruiter,,General business expenses:Memberships & subscriptions,158.97,55163019.33
07/18/2023,Expense,Linkedin Recruiter,Mike ross,Credit Card - Ramp,158.97,55163178.3
07/18/2023,Expense,Reclaim.ai,Max Kausman,Credit Card - Ramp,8,55163186.3
07/18/2023,Expense,Linkedin Recruiter,,General business expenses:Memberships & subscriptions,158.97,55163345.27
07/18/2023,Expense,Jane Surry Hills Restaurant,,Meals & Entertainment,483.51,55163828.78
07/18/2023,Expense,Segment,,Tools & Subscription - G&A,120,55163948.78
07/18/2023,Expense,Segment,Balapavan Tirumani,Credit Card - Ramp,120,55164068.78
07/18/2023,Expense,Reclaim.ai,,Tools & Subscription - G&A,8,55164076.78
07/18/2023,Expense,Reclaim.ai,,Tools & Subscription - G&A,8,55164084.78
07/18/2023,Expense,Segment,,Tools & Subscription - G&A,120,55164204.78
07/18/2023,Expense,Linkedin Recruiter,Mike ross,Credit Card - Ramp,158.97,55164363.75
07/18/2023,Expense,Linkedin Recruiter,Mike ross,Credit Card - Ramp,158.97,55164522.72
07/18/2023,Expense,Jane Surry Hills Restaurant,Mike ross,Credit Card - Ramp,483.51,55165006.23
07/18/2023,Expense,Reclaim.ai,,Tools & Subscription - G&A,8,55165014.23
07/18/2023,Expense,Linkedin Recruiter,,General business expenses:Memberships & subscriptions,158.97,55165173.2
07/18/2023,Expense,Segment,Balapavan Tirumani,Credit Card - Ramp,120,55165293.2
07/18/2023,Expense,Jane Surry Hills Restaurant,,Meals & Entertainment,483.51,55165776.71
07/18/2023,Expense,Reclaim.ai,,Tools & Subscription - G&A,8,55165784.71
07/18/2023,Expense,Linkedin Recruiter,Mike ross,Credit Card - Ramp,158.97,55165943.68
07/18/2023,Expense,Jane Surry Hills Restaurant,Mike ross,Credit Card - Ramp,483.51,55166427.19
07/18/2023,Expense,Segment,,Tools & Subscription - G&A,120,55166547.19
07/18/2023,Expense,Reclaim.ai,Max Kausman,Credit Card - Ramp,8,55166555.19
07/18/2023,Expense,Jane Surry Hills Restaurant,Mike ross,Credit Card - Ramp,483.51,55167038.7
07/18/2023,Expense,Segment,Balapavan Tirumani,Credit Card - Ramp,120,55167158.7
07/18/2023,Expense,Reclaim.ai,Max Kausman,Credit Card - Ramp,8,55167166.7
07/19/2023,Expense,RAMP BUSINESS CO,RAMP STATEMENT,Credit Card - Ramp,-11144.4,55156022.3
07/19/2023,Expense,Twitter,,Tools & Subscription - G&A,8.16,55156030.46
07/19/2023,Expense,OpenAI,,Tools & Subscription - G&A,3.3,55156033.76
07/19/2023,Expense,RAMP BUSINESS CO,RAMP STATEMENT,Account1,-11144.4,55144889.36
07/19/2023,Expense,RAMP BUSINESS CO,RAMP STATEMENT,Account1,-11144.4,55133744.96
07/19/2023,Expense,OpenAI,,Tools & Subscription - G&A,3.3,55133748.26
07/19/2023,Expense,OpenAI,Balapavan Tirumani,Credit Card - Ramp,3.3,55133751.56
07/19/2023,Expense,OpenAI,Balapavan Tirumani,Credit Card - Ramp,3.3,55133754.86
07/19/2023,Expense,Twitter,Harvey Spector,Credit Card - Ramp,8.16,55133763.02
07/19/2023,Expense,Twitter,,Tools & Subscription - G&A,8.16,55133771.18
07/19/2023,Expense,RAMP BUSINESS CO,RAMP STATEMENT,Credit Card - Ramp,-11144.4,55122626.78
07/19/2023,Expense,RAMP BUSINESS CO,RAMP STATEMENT,Account1,-11144.4,55111482.38
07/19/2023,Expense,RAMP BUSINESS CO,RAMP STATEMENT,Credit Card - Ramp,-11144.4,55100337.98
07/19/2023,Expense,OpenAI,,Tools & Subscription - G&A,3.3,55100341.28
07/19/2023,Expense,OpenAI,,Tools & Subscription - G&A,3.3,55100344.58
07/19/2023,Expense,Twitter,,Tools & Subscription - G&A,8.16,55100352.74
07/19/2023,Expense,Twitter,Harvey Spector,Credit Card - Ramp,8.16,55100360.9
07/19/2023,Expense,Twitter,,Tools & Subscription - G&A,8.16,55100369.06
07/19/2023,Expense,Twitter,Harvey Spector,Credit Card - Ramp,8.16,55100377.22
07/19/2023,Expense,RAMP BUSINESS CO,RAMP STATEMENT,Credit Card - Ramp,-11144.4,55089232.82
07/19/2023,Expense,RAMP BUSINESS CO,RAMP STATEMENT,Account1,-11144.4,55078088.42
07/19/2023,Expense,OpenAI,Balapavan Tirumani,Credit Card - Ramp,3.3,55078091.72
07/20/2023,Expense,Amazon Au,,Tools & Subscription - S&M,168.16,55078259.88
07/20/2023,Expense,Nlovadrjzb99Pbkjey,,Travelling Expenses,2.91,55078262.79
07/20/2023,Expense,Umart Online,,Tools & Subscription - S&M,646.6,55078909.39
07/20/2023,Expense,Umart Online,Max Kausman,Credit Card - Ramp,646.6,55079555.99
07/20/2023,Expense,Amazon Au,,Tools & Subscription - S&M,168.16,55079724.15
07/20/2023,Expense,Oti',Mike ross,Credit Card - Ramp,9.96,55079734.11
07/20/2023,Expense,Nlovadrjzb99Pbkjey,,Travelling Expenses,2.91,55079737.02
07/20/2023,Expense,Oti',Mike ross,Credit Card - Ramp,9.96,55079746.98
07/20/2023,Expense,Oti',,Meals & Entertainment,9.96,55079756.94
07/20/2023,Expense,Nlovadrjzb99Pbkjey,Harvey Spector,Credit Card - Ramp,2.91,55079759.85
07/20/2023,Expense,Nlovadrjzb99Pbkjey,,Travelling Expenses,2.91,55079762.76
07/20/2023,Expense,Oti',Mike ross,Credit Card - Ramp,9.96,55079772.72
07/20/2023,Expense,Nlovadrjzb99Pbkjey,Harvey Spector,Credit Card - Ramp,2.91,55079775.63
07/20/2023,Expense,Amazon Au,,Tools & Subscription - S&M,168.16,55079943.79
07/20/2023,Expense,Umart Online,,Tools & Subscription - S&M,646.6,55080590.39
07/20/2023,Expense,Umart Online,,Tools & Subscription - S&M,646.6,55081236.99
07/20/2023,Expense,Oti',,Meals & Entertainment,9.96,55081246.95
07/20/2023,Expense,Nlovadrjzb99Pbkjey,,Travelling Expenses,2.91,55081249.86
07/20/2023,Expense,Umart Online,,Tools & Subscription - S&M,646.6,55081896.46
07/20/2023,Expense,Oti',,Meals & Entertainment,9.96,55081906.42
07/20/2023,Expense,Umart Online,Max Kausman,Credit Card - Ramp,646.6,55082553.02
07/20/2023,Expense,Nlovadrjzb99Pbkjey,Harvey Spector,Credit Card - Ramp,2.91,55082555.93
07/20/2023,Expense,Amazon Au,,Tools & Subscription - S&M,168.16,55082724.09
07/20/2023,Expense,Oti',,Meals & Entertainment,9.96,55082734.05
07/20/2023,Expense,Amazon Au,Max Kausman,Credit Card - Ramp,168.16,55082902.21
07/20/2023,Expense,Oti',Mike ross,Credit Card - Ramp,9.96,55082912.17
07/20/2023,Expense,Umart Online,Max Kausman,Credit Card - Ramp,646.6,55083558.77
07/20/2023,Expense,Amazon Au,Max Kausman,Credit Card - Ramp,168.16,55083726.93
07/20/2023,Expense,Amazon Au,Max Kausman,Credit Card - Ramp,168.16,55083895.09
07/21/2023,Expense,Slack,,Tools & Subscription - G&A,1372.48,55085267.57
07/21/2023,Expense,Slack,,Tools & Subscription - G&A,1372.48,55086640.05
07/21/2023,Bill Payment (Check),Big Company ,,HSBC A/c,-50000,55036640.05
07/21/2023,Expense,Sp Mm Resources Gmbh,,General business expenses:Memberships & subscriptions,48,55036688.05
07/21/2023,Expense,Sp Mm Resources Gmbh,Mike ross,Credit Card - Ramp,48,55036736.05
07/21/2023,Expense,Cell Fantasy Ltd,Max Kausman,Credit Card - Ramp,30.69,55036766.74
07/21/2023,Expense,Uber,,Travelling Expenses,12.86,55036779.6
07/21/2023,Expense,Kxh Pty Ltd,,Meals & Entertainment,14.46,55036794.06
07/21/2023,Expense,Cell Fantasy Ltd,,Utilities:Internet & TV services,30.69,55036824.75
07/21/2023,Expense,Sp Mm Resources Gmbh,,General business expenses:Memberships & subscriptions,48,55036872.75
07/21/2023,Expense,Kxh Pty Ltd,Mike ross,Credit Card - Ramp,14.46,55036887.21
07/21/2023,Expense,Kxh Pty Ltd,,Meals & Entertainment,14.46,55036901.67
07/21/2023,Expense,Cell Fantasy Ltd,,Utilities:Internet & TV services,30.69,55036932.36
07/21/2023,Bill Payment (Check),Big Company ,"BOOK TRANSFER DEBIT 46BOOK DEBIT CHRONICLEHQ INC.*BBK:HK+SHANGHAI BANKING CORPORATION LTD,560 001,NO 7 MAHATMA*BNF:Big Company *BBI:/DA S/REF:06416NG02345*RPBOOK*TIME:0922*YOUR REF:06416NG02345*OUR REF 202409721",Accounts Payable (A/P),-50000,54986932.36
07/21/2023,Bill Payment (Check),Big Company ,,HSBC A/c,-50000,54936932.36
07/21/2023,Expense,Slack,,Tools & Subscription - G&A,1372.48,54938304.84
07/21/2023,Expense,Sp Mm Resources Gmbh,,General business expenses:Memberships & subscriptions,48,54938352.84
07/21/2023,Bill Payment (Check),Big Company ,,HSBC A/c,-50000,54888352.84
07/21/2023,Expense,Kxh Pty Ltd,,Meals & Entertainment,14.46,54888367.3
07/21/2023,Expense,Uber,,Travelling Expenses,12.86,54888380.16
07/21/2023,Expense,Cell Fantasy Ltd,,Utilities:Internet & TV services,30.69,54888410.85
07/21/2023,Expense,Uber,,Travelling Expenses,12.86,54888423.71
07/21/2023,Expense,Sp Mm Resources Gmbh,Mike ross,Credit Card - Ramp,48,54888471.71
07/21/2023,Expense,Uber,Mike ross,Credit Card - Ramp,12.86,54888484.57
07/21/2023,Expense,Sp Mm Resources Gmbh,Mike ross,Credit Card - Ramp,48,54888532.57
07/21/2023,Expense,Sp Mm Resources Gmbh,Mike ross,Credit Card - Ramp,48,54888580.57
07/21/2023,Expense,Kxh Pty Ltd,Mike ross,Credit Card - Ramp,14.46,54888595.03
07/21/2023,Expense,Kxh Pty Ltd,,Meals & Entertainment,14.46,54888609.49
07/21/2023,Expense,Kxh Pty Ltd,Mike ross,Credit Card - Ramp,14.46,54888623.95
07/21/2023,Bill Payment (Check),Big Company ,,HSBC A/c,-50000,54838623.95
07/21/2023,Expense,Slack,Mike ross,Credit Card - Ramp,1372.48,54839996.43
07/21/2023,Bill Payment (Check),Big Company ,"BOOK TRANSFER DEBIT 46BOOK DEBIT CHRONICLEHQ INC.*BBK:HK+SHANGHAI BANKING CORPORATION LTD,560 001,NO 7 MAHATMA*BNF:Big Company *BBI:/DA S/REF:06416NG02345*RPBOOK*TIME:0922*YOUR REF:06416NG02345*OUR REF 202409721",Accounts Payable (A/P),-50000,54789996.43
07/21/2023,Expense,Uber,Mike ross,Credit Card - Ramp,12.86,54790009.29
07/21/2023,Expense,Cell Fantasy Ltd,,Utilities:Internet & TV services,30.69,54790039.98
07/21/2023,Expense,Cell Fantasy Ltd,Max Kausman,Credit Card - Ramp,30.69,54790070.67
07/21/2023,Bill Payment (Check),Big Company ,"BOOK TRANSFER DEBIT 46BOOK DEBIT CHRONICLEHQ INC.*BBK:HK+SHANGHAI BANKING CORPORATION LTD,560 001,NO 7 MAHATMA*BNF:Big Company *BBI:/DA S/REF:06416NG02345*RPBOOK*TIME:0922*YOUR REF:06416NG02345*OUR REF 202409721",Accounts Payable (A/P),-50000,54740070.67
07/21/2023,Expense,Slack,Mike ross,Credit Card - Ramp,1372.48,54741443.15
07/21/2023,Expense,Slack,,Tools & Subscription - G&A,1372.48,54742815.63
07/21/2023,Expense,Sp Mm Resources Gmbh,,General business expenses:Memberships & subscriptions,48,54742863.63
07/21/2023,Expense,Uber,,Travelling Expenses,12.86,54742876.49
07/21/2023,Expense,Slack,Mike ross,Credit Card - Ramp,1372.48,54744248.97
07/21/2023,Expense,Cell Fantasy Ltd,Max Kausman,Credit Card - Ramp,30.69,54744279.66
07/21/2023,Expense,Kxh Pty Ltd,Mike ross,Credit Card - Ramp,14.46,54744294.12
07/21/2023,Bill Payment (Check),Big Company ,"BOOK TRANSFER DEBIT 46BOOK DEBIT CHRONICLEHQ INC.*BBK:HK+SHANGHAI BANKING CORPORATION LTD,560 001,NO 7 MAHATMA*BNF:Big Company *BBI:/DA S/REF:06416NG02345*RPBOOK*TIME:0922*YOUR REF:06416NG02345*OUR REF 202409721",Accounts Payable (A/P),-50000,54694294.12
07/21/2023,Expense,Uber,Mike ross,Credit Card - Ramp,12.86,54694306.98
07/22/2023,Expense,Dovetail,,Tools & Subscription - G&A,70,54694376.98
07/22/2023,Expense,Dovetail,,Tools & Subscription - G&A,70,54694446.98
07/22/2023,Expense,Vimcal,Balapavan Tirumani,Credit Card - Ramp,150,54694596.98
07/22/2023,Expense,Uber,,Travelling Expenses,57.18,54694654.16
07/22/2023,Expense,Vimcal,,Tools & Subscription - G&A,150,54694804.16
07/22/2023,Expense,Dovetail,Harvey Spector,Credit Card - Ramp,70,54694874.16
07/22/2023,Expense,Vimcal,Balapavan Tirumani,Credit Card - Ramp,150,54695024.16
07/22/2023,Expense,Vimcal,,Tools & Subscription - G&A,150,54695174.16
07/22/2023,Expense,Dovetail,,Tools & Subscription - G&A,70,54695244.16
07/22/2023,Expense,Uber,,Travelling Expenses,57.18,54695301.34
07/22/2023,Expense,Vimcal,,Tools & Subscription - G&A,150,54695451.34
07/22/2023,Expense,Vimcal,,Tools & Subscription - G&A,150,54695601.34
07/22/2023,Expense,Uber,Mike ross,Credit Card - Ramp,57.18,54695658.52
07/22/2023,Expense,Dovetail,Harvey Spector,Credit Card - Ramp,70,54695728.52
07/22/2023,Expense,Vimcal,Balapavan Tirumani,Credit Card - Ramp,150,54695878.52
07/22/2023,Expense,Dovetail,Harvey Spector,Credit Card - Ramp,70,54695948.52
07/22/2023,Expense,Dovetail,,Tools & Subscription - G&A,70,54696018.52
07/22/2023,Expense,Uber,,Travelling Expenses,57.18,54696075.7
07/22/2023,Expense,Uber,,Travelling Expenses,57.18,54696132.88
07/22/2023,Expense,Uber,Mike ross,Credit Card - Ramp,57.18,54696190.06
07/22/2023,Expense,Uber,Mike ross,Credit Card - Ramp,57.18,54696247.24
07/23/2023,Expense,Docusign,,Tools & Subscription - G&A,15,54696262.24
07/23/2023,Expense,Super,Harvey Spector,Credit Card - Ramp,12,54696274.24
07/23/2023,Expense,Uber,,Travelling Expenses,42.76,54696317
07/23/2023,Expense,Super,,Tools & Subscription - G&A,12,54696329
07/23/2023,Expense,Superhuman,,Professional Service Charges,92.68,54696421.68
07/23/2023,Expense,Docusign,,Tools & Subscription - G&A,15,54696436.68
07/23/2023,Expense,Super,,Tools & Subscription - G&A,12,54696448.68
07/23/2023,Expense,Super,Harvey Spector,Credit Card - Ramp,12,54696460.68
07/23/2023,Expense,Docusign,Harvey Spector,Credit Card - Ramp,15,54696475.68
07/23/2023,Expense,Docusign,Harvey Spector,Credit Card - Ramp,15,54696490.68
07/23/2023,Expense,Docusign,,Tools & Subscription - G&A,15,54696505.68
07/23/2023,Expense,Superhuman,,Professional Service Charges,92.68,54696598.36
07/23/2023,Expense,Uber,,Travelling Expenses,42.76,54696641.12
07/23/2023,Expense,Superhuman,Mike ross,Credit Card - Ramp,92.68,54696733.8
07/23/2023,Expense,Uber,Mike ross,Credit Card - Ramp,42.76,54696776.56
07/23/2023,Expense,Uber,Mike ross,Credit Card - Ramp,42.76,54696819.32
07/23/2023,Expense,Superhuman,Mike ross,Credit Card - Ramp,92.68,54696912
07/23/2023,Expense,Uber,,Travelling Expenses,42.76,54696954.76
07/23/2023,Expense,Superhuman,,Professional Service Charges,92.68,54697047.44
07/23/2023,Expense,Superhuman,Mike ross,Credit Card - Ramp,92.68,54697140.12
07/23/2023,Expense,Uber,,Travelling Expenses,42.76,54697182.88
07/23/2023,Expense,Superhuman,,Professional Service Charges,92.68,54697275.56
07/23/2023,Expense,Docusign,,Tools & Subscription - G&A,15,54697290.56
07/23/2023,Expense,Docusign,Harvey Spector,Credit Card - Ramp,15,54697305.56
07/23/2023,Expense,Super,Harvey Spector,Credit Card - Ramp,12,54697317.56
07/23/2023,Expense,Super,,Tools & Subscription - G&A,12,54697329.56
07/23/2023,Expense,Super,,Tools & Subscription - G&A,12,54697341.56
07/23/2023,Expense,Uber,Mike ross,Credit Card - Ramp,42.76,54697384.32
07/23/2023,Expense,Superhuman,Mike ross,Credit Card - Ramp,92.68,54697477
07/24/2023,Expense,Maadhya Pty Ltd,Mike ross,Credit Card - Ramp,11.55,54697488.55
07/24/2023,Expense,Maadhya Pty Ltd,,Meals & Entertainment,11.55,54697500.1
07/24/2023,Expense,Maadhya Pty Ltd,,Meals & Entertainment,11.55,54697511.65
07/24/2023,Expense,Benedict Evans,Harvey Spector,Credit Card - Ramp,10,54697521.65
07/24/2023,Expense,Benedict Evans,,Professional Service Charges,10,54697531.65
07/24/2023,Expense,Benedict Evans,,Professional Service Charges,10,54697541.65
07/24/2023,Expense,Maadhya Pty Ltd,Mike ross,Credit Card - Ramp,11.55,54697553.2
07/24/2023,Expense,Benedict Evans,Harvey Spector,Credit Card - Ramp,10,54697563.2
07/24/2023,Expense,Maadhya Pty Ltd,,Meals & Entertainment,11.55,54697574.75
07/24/2023,Expense,Benedict Evans,Harvey Spector,Credit Card - Ramp,10,54697584.75
07/24/2023,Expense,Benedict Evans,,Professional Service Charges,10,54697594.75
07/24/2023,Expense,Maadhya Pty Ltd,Mike ross,Credit Card - Ramp,11.55,54697606.3
07/24/2023,Expense,Maadhya Pty Ltd,,Meals & Entertainment,11.55,54697617.85
07/24/2023,Expense,Benedict Evans,,Professional Service Charges,10,54697627.85
07/24/2023,Expense,Benedict Evans,Harvey Spector,Credit Card - Ramp,10,54697637.85
07/24/2023,Expense,Maadhya Pty Ltd,Mike ross,Credit Card - Ramp,11.55,54697649.4
07/25/2023,Expense,Miro,Mike ross,Credit Card - Ramp,100,54697749.4
07/25/2023,Expense,Miro,,Tools & Subscription - G&A,100,54697849.4
07/25/2023,Expense,Cars Taxi Services Co,Harvey Spector,Credit Card - Ramp,6.87,54697856.27
07/25/2023,Expense,InZone Corporate Services,,Professional Service Charges,283.91,54698140.18
07/25/2023,Expense,Zoom,,Tools & Subscription - G&A,15.99,54698156.17
07/25/2023,Expense,Careem,,Travelling Expenses,5.33,54698161.5
07/25/2023,Expense,Careem,Harvey Spector,Credit Card - Ramp,4.07,54698165.57
07/25/2023,Expense,Cars Taxi Services Co,,Travelling Expenses,6.87,54698172.44
07/25/2023,Expense,InZone Corporate Services,,Professional Service Charges,283.91,54698456.35
07/25/2023,Expense,Cars Taxi Services Co,,Travelling Expenses,6.87,54698463.22
07/25/2023,Expense,Careem,,Travelling Expenses,4.07,54698467.29
07/25/2023,Expense,Miro,,Tools & Subscription - G&A,100,54698567.29
07/25/2023,Expense,Careem,Harvey Spector,Credit Card - Ramp,5.69,54698572.98
07/25/2023,Expense,Cars Taxi Services Co,Harvey Spector,Credit Card - Ramp,6.87,54698579.85
07/25/2023,Expense,Careem,,Travelling Expenses,5.33,54698585.18
07/25/2023,Expense,Careem,,Travelling Expenses,5.69,54698590.87
07/25/2023,Expense,InZone Corporate Services,Harvey Spector,Credit Card - Ramp,283.91,54698874.78
07/25/2023,Expense,Cars Taxi Services Co,,Travelling Expenses,6.87,54698881.65
07/25/2023,Expense,InZone Corporate Services,Harvey Spector,Credit Card - Ramp,283.91,54699165.56
07/25/2023,Expense,Careem,,Travelling Expenses,4.07,54699169.63
07/25/2023,Expense,Zoom,,Tools & Subscription - G&A,15.99,54699185.62
07/25/2023,Expense,InZone Corporate Services,,Professional Service Charges,283.91,54699469.53
07/25/2023,Expense,Careem,,Travelling Expenses,5.69,54699475.22
07/25/2023,Expense,Careem,,Travelling Expenses,4.07,54699479.29
07/25/2023,Expense,Miro,,Tools & Subscription - G&A,100,54699579.29
07/25/2023,Expense,Careem,Harvey Spector,Credit Card - Ramp,4.07,54699583.36
07/25/2023,Expense,Zoom,,Tools & Subscription - G&A,15.99,54699599.35
07/25/2023,Expense,Careem,,Travelling Expenses,4.07,54699603.42
07/25/2023,Expense,Careem,,Travelling Expenses,5.33,54699608.75
07/25/2023,Expense,Zoom,,Tools & Subscription - G&A,15.99,54699624.74
07/25/2023,Expense,Careem,Harvey Spector,Credit Card - Ramp,4.07,54699628.81
07/25/2023,Expense,Cars Taxi Services Co,,Travelling Expenses,6.87,54699635.68
07/25/2023,Expense,Careem,,Travelling Expenses,5.69,54699641.37
07/25/2023,Expense,Miro,,Tools & Subscription - G&A,100,54699741.37
07/25/2023,Expense,Careem,Harvey Spector,Credit Card - Ramp,5.33,54699746.7
07/25/2023,Expense,Careem,Harvey Spector,Credit Card - Ramp,5.69,54699752.39
07/25/2023,Expense,Zoom,Chad Blumenthal,Credit Card - Ramp,15.99,54699768.38
07/25/2023,Expense,InZone Corporate Services,Harvey Spector,Credit Card - Ramp,283.91,54700052.29
07/25/2023,Expense,Cars Taxi Services Co,Harvey Spector,Credit Card - Ramp,6.87,54700059.16
07/25/2023,Expense,Careem,,Travelling Expenses,5.69,54700064.85
07/25/2023,Expense,Careem,,Travelling Expenses,5.33,54700070.18
07/25/2023,Expense,InZone Corporate Services,,Professional Service Charges,283.91,54700354.09
07/25/2023,Expense,Careem,Harvey Spector,Credit Card - Ramp,5.69,54700359.78
07/25/2023,Expense,Zoom,Chad Blumenthal,Credit Card - Ramp,15.99,54700375.77
07/25/2023,Expense,InZone Corporate Services,Harvey Spector,Credit Card - Ramp,283.91,54700659.68
07/25/2023,Expense,Zoom,Chad Blumenthal,Credit Card - Ramp,15.99,54700675.67
07/25/2023,Expense,Careem,Harvey Spector,Credit Card - Ramp,5.33,54700681
07/25/2023,Expense,Careem,Harvey Spector,Credit Card - Ramp,5.33,54700686.33
07/25/2023,Expense,Miro,Mike ross,Credit Card - Ramp,100,54700786.33
07/25/2023,Expense,Miro,Mike ross,Credit Card - Ramp,100,54700886.33
07/26/2023,Expense,Big Company ,Income Capitals ,Account1,9554,54710440.33
07/26/2023,Expense,Big Company ,Income Capitals ,Contract labor,-9554,54700886.33
07/26/2023,Expense,Big Company ,Income Capitals ,Contract labor,-9554,54691332.33
07/26/2023,Expense,Big Company ,Income Capitals ,Account1,9554,54700886.33
07/26/2023,Bill,ANSR Dubai,,Professional Service Charges,12000,54712886.33
07/26/2023,Bill,ANSR Dubai,Service Fees for July 2023,Accounts Payable (A/P),12000,54724886.33
07/26/2023,Bill,ANSR Dubai,,Professional Service Charges,12000,54736886.33
07/26/2023,Bill,ANSR Dubai,Service Fees for July 2023,Accounts Payable (A/P),12000,54748886.33
07/26/2023,Bill,ANSR Dubai,,Professional Service Charges,12000,54760886.33
07/26/2023,Expense,Big Company ,Income Capitals ,Contract labor,-9554,54751332.33
07/26/2023,Expense,Big Company ,Income Capitals ,Account1,9554,54760886.33
07/26/2023,Bill,ANSR Dubai,,Professional Service Charges,12000,54772886.33
07/26/2023,Expense,Big Company ,Income Capitals ,Account1,9554,54782440.33
07/26/2023,Bill,ANSR Dubai,Service Fees for July 2023,Accounts Payable (A/P),12000,54794440.33
07/26/2023,Bill,ANSR Dubai,Service Fees for July 2023,Accounts Payable (A/P),12000,54806440.33
07/26/2023,Expense,Big Company ,Income Capitals ,Contract labor,-9554,54796886.33
07/27/2023,Expense,Splitbee,Harris Jose,Credit Card - Ramp,16.52,54796902.85
07/27/2023,Expense,Sendinblue,,Tools & Subscription - G&A,79.58,54796982.43
07/27/2023,Expense,Sentry,Balapavan Tirumani,Credit Card - Ramp,29,54797011.43
07/27/2023,Expense,Splitbee,Harris Jose,Credit Card - Ramp,16.52,54797027.95
07/27/2023,Expense,Sendinblue,Balapavan Tirumani,Credit Card - Ramp,79.58,54797107.53
07/27/2023,Expense,The Commons Surry Hil,,Travel:Hotels,4.2,54797111.73
07/27/2023,Expense,The Commons Surry Hil,,Travel:Hotels,7.7,54797119.43
07/27/2023,Expense,Sentry,,Tools & Subscription - G&A,29,54797148.43
07/27/2023,Expense,The Commons Surry Hil,Mike ross,Credit Card - Ramp,4.2,54797152.63
07/27/2023,Expense,Splitbee,,Tools & Subscription - G&A,16.52,54797169.15
07/27/2023,Expense,The Commons Surry Hil,Mike ross,Credit Card - Ramp,4.2,54797173.35
07/27/2023,Expense,Sendinblue,Balapavan Tirumani,Credit Card - Ramp,79.58,54797252.93
07/27/2023,Expense,The Commons Surry Hil,Mike ross,Credit Card - Ramp,7.7,54797260.63
07/27/2023,Expense,Sendinblue,Balapavan Tirumani,Credit Card - Ramp,79.58,54797340.21
07/27/2023,Expense,Sentry,,Tools & Subscription - G&A,29,54797369.21
07/27/2023,Expense,Sentry,Balapavan Tirumani,Credit Card - Ramp,29,54797398.21
07/27/2023,Expense,The Commons Surry Hil,,Travel:Hotels,7.7,54797405.91
07/27/2023,Expense,The Commons Surry Hil,Mike ross,Credit Card - Ramp,7.7,54797413.61
07/27/2023,Expense,The Commons Surry Hil,,Travel:Hotels,4.2,54797417.81
07/27/2023,Expense,The Commons Surry Hil,,Travel:Hotels,4.2,54797422.01
07/27/2023,Expense,Splitbee,Harris Jose,Credit Card - Ramp,16.52,54797438.53
07/27/2023,Expense,Sentry,,Tools & Subscription - G&A,29,54797467.53
07/27/2023,Expense,Sendinblue,,Tools & Subscription - G&A,79.58,54797547.11
07/27/2023,Expense,Sentry,,Tools & Subscription - G&A,29,54797576.11
07/27/2023,Expense,Splitbee,,Tools & Subscription - G&A,16.52,54797592.63
07/27/2023,Expense,Sendinblue,,Tools & Subscription - G&A,79.58,54797672.21
07/27/2023,Expense,Sentry,Balapavan Tirumani,Credit Card - Ramp,29,54797701.21
07/27/2023,Expense,Splitbee,,Tools & Subscription - G&A,16.52,54797717.73
07/27/2023,Expense,The Commons Surry Hil,,Travel:Hotels,7.7,54797725.43
07/27/2023,Expense,The Commons Surry Hil,,Travel:Hotels,7.7,54797733.13
07/27/2023,Expense,Sendinblue,,Tools & Subscription - G&A,79.58,54797812.71
07/27/2023,Expense,Splitbee,,Tools & Subscription - G&A,16.52,54797829.23
07/27/2023,Expense,The Commons Surry Hil,Mike ross,Credit Card - Ramp,7.7,54797836.93
07/27/2023,Expense,The Commons Surry Hil,,Travel:Hotels,4.2,54797841.13
07/27/2023,Expense,The Commons Surry Hil,Mike ross,Credit Card - Ramp,4.2,54797845.33
07/28/2023,Expense,Openphone,,Tools & Subscription - G&A,120,54797965.33
07/28/2023,Expense,Philled,,Professional Service Charges,139.87,54798105.2
07/28/2023,Expense,Philled,Mike ross,Credit Card - Ramp,139.87,54798245.07
07/28/2023,Expense,Github,,Tools & Subscription - G&A,44,54798289.07
07/28/2023,Expense,Philled,,Professional Service Charges,139.87,54798428.94
07/28/2023,Expense,Github,,Tools & Subscription - G&A,10,54798438.94
07/28/2023,Expense,Github,,Tools & Subscription - G&A,10,54798448.94
07/28/2023,Expense,Github,,Tools & Subscription - G&A,44,54798492.94
07/28/2023,Expense,Github,,Tools & Subscription - G&A,44,54798536.94
07/28/2023,Expense,Philled,,Professional Service Charges,139.87,54798676.81
07/28/2023,Expense,Openphone,,Tools & Subscription - G&A,120,54798796.81
07/28/2023,Expense,Github,Balapavan Tirumani,Credit Card - Ramp,10,54798806.81
07/28/2023,Expense,Openphone,,Tools & Subscription - G&A,120,54798926.81
07/28/2023,Expense,Philled,Mike ross,Credit Card - Ramp,139.87,54799066.68
07/28/2023,Expense,Philled,Mike ross,Credit Card - Ramp,139.87,54799206.55
07/28/2023,Expense,Github,Balapavan Tirumani,Credit Card - Ramp,10,54799216.55
07/28/2023,Expense,Github,Balapavan Tirumani,Credit Card - Ramp,44,54799260.55
07/28/2023,Expense,Philled,,Professional Service Charges,139.87,54799400.42
07/28/2023,Expense,Github,,Tools & Subscription - G&A,44,54799444.42
07/28/2023,Expense,Openphone,Harvey Spector,Credit Card - Ramp,120,54799564.42
07/28/2023,Expense,Github,Balapavan Tirumani,Credit Card - Ramp,10,54799574.42
07/28/2023,Expense,Github,,Tools & Subscription - G&A,10,54799584.42
07/28/2023,Expense,Github,Balapavan Tirumani,Credit Card - Ramp,44,54799628.42
07/28/2023,Expense,Openphone,Harvey Spector,Credit Card - Ramp,120,54799748.42
07/28/2023,Expense,Philled,Mike ross,Credit Card - Ramp,139.87,54799888.29
07/28/2023,Expense,Openphone,Harvey Spector,Credit Card - Ramp,120,54800008.29
07/28/2023,Expense,Openphone,,Tools & Subscription - G&A,120,54800128.29
07/28/2023,Expense,Github,,Tools & Subscription - G&A,10,54800138.29
07/28/2023,Expense,Github,Balapavan Tirumani,Credit Card - Ramp,44,54800182.29
07/29/2023,Expense,Home Affairs,,Office expenses,133.29,54800315.58
07/29/2023,Expense,Netlify,,Tools & Subscription - G&A,19,54800334.58
07/29/2023,Expense,Home Affairs,,Office expenses,133.29,54800467.87
07/29/2023,Expense,Home Affairs,Harvey Spector,Credit Card - Ramp,133.29,54800601.16
07/29/2023,Expense,Netlify,,Tools & Subscription - G&A,19,54800620.16
07/29/2023,Expense,Home Affairs,Harvey Spector,Credit Card - Ramp,133.29,54800753.45
07/29/2023,Expense,Netlify,Balapavan Tirumani,Credit Card - Ramp,19,54800772.45
07/29/2023,Expense,Netlify,,Tools & Subscription - G&A,19,54800791.45
07/29/2023,Expense,Home Affairs,Harvey Spector,Credit Card - Ramp,133.29,54800924.74
07/29/2023,Expense,Home Affairs,,Office expenses,133.29,54801058.03
07/29/2023,Expense,Netlify,,Tools & Subscription - G&A,19,54801077.03
07/29/2023,Expense,Home Affairs,,Office expenses,133.29,54801210.32
07/29/2023,Expense,Home Affairs,Harvey Spector,Credit Card - Ramp,133.29,54801343.61
07/29/2023,Expense,Netlify,Balapavan Tirumani,Credit Card - Ramp,19,54801362.61
07/29/2023,Expense,Netlify,Balapavan Tirumani,Credit Card - Ramp,19,54801381.61
07/30/2023,Expense,inkle,Harvey Spector,Credit Card - Ramp,30,54801411.61
07/30/2023,Expense,inkle,,Tools & Subscription - G&A,30,54801441.61
07/30/2023,Expense,inkle,Harvey Spector,Credit Card - Ramp,30,54801471.61
07/30/2023,Expense,inkle,,Tools & Subscription - G&A,30,54801501.61
07/30/2023,Expense,inkle,,Tools & Subscription - G&A,30,54801531.61
07/30/2023,Expense,inkle,Harvey Spector,Credit Card - Ramp,30,54801561.61
07/30/2023,Expense,inkle,,Tools & Subscription - G&A,30,54801591.61
07/31/2023,Bill,Big Company ,"Service Expenses for the month of July 2023 
INR   27,02,371   @ 82.2911",Accounts Payable (A/P),32839,54834430.61
07/31/2023,Expense,Adobe,Mike ross,Credit Card - Ramp,15.21,54834445.82
07/31/2023,Expense,Adobe,Mike ross,Credit Card - Ramp,15.21,54834461.03
07/31/2023,Expense,Bootsdarling,Mike ross,Credit Card - Ramp,15.22,54834476.25
07/31/2023,Expense,Adobe,Mike ross,Credit Card - Ramp,15.21,54834491.46
07/31/2023,Bill Payment (Check),ANSR Dubai,BOOK TRANSFER DEBIT 45BOOK DEBIT CHRONICLEHQ INC.*BNF:ANSR (EMEA) GLOBAL SERVICES LIM ITED*OBI:/INV/ANSREMEA/011*BBI:/DAS/REF:63966NP00N7A*STBOOK*TIME: 0524*YOUR REF:ANSREMEA/011*OUR REF:212517231,Accounts Payable (A/P),-12000,54822491.46
07/31/2023,Bill Payment (Check),ANSR Dubai,,HSBC A/c,-12000,54810491.46
07/31/2023,Bill,Big Company ,,Outsources Services - India,32839,54843330.46
07/31/2023,Bill Payment (Check),ANSR Dubai,,HSBC A/c,-12000,54831330.46
07/31/2023,Bill,Big Company ,,Outsources Services - India,32839,54864169.46
07/31/2023,Bill,Big Company ,"Service Expenses for the month of July 2023 
INR   27,02,371   @ 82.2911",Accounts Payable (A/P),32839,54897008.46
07/31/2023,Bill Payment (Check),ANSR Dubai,,HSBC A/c,-12000,54885008.46
07/31/2023,Bill,Big Company ,"Service Expenses for the month of July 2023 
INR   27,02,371   @ 82.2911",Accounts Payable (A/P),32839,54917847.46
07/31/2023,Bill,Big Company ,,Outsources Services - India,32839,54950686.46
07/31/2023,Bill Payment (Check),ANSR Dubai,,HSBC A/c,-12000,54938686.46
07/31/2023,Expense,Bootsdarling,Mike ross,Credit Card - Ramp,15.22,54938701.68
07/31/2023,Bill Payment (Check),ANSR Dubai,BOOK TRANSFER DEBIT 45BOOK DEBIT CHRONICLEHQ INC.*BNF:ANSR (EMEA) GLOBAL SERVICES LIM ITED*OBI:/INV/ANSREMEA/011*BBI:/DAS/REF:63966NP00N7A*STBOOK*TIME: 0524*YOUR REF:ANSREMEA/011*OUR REF:212517231,Accounts Payable (A/P),-12000,54926701.68
07/31/2023,Expense,Bootsdarling,,Meals & Entertainment,15.22,54926716.9
07/31/2023,Bill,Big Company ,"Service Expenses for the month of July 2023 
INR   27,02,371   @ 82.2911",Accounts Payable (A/P),32839,54959555.9
07/31/2023,Bill Payment (Check),ANSR Dubai,BOOK TRANSFER DEBIT 45BOOK DEBIT CHRONICLEHQ INC.*BNF:ANSR (EMEA) GLOBAL SERVICES LIM ITED*OBI:/INV/ANSREMEA/011*BBI:/DAS/REF:63966NP00N7A*STBOOK*TIME: 0524*YOUR REF:ANSREMEA/011*OUR REF:212517231,Accounts Payable (A/P),-12000,54947555.9
07/31/2023,Expense,Adobe,,Tools & Subscription - S&M,15.21,54947571.11
07/31/2023,Bill Payment (Check),ANSR Dubai,BOOK TRANSFER DEBIT 45BOOK DEBIT CHRONICLEHQ INC.*BNF:ANSR (EMEA) GLOBAL SERVICES LIM ITED*OBI:/INV/ANSREMEA/011*BBI:/DAS/REF:63966NP00N7A*STBOOK*TIME: 0524*YOUR REF:ANSREMEA/011*OUR REF:212517231,Accounts Payable (A/P),-12000,54935571.11
07/31/2023,Expense,Adobe,,Tools & Subscription - S&M,15.21,54935586.32
07/31/2023,Expense,Bootsdarling,Mike ross,Credit Card - Ramp,15.22,54935601.54
07/31/2023,Expense,Bootsdarling,,Meals & Entertainment,15.22,54935616.76
07/31/2023,Expense,Adobe,,Tools & Subscription - S&M,15.21,54935631.97
07/31/2023,Expense,Bootsdarling,Mike ross,Credit Card - Ramp,15.22,54935647.19
07/31/2023,Expense,Bootsdarling,,Meals & Entertainment,15.22,54935662.41
07/31/2023,Expense,Bootsdarling,,Meals & Entertainment,15.22,54935677.63
07/31/2023,Bill,Big Company ,,Outsources Services - India,32839,54968516.63
07/31/2023,Expense,Adobe,,Tools & Subscription - S&M,15.21,54968531.84
08/01/2023,Expense,Silom Thai Restaurant,,Meals & Entertainment,50.75,54968582.59
08/01/2023,Expense,Render,Balapavan Tirumani,Credit Card - Ramp,259.66,54968842.25
08/01/2023,Expense,Google G Suite,Mike ross,Credit Card - Ramp,142.56,54968984.81
08/01/2023,Expense,Google G Suite,Mike ross,Credit Card - Ramp,142.56,54969127.37
08/01/2023,Expense,Silom Thai Restaurant,Mike ross,Credit Card - Ramp,50.75,54969178.12
08/01/2023,Expense,Render,,Tools & Subscription - G&A,259.66,54969437.78
08/01/2023,Expense,Maadhya Pty Ltd,Mike ross,Credit Card - Ramp,9.02,54969446.8
08/01/2023,Expense,Adobe Creative Cloud,Chris George,Tools & Subscription - G&A,31.49,54969478.29
08/01/2023,Expense,Silom Thai Restaurant,Mike ross,Credit Card - Ramp,50.75,54969529.04
08/01/2023,Expense,Adobe Creative Cloud,Chris George,Credit Card - Ramp,31.49,54969560.53
08/01/2023,Expense,Adobe Creative Cloud,Chris George,Credit Card - Ramp,31.49,54969592.02
08/01/2023,Expense,Google G Suite,Mike ross,Tools & Subscription - G&A,142.56,54969734.58
08/01/2023,Expense,Render,Balapavan Tirumani,Credit Card - Ramp,259.66,54969994.24
08/01/2023,Expense,Silom Thai Restaurant,Mike ross,Credit Card - Ramp,50.75,54970044.99
08/01/2023,Expense,Maadhya Pty Ltd,,Meals & Entertainment,9.02,54970054.01
08/01/2023,Expense,Maadhya Pty Ltd,Mike ross,Credit Card - Ramp,9.02,54970063.03
08/01/2023,Expense,Maadhya Pty Ltd,Mike ross,Credit Card - Ramp,9.02,54970072.05
08/01/2023,Expense,Adobe Creative Cloud,Chris George,Tools & Subscription - G&A,31.49,54970103.54
08/01/2023,Expense,Maadhya Pty Ltd,,Meals & Entertainment,9.02,54970112.56
08/01/2023,Expense,Maadhya Pty Ltd,,Meals & Entertainment,9.02,54970121.58
08/01/2023,Expense,Silom Thai Restaurant,,Meals & Entertainment,50.75,54970172.33
08/01/2023,Expense,Render,Balapavan Tirumani,Credit Card - Ramp,259.66,54970431.99
08/01/2023,Expense,Google G Suite,Mike ross,Credit Card - Ramp,142.56,54970574.55
08/01/2023,Expense,Adobe Creative Cloud,Chris George,Credit Card - Ramp,31.49,54970606.04
08/01/2023,Expense,Google G Suite,Mike ross,Tools & Subscription - G&A,142.56,54970748.6
08/01/2023,Expense,Google G Suite,Mike ross,Tools & Subscription - G&A,142.56,54970891.16
08/01/2023,Expense,Maadhya Pty Ltd,Mike ross,Credit Card - Ramp,9.02,54970900.18
08/01/2023,Expense,Silom Thai Restaurant,Mike ross,Credit Card - Ramp,50.75,54970950.93
08/01/2023,Expense,Maadhya Pty Ltd,,Meals & Entertainment,9.02,54970959.95
08/01/2023,Expense,Google G Suite,Mike ross,Tools & Subscription - G&A,142.56,54971102.51
08/01/2023,Expense,Adobe Creative Cloud,Chris George,Tools & Subscription - G&A,31.49,54971134
08/01/2023,Expense,Silom Thai Restaurant,,Meals & Entertainment,50.75,54971184.75
08/01/2023,Expense,Adobe Creative Cloud,Chris George,Tools & Subscription - G&A,31.49,54971216.24
08/01/2023,Expense,Render,,Tools & Subscription - G&A,259.66,54971475.9
08/01/2023,Expense,Silom Thai Restaurant,,Meals & Entertainment,50.75,54971526.65
08/01/2023,Expense,Render,,Tools & Subscription - G&A,259.66,54971786.31
08/01/2023,Expense,Render,,Tools & Subscription - G&A,259.66,54972045.97
08/02/2023,Expense,Powerhouse Supplements,,Tools & Subscription - G&A,221.85,54972267.82
08/02/2023,Expense,VFS Global,Harvey Spector,Tools & Subscription,171.17,54972438.99
08/02/2023,Expense,June,,Tools & Subscription - G&A,149,54972587.99
08/02/2023,Deposit,,Interest Accrual INTEREST,Savings (6977),3.64,54972591.63
08/02/2023,Expense,Andiamo Trattoria,,Meals & Entertainment,40.83,54972632.46
08/02/2023,Deposit,,Interest Accrual INTEREST,Interest Received,3.64,54972636.1
08/02/2023,Expense,Careem,Harvey Spector,Travelling Expenses,6.17,54972642.27
08/02/2023,Expense,Careem,Harvey Spector,Travelling Expenses,5.75,54972648.02
08/02/2023,Expense,Careem,Harvey Spector,Travelling Expenses,5.75,54972653.77
08/02/2023,Deposit,,Interest Accrual INTEREST,Interest Received,3.64,54972657.41
08/02/2023,Expense,Careem,Harvey Spector,Credit Card - Ramp,5.75,54972663.16
08/02/2023,Expense,Careem,Harvey Spector,Travelling Expenses,5.75,54972668.91
08/02/2023,Expense,VFS Global,Harvey Spector,Tools & Subscription,171.17,54972840.08
08/02/2023,Expense,Powerhouse Supplements,,Tools & Subscription - G&A,221.85,54973061.93
08/02/2023,Expense,June,,Tools & Subscription - G&A,149,54973210.93
08/02/2023,Expense,Powerhouse Supplements,Mike ross,Credit Card - Ramp,221.85,54973432.78
08/02/2023,Expense,Andiamo Trattoria,Mike ross,Credit Card - Ramp,40.83,54973473.61
08/02/2023,Expense,Careem,Harvey Spector,Travelling Expenses,6.17,54973479.78
08/02/2023,Expense,Andiamo Trattoria,,Meals & Entertainment,40.83,54973520.61
08/02/2023,Expense,Careem,Harvey Spector,Credit Card - Ramp,6.17,54973526.78
08/02/2023,Expense,VFS Global,Harvey Spector,Credit Card - Ramp,171.17,54973697.95
08/02/2023,Expense,VFS Global,Harvey Spector,Credit Card - Ramp,171.17,54973869.12
08/02/2023,Expense,Andiamo Trattoria,Mike ross,Credit Card - Ramp,40.83,54973909.95
08/02/2023,Expense,June,Balapavan Tirumani,Credit Card - Ramp,149,54974058.95
08/02/2023,Expense,Careem,Harvey Spector,Credit Card - Ramp,6.17,54974065.12
08/02/2023,Expense,Andiamo Trattoria,Mike ross,Credit Card - Ramp,40.83,54974105.95
08/02/2023,Deposit,,Interest Accrual INTEREST,Interest Received,3.64,54974109.59
08/02/2023,Expense,Careem,Harvey Spector,Credit Card - Ramp,5.75,54974115.34
08/02/2023,Deposit,,Interest Accrual INTEREST,Interest Received,3.64,54974118.98
08/02/2023,Deposit,,Interest Accrual INTEREST,Savings (6977),3.64,54974122.62
08/02/2023,Expense,Careem,Harvey Spector,Travelling Expenses,6.17,54974128.79
08/02/2023,Expense,Andiamo Trattoria,Mike ross,Credit Card - Ramp,40.83,54974169.62
08/02/2023,Expense,Careem,Harvey Spector,Credit Card - Ramp,5.75,54974175.37
08/02/2023,Expense,Powerhouse Supplements,,Tools & Subscription - G&A,221.85,54974397.22
08/02/2023,Expense,June,,Tools & Subscription - G&A,149,54974546.22
08/02/2023,Expense,Andiamo Trattoria,,Meals & Entertainment,40.83,54974587.05
08/02/2023,Expense,Careem,Harvey Spector,Travelling Expenses,6.17,54974593.22
08/02/2023,Expense,Careem,Harvey Spector,Travelling Expenses,5.75,54974598.97
08/02/2023,Expense,Powerhouse Supplements,Mike ross,Credit Card - Ramp,221.85,54974820.82
08/02/2023,Expense,VFS Global,Harvey Spector,Tools & Subscription,171.17,54974991.99
08/02/2023,Expense,June,Balapavan Tirumani,Credit Card - Ramp,149,54975140.99
08/02/2023,Expense,June,Balapavan Tirumani,Credit Card - Ramp,149,54975289.99
08/02/2023,Expense,Powerhouse Supplements,Mike ross,Credit Card - Ramp,221.85,54975511.84
08/02/2023,Expense,VFS Global,Harvey Spector,Tools & Subscription,171.17,54975683.01
08/02/2023,Expense,VFS Global,Harvey Spector,Credit Card - Ramp,171.17,54975854.18
08/02/2023,Expense,June,,Tools & Subscription - G&A,149,54976003.18
08/02/2023,Expense,Andiamo Trattoria,,Meals & Entertainment,40.83,54976044.01
08/02/2023,Deposit,,Interest Accrual INTEREST,Savings (6977),3.64,54976047.65
08/02/2023,Expense,Careem,Harvey Spector,Credit Card - Ramp,6.17,54976053.82
08/02/2023,Expense,Powerhouse Supplements,,Tools & Subscription - G&A,221.85,54976275.67
08/03/2023,Expense,VirtualPostMail,Harvey Spector,General business expenses:Memberships & subscriptions,35,54976310.67
08/03/2023,Expense,VirtualPostMail,Harvey Spector,General business expenses:Memberships & subscriptions,35,54976345.67
08/03/2023,Expense,Petz Park,Mike ross,Credit Card - Ramp,86.51,54976432.18
08/03/2023,Expense,Subway,Harvey Spector,Meals & Entertainment,9.26,54976441.44
08/03/2023,Expense,Petz Park,Mike ross,Meals & Entertainment,86.51,54976527.95
08/03/2023,Expense,Subway,Harvey Spector,Credit Card - Ramp,0.84,54976528.79
08/03/2023,Expense,VirtualPostMail,Harvey Spector,Credit Card - Ramp,35,54976563.79
08/03/2023,Expense,Petz Park,Mike ross,Credit Card - Ramp,86.51,54976650.3
08/03/2023,Expense,Petz Park,Mike ross,Meals & Entertainment,86.51,54976736.81
08/03/2023,Expense,Subway,Harvey Spector,Meals & Entertainment,0.84,54976737.65
08/03/2023,Expense,Subway,Harvey Spector,Credit Card - Ramp,0.84,54976738.49
08/03/2023,Expense,Subway,Harvey Spector,Meals & Entertainment,9.26,54976747.75
08/03/2023,Expense,Petz Park,Mike ross,Meals & Entertainment,86.51,54976834.26
08/03/2023,Expense,Subway,Harvey Spector,Credit Card - Ramp,9.26,54976843.52
08/03/2023,Expense,Subway,Harvey Spector,Meals & Entertainment,0.84,54976844.36
08/03/2023,Expense,VirtualPostMail,Harvey Spector,Credit Card - Ramp,35,54976879.36
08/03/2023,Expense,Subway,Harvey Spector,Credit Card - Ramp,9.26,54976888.62
08/03/2023,Expense,Subway,Harvey Spector,Meals & Entertainment,0.84,54976889.46
08/03/2023,Expense,Subway,Harvey Spector,Credit Card - Ramp,0.84,54976890.3
08/03/2023,Expense,VirtualPostMail,Harvey Spector,General business expenses:Memberships & subscriptions,35,54976925.3
08/03/2023,Expense,Subway,Harvey Spector,Credit Card - Ramp,0.84,54976926.14
08/03/2023,Expense,VirtualPostMail,Harvey Spector,Credit Card - Ramp,35,54976961.14
08/03/2023,Expense,Petz Park,Mike ross,Credit Card - Ramp,86.51,54977047.65
08/03/2023,Expense,Subway,Harvey Spector,Credit Card - Ramp,9.26,54977056.91
08/03/2023,Expense,Subway,Harvey Spector,Credit Card - Ramp,9.26,54977066.17
08/03/2023,Expense,Subway,Harvey Spector,Meals & Entertainment,0.84,54977067.01
08/03/2023,Expense,Subway,Harvey Spector,Meals & Entertainment,9.26,54977076.27
08/03/2023,Expense,VirtualPostMail,Harvey Spector,Credit Card - Ramp,35,54977111.27
08/03/2023,Expense,VirtualPostMail,Harvey Spector,General business expenses:Memberships & subscriptions,35,54977146.27
08/03/2023,Expense,Petz Park,Mike ross,Credit Card - Ramp,86.51,54977232.78
08/03/2023,Expense,Petz Park,Mike ross,Meals & Entertainment,86.51,54977319.29
08/03/2023,Expense,Subway,Harvey Spector,Meals & Entertainment,9.26,54977328.55
08/04/2023,Transfer,,PaymentServiceB Savings **6977,Account1,-1000000,53977328.55
08/04/2023,Expense,OpenAI,Mike ross,Tools & Subscription - G&A,20,53977348.55
08/04/2023,Transfer,,PaymentServiceB Savings **6977,Savings (6977),1000000,54977348.55
08/04/2023,Transfer,,PaymentServiceB Savings **6977,Savings (6977),1000000,55977348.55
08/04/2023,Expense,zamp finance,Zamp Finance,Zamp Investments - Other,-1000000,54977348.55
08/04/2023,Expense,zamp finance,Zamp Finance,Zamp Investments - Other,-1000000,53977348.55
08/04/2023,Expense,zamp finance,Zamp Finance,Zamp Investments - Other,-1000000,52977348.55
08/04/2023,Expense,zamp finance,Zamp Finance,Account1,1000000,53977348.55
08/04/2023,Expense,zamp finance,Zamp Finance,Account1,1000000,54977348.55
08/04/2023,Transfer,,PaymentServiceB Savings **6977,Savings (6977),1000000,55977348.55
08/04/2023,Transfer,,PaymentServiceB Savings **6977,Savings (6977),1000000,56977348.55
08/04/2023,Expense,OpenAI,Mike ross,Credit Card - Ramp,20,56977368.55
08/04/2023,Transfer,,PaymentServiceB Savings **6977,Account1,-1000000,55977368.55
08/04/2023,Expense,zamp finance,Zamp Finance,Account1,1000000,56977368.55
08/04/2023,Transfer,,PaymentServiceB Savings **6977,Account1,-1000000,55977368.55
08/04/2023,Expense,OpenAI,Mike ross,Credit Card - Ramp,20,55977388.55
08/04/2023,Expense,OpenAI,Mike ross,Credit Card - Ramp,20,55977408.55
08/04/2023,Expense,OpenAI,Mike ross,Tools & Subscription - G&A,20,55977428.55
08/04/2023,Expense,zamp finance,Zamp Finance,Account1,1000000,56977428.55
08/04/2023,Expense,zamp finance,Zamp Finance,Zamp Investments - Other,-1000000,55977428.55
08/04/2023,Expense,OpenAI,Mike ross,Tools & Subscription - G&A,20,55977448.55
08/04/2023,Expense,OpenAI,Mike ross,Tools & Subscription - G&A,20,55977468.55
08/04/2023,Transfer,,PaymentServiceB Savings **6977,Account1,-1000000,54977468.55
08/05/2023,Expense,Uber,Mike ross,Travelling Expenses,7.66,54977476.21
08/05/2023,Expense,Uber,Mike ross,Credit Card - Ramp,7.66,54977483.87
08/05/2023,Expense,Uber,Mike ross,Travelling Expenses,7.66,54977491.53
08/05/2023,Expense,Uber,Mike ross,Travelling Expenses,7.66,54977499.19
08/05/2023,Expense,Uber,Mike ross,Credit Card - Ramp,7.66,54977506.85
08/05/2023,Expense,Uber,Mike ross,Travelling Expenses,7.66,54977514.51
08/05/2023,Expense,Uber,Mike ross,Credit Card - Ramp,7.66,54977522.17
08/06/2023,Expense,Adobe,Mike ross,Tools & Subscription - S&M,83.08,54977605.25
08/06/2023,Expense,The New York Times,Mike ross,Credit Card - Ramp,8.17,54977613.42
08/06/2023,Expense,Adobe,Mike ross,Tools & Subscription - S&M,83.08,54977696.5
08/06/2023,Expense,The New York Times,Mike ross,General business expenses:Memberships & subscriptions,8.17,54977704.67
08/06/2023,Expense,The New York Times,Mike ross,General business expenses:Memberships & subscriptions,8.17,54977712.84
08/06/2023,Expense,Adobe,Mike ross,Credit Card - Ramp,83.08,54977795.92
08/06/2023,Expense,Adobe,Mike ross,Credit Card - Ramp,83.08,54977879
08/06/2023,Expense,Adobe,Mike ross,Tools & Subscription - S&M,83.08,54977962.08
08/06/2023,Expense,The New York Times,Mike ross,Credit Card - Ramp,8.17,54977970.25
08/06/2023,Expense,The New York Times,Mike ross,Credit Card - Ramp,8.17,54977978.42
08/06/2023,Expense,Adobe,Mike ross,Credit Card - Ramp,83.08,54978061.5
08/06/2023,Expense,Adobe,Mike ross,Tools & Subscription - S&M,83.08,54978144.58
08/06/2023,Expense,The New York Times,Mike ross,Credit Card - Ramp,8.17,54978152.75
08/06/2023,Expense,The New York Times,Mike ross,General business expenses:Memberships & subscriptions,8.17,54978160.92
08/06/2023,Expense,The New York Times,Mike ross,General business expenses:Memberships & subscriptions,8.17,54978169.09
08/07/2023,Expense,Heroku,Balapavan Tirumani,Tools & Subscription - S&M,85,54978254.09
08/07/2023,Expense,EmberMap,Anik Das,Tools & Subscription - G&A,99,54978353.09
08/07/2023,Expense,EmberMap,Anik Das,Tools & Subscription - G&A,99,54978452.09
08/07/2023,Expense,Heroku,Balapavan Tirumani,Tools & Subscription - S&M,85,54978537.09
08/07/2023,Expense,EmberMap,Anik Das,Credit Card - Ramp,99,54978636.09
08/07/2023,Expense,EmberMap,Anik Das,Credit Card - Ramp,99,54978735.09
08/07/2023,Expense,Heroku,Balapavan Tirumani,Credit Card - Ramp,85,54978820.09
08/07/2023,Expense,Heroku,Balapavan Tirumani,Tools & Subscription - S&M,85,54978905.09
08/07/2023,Expense,EmberMap,Anik Das,Tools & Subscription - G&A,99,54979004.09
08/07/2023,Expense,Heroku,Balapavan Tirumani,Credit Card - Ramp,85,54979089.09
08/07/2023,Expense,EmberMap,Anik Das,Credit Card - Ramp,99,54979188.09
08/07/2023,Expense,Heroku,Balapavan Tirumani,Credit Card - Ramp,85,54979273.09
08/07/2023,Expense,Heroku,Balapavan Tirumani,Tools & Subscription - S&M,85,54979358.09
08/07/2023,Expense,EmberMap,Anik Das,Tools & Subscription - G&A,99,54979457.09
08/08/2023,Expense,Todoist,Harvey Spector,Credit Card - Ramp,48,54979505.09
08/08/2023,Expense,zamp finance,Zamp Finance,Account1,1000000,55979505.09
08/08/2023,Expense,Userflow,Max Kausman,Tools & Subscription - G&A,250,55979755.09
08/08/2023,Deposit,,PaymentServiceB Savings **6977,Account1,-1000000,54979755.09
08/08/2023,Expense,Todoist,Harvey Spector,Tools & Subscription - G&A,48,54979803.09
08/08/2023,Expense,Vodafone Australia,Max Kausman,Credit Card - Ramp,28.11,54979831.2
08/08/2023,Expense,Todoist,Harvey Spector,Credit Card - Ramp,48,54979879.2
08/08/2023,Expense,Vodafone Australia,Max Kausman,Office expenses,28.11,54979907.31
08/08/2023,Expense,Userflow,Max Kausman,Credit Card - Ramp,250,54980157.31
08/08/2023,Expense,zamp finance,Zamp Finance,Zamp Investments - Other,-1000000,53980157.31
08/08/2023,Expense,zamp finance,Zamp Finance,Account1,1000000,54980157.31
08/08/2023,Expense,Vodafone Australia,Max Kausman,Credit Card - Ramp,28.11,54980185.42
08/08/2023,Expense,zamp finance,Zamp Finance,Zamp Investments - Other,-1000000,53980185.42
08/08/2023,Expense,Userflow,Max Kausman,Credit Card - Ramp,250,53980435.42
08/08/2023,Deposit,,PaymentServiceB Savings **6977,Savings (6977),1000000,54980435.42
08/08/2023,Expense,Vodafone Australia,Max Kausman,Credit Card - Ramp,28.11,54980463.53
08/08/2023,Deposit,,PaymentServiceB Savings **6977,Savings (6977),1000000,55980463.53
08/08/2023,Expense,zamp finance,Zamp Finance,Account1,1000000,56980463.53
08/08/2023,Deposit,,PaymentServiceB Savings **6977,Account1,-1000000,55980463.53
08/08/2023,Expense,Vodafone Australia,Max Kausman,Office expenses,28.11,55980491.64
08/08/2023,Expense,Userflow,Max Kausman,Tools & Subscription - G&A,250,55980741.64
08/08/2023,Expense,Todoist,Harvey Spector,Credit Card - Ramp,48,55980789.64
08/08/2023,Expense,Vodafone Australia,Max Kausman,Credit Card - Ramp,28.11,55980817.75
08/08/2023,Deposit,,PaymentServiceB Savings **6977,Savings (6977),1000000,56980817.75
08/08/2023,Expense,Userflow,Max Kausman,Credit Card - Ramp,250,56981067.75
08/08/2023,Deposit,,PaymentServiceB Savings **6977,Account1,-1000000,55981067.75
08/08/2023,Expense,Userflow,Max Kausman,Tools & Subscription - G&A,250,55981317.75
08/08/2023,Expense,zamp finance,Zamp Finance,Zamp Investments - Other,-1000000,54981317.75
08/08/2023,Expense,Vodafone Australia,Max Kausman,Office expenses,28.11,54981345.86
08/08/2023,Expense,Todoist,Harvey Spector,Tools & Subscription - G&A,48,54981393.86
08/08/2023,Deposit,,PaymentServiceB Savings **6977,Savings (6977),1000000,55981393.86
08/08/2023,Expense,Todoist,Harvey Spector,Tools & Subscription - G&A,48,55981441.86
08/08/2023,Expense,zamp finance,Zamp Finance,Account1,1000000,56981441.86
08/08/2023,Expense,zamp finance,Zamp Finance,Zamp Investments - Other,-1000000,55981441.86
08/08/2023,Expense,Todoist,Harvey Spector,Tools & Subscription - G&A,48,55981489.86
08/08/2023,Expense,Userflow,Max Kausman,Tools & Subscription - G&A,250,55981739.86
08/08/2023,Expense,Vodafone Australia,Max Kausman,Office expenses,28.11,55981767.97
08/08/2023,Deposit,,PaymentServiceB Savings **6977,Account1,-1000000,54981767.97
08/09/2023,Expense,OpenAI,Balapavan Tirumani,Tools & Subscription - G&A,20,54981787.97
08/09/2023,Expense,OpenAI,Balapavan Tirumani,Credit Card - Ramp,20,54981807.97
08/09/2023,Expense,Taplio,Harvey Spector,Credit Card - Ramp,39,54981846.97
08/09/2023,Expense,Usersnap,Harris Jose,Credit Card - Ramp,99,54981945.97
08/09/2023,Expense,Usersnap,Harris Jose,Credit Card - Ramp,99,54982044.97
08/09/2023,Expense,OpenAI,Balapavan Tirumani,Credit Card - Ramp,20,54982064.97
08/09/2023,Expense,Usersnap,Harris Jose,Tools & Subscription - G&A,99,54982163.97
08/09/2023,Expense,Usersnap,Harris Jose,Tools & Subscription - G&A,99,54982262.97
08/09/2023,Expense,Taplio,Harvey Spector,Credit Card - Ramp,39,54982301.97
08/09/2023,Expense,Taplio,Harvey Spector,Tools & Subscription - G&A,39,54982340.97
08/09/2023,Expense,Taplio,Harvey Spector,Tools & Subscription - G&A,39,54982379.97
08/09/2023,Expense,Usersnap,Harris Jose,Tools & Subscription - G&A,99,54982478.97
08/09/2023,Expense,Usersnap,Harris Jose,Tools & Subscription - G&A,99,54982577.97
08/09/2023,Expense,Usersnap,Harris Jose,Credit Card - Ramp,99,54982676.97
08/09/2023,Expense,Taplio,Harvey Spector,Credit Card - Ramp,39,54982715.97
08/09/2023,Expense,OpenAI,Balapavan Tirumani,Credit Card - Ramp,20,54982735.97
08/09/2023,Expense,OpenAI,Balapavan Tirumani,Tools & Subscription - G&A,20,54982755.97
08/09/2023,Expense,Taplio,Harvey Spector,Tools & Subscription - G&A,39,54982794.97
08/09/2023,Expense,OpenAI,Balapavan Tirumani,Tools & Subscription - G&A,20,54982814.97
08/09/2023,Expense,Taplio,Harvey Spector,Tools & Subscription - G&A,39,54982853.97
08/09/2023,Expense,OpenAI,Balapavan Tirumani,Tools & Subscription - G&A,20,54982873.97
08/10/2023,Expense,Zoom,Max Kausman,Tools & Subscription - G&A,15.99,54982889.96
08/10/2023,Expense,Pause Cafe,Harvey Spector,Meals & Entertainment,14,54982903.96
08/10/2023,Expense,Pause Cafe,Harvey Spector,Credit Card - Ramp,14,54982917.96
08/10/2023,Expense,The Commons Surry Hil,Mike ross,Credit Card - Ramp,4.4,54982922.36
08/10/2023,Expense,Zoom,Max Kausman,Credit Card - Ramp,15.99,54982938.35
08/10/2023,Expense,Pause Cafe,Harvey Spector,Credit Card - Ramp,14,54982952.35
08/10/2023,Expense,Uber,Mike ross,Credit Card - Ramp,11.09,54982963.44
08/10/2023,Expense,Zoom,Max Kausman,Credit Card - Ramp,15.99,54982979.43
08/10/2023,Expense,inkle,Harvey Spector,Credit Card - Ramp,200,54983179.43
08/10/2023,Expense,Uber,Mike ross,Credit Card - Ramp,8.98,54983188.41
08/10/2023,Expense,inkle,Harvey Spector,Tools & Subscription - G&A,200,54983388.41
08/10/2023,Expense,Conde Nast,Mike ross,General business expenses:Memberships & subscriptions,199.99,54983588.4
08/10/2023,Expense,inkle,Harvey Spector,Credit Card - Ramp,200,54983788.4
08/10/2023,Expense,The Commons Surry Hil,Mike ross,Travel:Hotels,4.4,54983792.8
08/10/2023,Expense,Uber,Mike ross,Travelling Expenses,11.09,54983803.89
08/10/2023,Expense,Uber,Mike ross,Travelling Expenses,8.98,54983812.87
08/10/2023,Expense,inkle,Harvey Spector,Tools & Subscription - G&A,200,54984012.87
08/10/2023,Expense,Zoom,Max Kausman,Tools & Subscription - G&A,15.99,54984028.86
08/10/2023,Expense,Pause Cafe,Harvey Spector,Meals & Entertainment,14,54984042.86
08/10/2023,Expense,Conde Nast,Mike ross,Credit Card - Ramp,199.99,54984242.85
08/10/2023,Expense,Zoom,Max Kausman,Credit Card - Ramp,15.99,54984258.84
08/10/2023,Expense,Conde Nast,Mike ross,Credit Card - Ramp,199.99,54984458.83
08/10/2023,Expense,inkle,Harvey Spector,Credit Card - Ramp,200,54984658.83
08/10/2023,Expense,Conde Nast,Mike ross,Credit Card - Ramp,199.99,54984858.82
08/10/2023,Expense,Conde Nast,Mike ross,Credit Card - Ramp,199.99,54985058.81
08/10/2023,Expense,The Commons Surry Hil,Mike ross,Credit Card - Ramp,4.4,54985063.21
08/10/2023,Expense,Uber,Mike ross,Credit Card - Ramp,11.09,54985074.3
08/10/2023,Expense,inkle,Harvey Spector,Tools & Subscription - G&A,200,54985274.3
08/10/2023,Expense,The Commons Surry Hil,Mike ross,Travel:Hotels,4.4,54985278.7
08/10/2023,Expense,Uber,Mike ross,Travelling Expenses,11.09,54985289.79
08/10/2023,Expense,Conde Nast,Mike ross,General business expenses:Memberships & subscriptions,199.99,54985489.78
08/10/2023,Expense,Pause Cafe,Harvey Spector,Credit Card - Ramp,14,54985503.78
08/10/2023,Expense,Uber,Mike ross,Travelling Expenses,8.98,54985512.76
08/10/2023,Expense,The Commons Surry Hil,Mike ross,Travel:Hotels,4.4,54985517.16
08/10/2023,Expense,Zoom,Max Kausman,Tools & Subscription - G&A,15.99,54985533.15
08/10/2023,Expense,Pause Cafe,Harvey Spector,Credit Card - Ramp,14,54985547.15
08/10/2023,Expense,Uber,Mike ross,Travelling Expenses,8.98,54985556.13
08/10/2023,Expense,Conde Nast,Mike ross,General business expenses:Memberships & subscriptions,199.99,54985756.12
08/10/2023,Expense,inkle,Harvey Spector,Tools & Subscription - G&A,200,54985956.12
08/10/2023,Expense,The Commons Surry Hil,Mike ross,Travel:Hotels,4.4,54985960.52
08/10/2023,Expense,Uber,Mike ross,Credit Card - Ramp,11.09,54985971.61
08/10/2023,Expense,Pause Cafe,Harvey Spector,Meals & Entertainment,14,54985985.61
08/10/2023,Expense,Uber,Mike ross,Credit Card - Ramp,8.98,54985994.59
08/10/2023,Expense,The Commons Surry Hil,Mike ross,Credit Card - Ramp,4.4,54985998.99
08/10/2023,Expense,Uber,Mike ross,Credit Card - Ramp,8.98,54986007.97
08/10/2023,Expense,Pause Cafe,Harvey Spector,Meals & Entertainment,14,54986021.97
08/10/2023,Expense,Uber,Mike ross,Travelling Expenses,11.09,54986033.06
08/10/2023,Expense,Conde Nast,Mike ross,General business expenses:Memberships & subscriptions,199.99,54986233.05
08/10/2023,Expense,Uber,Mike ross,Travelling Expenses,8.98,54986242.03
08/10/2023,Expense,Zoom,Max Kausman,Tools & Subscription - G&A,15.99,54986258.02
08/10/2023,Expense,Uber,Mike ross,Travelling Expenses,11.09,54986269.11
08/12/2023,Expense,WordPress,Harris Jose,Tools & Subscription - G&A,15.69,54986284.8
08/12/2023,Expense,Adobe,Chris George,Credit Card - Ramp,20.99,54986305.79
08/12/2023,Expense,Noon Al Quoz,Harvey Spector,Credit Card - Ramp,4.2,54986309.99
08/12/2023,Expense,WordPress,Harris Jose,Tools & Subscription - G&A,15.69,54986325.68
08/12/2023,Expense,Adobe,Chris George,Credit Card - Ramp,20.99,54986346.67
08/12/2023,Expense,Noon Al Quoz,Harvey Spector,Credit Card - Ramp,4.2,54986350.87
08/12/2023,Expense,Adobe,Chris George,Credit Card - Ramp,20.99,54986371.86
08/12/2023,Expense,Adobe,Chris George,Tools & Subscription - S&M,20.99,54986392.85
08/12/2023,Expense,WordPress,Harris Jose,Tools & Subscription - G&A,15.69,54986408.54
08/12/2023,Expense,Noon Al Quoz,Harvey Spector,Meals & Entertainment,4.2,54986412.74
08/12/2023,Expense,Noon Al Quoz,Harvey Spector,Credit Card - Ramp,4.2,54986416.94
08/12/2023,Expense,Adobe,Chris George,Tools & Subscription - S&M,20.99,54986437.93
08/12/2023,Expense,Adobe,Chris George,Tools & Subscription - S&M,20.99,54986458.92
08/12/2023,Expense,WordPress,Harris Jose,Credit Card - Ramp,15.69,54986474.61
08/12/2023,Expense,Noon Al Quoz,Harvey Spector,Meals & Entertainment,4.2,54986478.81
08/12/2023,Expense,WordPress,Harris Jose,Credit Card - Ramp,15.69,54986494.5
08/12/2023,Expense,Noon Al Quoz,Harvey Spector,Meals & Entertainment,4.2,54986498.7
08/12/2023,Expense,Adobe,Chris George,Tools & Subscription - S&M,20.99,54986519.69
08/12/2023,Expense,WordPress,Harris Jose,Tools & Subscription - G&A,15.69,54986535.38
08/12/2023,Expense,Noon Al Quoz,Harvey Spector,Credit Card - Ramp,4.2,54986539.58
08/12/2023,Expense,WordPress,Harris Jose,Credit Card - Ramp,15.69,54986555.27
08/12/2023,Expense,Noon Al Quoz,Harvey Spector,Meals & Entertainment,4.2,54986559.47
08/13/2023,Expense,Figma,Mike ross,Tools & Subscription - G&A,85,54986644.47
08/13/2023,Expense,Careem,Harvey Spector,Credit Card - Ramp,21.6,54986666.07
08/13/2023,Expense,Uber,Mike ross,Credit Card - Ramp,47.27,54986713.34
08/13/2023,Expense,Careem,Harvey Spector,Credit Card - Ramp,15.41,54986728.75
08/13/2023,Expense,Vercel,Harris Jose,Tools & Subscription - G&A,240,54986968.75
08/13/2023,Expense,Interact32,Harvey Spector,Tools & Subscription - G&A,10.14,54986978.89
08/13/2023,Expense,Careem,Harvey Spector,Travelling Expenses,21.6,54987000.49
08/13/2023,Expense,Uber,Mike ross,Travelling Expenses,47.27,54987047.76
08/13/2023,Expense,Uber,Mike ross,Travelling Expenses,47.27,54987095.03
08/13/2023,Expense,Figma,Mike ross,Tools & Subscription - G&A,85,54987180.03
08/13/2023,Expense,Careem,Harvey Spector,Credit Card - Ramp,21.6,54987201.63
08/13/2023,Expense,Vercel,Harris Jose,Tools & Subscription - G&A,240,54987441.63
08/13/2023,Expense,Uber,Mike ross,Credit Card - Ramp,47.27,54987488.9
08/13/2023,Expense,Lenny Rachitsky,Max Kausman,General business expenses:Memberships & subscriptions,15,54987503.9
08/13/2023,Expense,Careem,Harvey Spector,Travelling Expenses,15.41,54987519.31
08/13/2023,Expense,Careem,Harvey Spector,Travelling Expenses,15.41,54987534.72
08/13/2023,Expense,Uber,Mike ross,Travelling Expenses,47.27,54987581.99
08/13/2023,Expense,Careem,Harvey Spector,Travelling Expenses,21.6,54987603.59
08/13/2023,Expense,Lenny Rachitsky,Max Kausman,Credit Card - Ramp,15,54987618.59
08/13/2023,Expense,Interact32,Harvey Spector,Tools & Subscription - G&A,10.14,54987628.73
08/13/2023,Expense,Figma,Mike ross,Tools & Subscription - G&A,85,54987713.73
08/13/2023,Expense,Vercel,Harris Jose,Credit Card - Ramp,240,54987953.73
08/13/2023,Expense,Careem,Harvey Spector,Travelling Expenses,21.6,54987975.33
08/13/2023,Expense,Careem,Harvey Spector,Credit Card - Ramp,15.41,54987990.74
08/13/2023,Expense,Lenny Rachitsky,Max Kausman,General business expenses:Memberships & subscriptions,15,54988005.74
08/13/2023,Expense,Lenny Rachitsky,Max Kausman,Credit Card - Ramp,15,54988020.74
08/13/2023,Expense,Lenny Rachitsky,Max Kausman,General business expenses:Memberships & subscriptions,15,54988035.74
08/13/2023,Expense,Interact32,Harvey Spector,Credit Card - Ramp,10.14,54988045.88
08/13/2023,Expense,Careem,Harvey Spector,Travelling Expenses,21.6,54988067.48
08/13/2023,Expense,Careem,Harvey Spector,Credit Card - Ramp,15.41,54988082.89
08/13/2023,Expense,Lenny Rachitsky,Max Kausman,General business expenses:Memberships & subscriptions,15,54988097.89
08/13/2023,Expense,Careem,Harvey Spector,Travelling Expenses,15.41,54988113.3
08/13/2023,Expense,Interact32,Harvey Spector,Tools & Subscription - G&A,10.14,54988123.44
08/13/2023,Expense,Figma,Mike ross,Credit Card - Ramp,85,54988208.44
08/13/2023,Expense,Figma,Mike ross,Tools & Subscription - G&A,85,54988293.44
08/13/2023,Expense,Interact32,Harvey Spector,Tools & Subscription - G&A,10.14,54988303.58
08/13/2023,Expense,Lenny Rachitsky,Max Kausman,Credit Card - Ramp,15,54988318.58
08/13/2023,Expense,Careem,Harvey Spector,Travelling Expenses,15.41,54988333.99
08/13/2023,Expense,Vercel,Harris Jose,Tools & Subscription - G&A,240,54988573.99
08/13/2023,Expense,Vercel,Harris Jose,Credit Card - Ramp,240,54988813.99
08/13/2023,Expense,Interact32,Harvey Spector,Credit Card - Ramp,10.14,54988824.13
08/13/2023,Expense,Figma,Mike ross,Credit Card - Ramp,85,54988909.13
08/13/2023,Expense,Vercel,Harris Jose,Credit Card - Ramp,240,54989149.13
08/13/2023,Expense,Figma,Mike ross,Credit Card - Ramp,85,54989234.13
08/13/2023,Expense,Lenny Rachitsky,Max Kausman,Credit Card - Ramp,15,54989249.13
08/13/2023,Expense,Interact32,Harvey Spector,Credit Card - Ramp,10.14,54989259.27
08/13/2023,Expense,Uber,Mike ross,Credit Card - Ramp,47.27,54989306.54
08/13/2023,Expense,Careem,Harvey Spector,Credit Card - Ramp,21.6,54989328.14
08/13/2023,Expense,Uber,Mike ross,Travelling Expenses,47.27,54989375.41
08/13/2023,Expense,Vercel,Harris Jose,Tools & Subscription - G&A,240,54989615.41
08/14/2023,Expense,Creative Market,Chris George,Advertising & marketing,19.76,54989635.17
08/14/2023,Expense,Intuit,Harvey Spector,Credit Card - Ramp,60,54989695.17
08/14/2023,Expense,Creative Market,Chris George,Credit Card - Ramp,19.76,54989714.93
08/14/2023,Expense,Creative Market,Chris George,Credit Card - Ramp,19.76,54989734.69
08/14/2023,Expense,Intuit,Harvey Spector,Tools & Subscription - G&A,60,54989794.69
08/14/2023,Expense,Creative Market,Chris George,Advertising & marketing,19.76,54989814.45
08/14/2023,Expense,Intuit,Harvey Spector,Tools & Subscription - G&A,60,54989874.45
08/14/2023,Expense,Intuit,Harvey Spector,Credit Card - Ramp,60,54989934.45
08/14/2023,Expense,Intuit,Harvey Spector,Tools & Subscription - G&A,60,54989994.45
08/14/2023,Expense,Creative Market,Chris George,Credit Card - Ramp,19.76,54990014.21
08/14/2023,Expense,Intuit,Harvey Spector,Credit Card - Ramp,60,54990074.21
08/14/2023,Expense,Creative Market,Chris George,Advertising & marketing,19.76,54990093.97
08/14/2023,Expense,Creative Market,Chris George,Advertising & marketing,19.76,54990113.73
08/14/2023,Expense,Intuit,Harvey Spector,Tools & Subscription - G&A,60,54990173.73
08/14/2023,Expense,Creative Market,Chris George,Credit Card - Ramp,19.76,54990193.49
08/15/2023,Bill Payment (Check),ANSR Dubai,BOOK TRANSFER DEBIT 45BOOK DEBIT CHRONICLEHQ INC.*BNF:ANSR (EMEA) GLOBAL SERVICES LIM ITED*BBI:/DAS/REF:18106O200HKL*STBOOK*TIME:0228*YOUR REF:ANSREMEA / 002*OUR REF:227399795,Accounts Payable (A/P),-12000,54978193.49
08/15/2023,Expense,Grammarly,Mike ross,Credit Card - Ramp,144,54978337.49
08/15/2023,Expense,Grammarly,Mike ross,Tools & Subscription - G&A,144,54978481.49
08/15/2023,Expense,Grammarly,Mike ross,Credit Card - Ramp,144,54978625.49
08/15/2023,Bill Payment (Check),ANSR Dubai,,HSBC A/c,-12000,54966625.49
08/15/2023,Expense,Grammarly,Mike ross,Credit Card - Ramp,144,54966769.49
08/15/2023,Bill Payment (Check),ANSR Dubai,BOOK TRANSFER DEBIT 45BOOK DEBIT CHRONICLEHQ INC.*BNF:ANSR (EMEA) GLOBAL SERVICES LIM ITED*BBI:/DAS/REF:18106O200HKL*STBOOK*TIME:0228*YOUR REF:ANSREMEA / 002*OUR REF:227399795,Accounts Payable (A/P),-12000,54954769.49
08/15/2023,Bill Payment (Check),ANSR Dubai,BOOK TRANSFER DEBIT 45BOOK DEBIT CHRONICLEHQ INC.*BNF:ANSR (EMEA) GLOBAL SERVICES LIM ITED*BBI:/DAS/REF:18106O200HKL*STBOOK*TIME:0228*YOUR REF:ANSREMEA / 002*OUR REF:227399795,Accounts Payable (A/P),-12000,54942769.49
08/15/2023,Expense,Grammarly,Mike ross,Tools & Subscription - G&A,144,54942913.49
08/15/2023,Expense,Grammarly,Mike ross,Tools & Subscription - G&A,144,54943057.49
08/15/2023,Bill Payment (Check),ANSR Dubai,,HSBC A/c,-12000,54931057.49
08/15/2023,Expense,Grammarly,Mike ross,Tools & Subscription - G&A,144,54931201.49
08/15/2023,Bill Payment (Check),ANSR Dubai,BOOK TRANSFER DEBIT 45BOOK DEBIT CHRONICLEHQ INC.*BNF:ANSR (EMEA) GLOBAL SERVICES LIM ITED*BBI:/DAS/REF:18106O200HKL*STBOOK*TIME:0228*YOUR REF:ANSREMEA / 002*OUR REF:227399795,Accounts Payable (A/P),-12000,54919201.49
08/15/2023,Bill Payment (Check),ANSR Dubai,,HSBC A/c,-12000,54907201.49
08/15/2023,Bill Payment (Check),ANSR Dubai,,HSBC A/c,-12000,54895201.49
08/16/2023,Bill,ANSR Dubai,,Professional Service Charges,10874,54906075.49
08/16/2023,Expense,Paypal,Mike ross,Credit Card - Ramp,314.5,54906389.99
08/16/2023,Expense,Zapier,Harvey Spector,Credit Card - Ramp,29.99,54906419.98
08/16/2023,Expense,Zapier,Harvey Spector,Tools & Subscription - G&A,29.99,54906449.97
08/16/2023,Bill,ANSR Dubai,,Professional Service Charges,10874,54917323.97
08/16/2023,Expense,Zapier,Harvey Spector,Tools & Subscription - G&A,29.99,54917353.96
08/16/2023,Expense,Paypal,Mike ross,Tools & Subscription - G&A,314.5,54917668.46
08/16/2023,Bill,ANSR Dubai,Service Fees for August 2023,Accounts Payable (A/P),10874,54928542.46
08/16/2023,Expense,Paypal,Mike ross,Credit Card - Ramp,314.5,54928856.96
08/16/2023,Bill,ANSR Dubai,Service Fees for August 2023,Accounts Payable (A/P),10874,54939730.96
08/16/2023,Bill,ANSR Dubai,,Professional Service Charges,10874,54950604.96
08/16/2023,Expense,Paypal,Mike ross,Tools & Subscription - G&A,314.5,54950919.46
08/16/2023,Expense,Zapier,Harvey Spector,Tools & Subscription - G&A,29.99,54950949.45
08/16/2023,Expense,Paypal,Mike ross,Tools & Subscription - G&A,314.5,54951263.95
08/16/2023,Expense,Paypal,Mike ross,Credit Card - Ramp,314.5,54951578.45
08/16/2023,Bill,ANSR Dubai,Service Fees for August 2023,Accounts Payable (A/P),10874,54962452.45
08/16/2023,Expense,Zapier,Harvey Spector,Credit Card - Ramp,29.99,54962482.44
08/16/2023,Expense,Zapier,Harvey Spector,Tools & Subscription - G&A,29.99,54962512.43
08/16/2023,Bill,ANSR Dubai,,Professional Service Charges,10874,54973386.43
08/16/2023,Expense,Paypal,Mike ross,Tools & Subscription - G&A,314.5,54973700.93
08/16/2023,Bill,ANSR Dubai,Service Fees for August 2023,Accounts Payable (A/P),10874,54984574.93
08/16/2023,Expense,Zapier,Harvey Spector,Credit Card - Ramp,29.99,54984604.92
08/17/2023,Expense,,MONTHLY CHARGE Bank Charges for the per 01JUL2023 TO 31JUL2023 Invoice No 1668519,General business expenses:Bank fees & service charges,-37.23,54984567.69
08/17/2023,Expense,Sejda,Harvey Spector,Credit Card - Ramp,5,54984572.69
08/17/2023,Expense,Sejda,Harvey Spector,Tools & Subscription - G&A,5,54984577.69
08/17/2023,Expense,Sejda,Harvey Spector,Tools & Subscription - G&A,5,54984582.69
08/17/2023,Expense,,Fees,HSBC A/c,37.23,54984619.92
08/17/2023,Expense,,MONTHLY CHARGE Bank Charges for the per 01JUL2023 TO 31JUL2023 Invoice No 1668519,General business expenses:Bank fees & service charges,-37.23,54984582.69
08/17/2023,Expense,Sejda,Harvey Spector,Tools & Subscription - G&A,5,54984587.69
08/17/2023,Expense,,Fees,HSBC A/c,37.23,54984624.92
08/17/2023,Expense,,MONTHLY CHARGE Bank Charges for the per 01JUL2023 TO 31JUL2023 Invoice No 1668519,General business expenses:Bank fees & service charges,-37.23,54984587.69
08/17/2023,Expense,Sejda,Harvey Spector,Tools & Subscription - G&A,5,54984592.69
08/17/2023,Expense,Sejda,Harvey Spector,Credit Card - Ramp,5,54984597.69
08/17/2023,Expense,,Fees,HSBC A/c,37.23,54984634.92
08/17/2023,Expense,,MONTHLY CHARGE Bank Charges for the per 01JUL2023 TO 31JUL2023 Invoice No 1668519,General business expenses:Bank fees & service charges,-37.23,54984597.69
08/17/2023,Expense,,Fees,HSBC A/c,37.23,54984634.92
08/17/2023,Expense,Sejda,Harvey Spector,Credit Card - Ramp,5,54984639.92
08/18/2023,Expense,Single O,Mike ross,Credit Card - Ramp,65.62,54984705.54
08/18/2023,Expense,Single O,Mike ross,Meals & Entertainment,65.62,54984771.16
08/18/2023,Expense,Reclaim.ai,Max Kausman,Credit Card - Ramp,8,54984779.16
08/18/2023,Expense,Uber,Mike ross,Credit Card - Ramp,10.23,54984789.39
08/18/2023,Expense,Single O,Mike ross,Meals & Entertainment,65.62,54984855.01
08/18/2023,Expense,Uber,Mike ross,Credit Card - Ramp,10.23,54984865.24
08/18/2023,Expense,Segment,Balapavan Tirumani,Tools & Subscription - G&A,120,54984985.24
08/18/2023,Expense,LinkedIn,Mike ross,Credit Card - Ramp,149.55,54985134.79
08/18/2023,Expense,LinkedIn,Mike ross,Tools & Subscription - G&A,149.55,54985284.34
08/18/2023,Expense,Reclaim.ai,Max Kausman,Tools & Subscription - G&A,8,54985292.34
08/18/2023,Expense,Uber,Mike ross,Travelling Expenses,10.23,54985302.57
08/18/2023,Expense,Uber,Mike ross,Travelling Expenses,10.23,54985312.8
08/18/2023,Expense,LinkedIn,Mike ross,Tools & Subscription - G&A,149.55,54985462.35
08/18/2023,Expense,Reclaim.ai,Max Kausman,Tools & Subscription - G&A,8,54985470.35
08/18/2023,Expense,Segment,Balapavan Tirumani,Credit Card - Ramp,120,54985590.35
08/18/2023,Expense,Single O,Mike ross,Credit Card - Ramp,65.62,54985655.97
08/18/2023,Expense,Uber,Mike ross,Travelling Expenses,10.23,54985666.2
08/18/2023,Expense,Segment,Balapavan Tirumani,Tools & Subscription - G&A,120,54985786.2
08/18/2023,Expense,Single O,Mike ross,Credit Card - Ramp,65.62,54985851.82
08/18/2023,Expense,Single O,Mike ross,Meals & Entertainment,65.62,54985917.44
08/18/2023,Expense,LinkedIn,Mike ross,Credit Card - Ramp,149.55,54986066.99
08/18/2023,Expense,Segment,Balapavan Tirumani,Tools & Subscription - G&A,120,54986186.99
08/18/2023,Expense,Single O,Mike ross,Meals & Entertainment,65.62,54986252.61
08/18/2023,Expense,LinkedIn,Mike ross,Tools & Subscription - G&A,149.55,54986402.16
08/18/2023,Expense,Segment,Balapavan Tirumani,Credit Card - Ramp,120,54986522.16
08/18/2023,Expense,Reclaim.ai,Max Kausman,Tools & Subscription - G&A,8,54986530.16
08/18/2023,Expense,Uber,Mike ross,Travelling Expenses,10.23,54986540.39
08/18/2023,Expense,Reclaim.ai,Max Kausman,Credit Card - Ramp,8,54986548.39
08/18/2023,Expense,LinkedIn,Mike ross,Tools & Subscription - G&A,149.55,54986697.94
08/18/2023,Expense,Reclaim.ai,Max Kausman,Credit Card - Ramp,8,54986705.94
08/18/2023,Expense,Segment,Balapavan Tirumani,Tools & Subscription - G&A,120,54986825.94
08/18/2023,Expense,Reclaim.ai,Max Kausman,Tools & Subscription - G&A,8,54986833.94
08/18/2023,Expense,LinkedIn,Mike ross,Credit Card - Ramp,149.55,54986983.49
08/18/2023,Expense,Segment,Balapavan Tirumani,Credit Card - Ramp,120,54987103.49
08/18/2023,Expense,Single O,Mike ross,Credit Card - Ramp,65.62,54987169.11
08/18/2023,Expense,Uber,Mike ross,Credit Card - Ramp,10.23,54987179.34
08/19/2023,Expense,Twitter,Harvey Spector,Tools & Subscription - G&A,6.06,54987185.4
08/19/2023,Expense,Twitter,Harvey Spector,Tools & Subscription - G&A,6.06,54987191.46
08/19/2023,Expense,Twitter,Harvey Spector,Tools & Subscription - G&A,6.06,54987197.52
08/19/2023,Expense,Twitter,Harvey Spector,Credit Card - Ramp,6.06,54987203.58
08/19/2023,Expense,Twitter,Harvey Spector,Credit Card - Ramp,6.06,54987209.64
08/19/2023,Expense,Twitter,Harvey Spector,Credit Card - Ramp,6.06,54987215.7
08/19/2023,Expense,Twitter,Harvey Spector,Tools & Subscription - G&A,6.06,54987221.76
08/21/2023,Expense,Henry Lee's,Harvey Spector,Meals & Entertainment,27.25,54987249.01
08/21/2023,Expense,Henry Lee's,Harvey Spector,Meals & Entertainment,6.06,54987255.07
08/21/2023,Expense,Ariel Booksellers,Mike ross,Credit Card - Ramp,88.28,54987343.35
08/21/2023,Expense,Paddington Alimentari,Mike ross,Credit Card - Ramp,35.79,54987379.14
08/21/2023,Expense,Henry Lee's,Harvey Spector,Meals & Entertainment,27.25,54987406.39
08/21/2023,Expense,Uber,Mike ross,Travelling Expenses,16.63,54987423.02
08/21/2023,Expense,The Commons Surry Hil,Mike ross,Travel:Hotels,6.63,54987429.65
08/21/2023,Expense,The Commons Surry Hil,Mike ross,Travel:Hotels,6.63,54987436.28
08/21/2023,Expense,Uber,Mike ross,Travelling Expenses,16.63,54987452.91
08/21/2023,Expense,Henry Lee's,Harvey Spector,Meals & Entertainment,27.25,54987480.16
08/21/2023,Expense,Henry Lee's,Harvey Spector,Meals & Entertainment,6.06,54987486.22
08/21/2023,Expense,Paddington Alimentari,Mike ross,Meals & Entertainment,35.79,54987522.01
08/21/2023,Expense,Ariel Booksellers,Mike ross,Credit Card - Ramp,88.28,54987610.29
08/21/2023,Expense,Henry Lee's,Harvey Spector,Credit Card - Ramp,6.06,54987616.35
08/21/2023,Expense,Henry Lee's,Harvey Spector,Credit Card - Ramp,27.25,54987643.6
08/21/2023,Expense,Ariel Booksellers,Mike ross,General business expenses:Memberships & subscriptions,88.28,54987731.88
08/21/2023,Expense,Paddington Alimentari,Mike ross,Meals & Entertainment,35.79,54987767.67
08/21/2023,Expense,The Commons Surry Hil,Mike ross,Travel:Hotels,6.63,54987774.3
08/21/2023,Expense,The Commons Surry Hil,Mike ross,Credit Card - Ramp,6.63,54987780.93
08/21/2023,Expense,Paddington Alimentari,Mike ross,Credit Card - Ramp,35.79,54987816.72
08/21/2023,Expense,Ariel Booksellers,Mike ross,General business expenses:Memberships & subscriptions,88.28,54987905
08/21/2023,Expense,Henry Lee's,Harvey Spector,Credit Card - Ramp,6.06,54987911.06
08/21/2023,Expense,Henry Lee's,Harvey Spector,Credit Card - Ramp,27.25,54987938.31
08/21/2023,Expense,Henry Lee's,Harvey Spector,Meals & Entertainment,27.25,54987965.56
08/21/2023,Expense,Uber,Mike ross,Travelling Expenses,16.63,54987982.19
08/21/2023,Expense,Ariel Booksellers,Mike ross,Credit Card - Ramp,88.28,54988070.47
08/21/2023,Expense,Paddington Alimentari,Mike ross,Meals & Entertainment,35.79,54988106.26
08/21/2023,Expense,The Commons Surry Hil,Mike ross,Travel:Hotels,6.63,54988112.89
08/21/2023,Expense,Ariel Booksellers,Mike ross,General business expenses:Memberships & subscriptions,88.28,54988201.17
08/21/2023,Expense,Uber,Mike ross,Travelling Expenses,16.63,54988217.8
08/21/2023,Expense,Paddington Alimentari,Mike ross,Meals & Entertainment,35.79,54988253.59
08/21/2023,Expense,Ariel Booksellers,Mike ross,General business expenses:Memberships & subscriptions,88.28,54988341.87
08/21/2023,Expense,Uber,Mike ross,Credit Card - Ramp,16.63,54988358.5
08/21/2023,Expense,Henry Lee's,Harvey Spector,Credit Card - Ramp,6.06,54988364.56
08/21/2023,Expense,Henry Lee's,Harvey Spector,Credit Card - Ramp,27.25,54988391.81
08/21/2023,Expense,Henry Lee's,Harvey Spector,Meals & Entertainment,6.06,54988397.87
08/21/2023,Expense,Henry Lee's,Harvey Spector,Credit Card - Ramp,6.06,54988403.93
08/21/2023,Expense,Uber,Mike ross,Credit Card - Ramp,16.63,54988420.56
08/21/2023,Expense,The Commons Surry Hil,Mike ross,Credit Card - Ramp,6.63,54988427.19
08/21/2023,Expense,Paddington Alimentari,Mike ross,Credit Card - Ramp,35.79,54988462.98
08/21/2023,Expense,Uber,Mike ross,Credit Card - Ramp,16.63,54988479.61
08/21/2023,Expense,Henry Lee's,Harvey Spector,Credit Card - Ramp,27.25,54988506.86
08/21/2023,Expense,Ariel Booksellers,Mike ross,Credit Card - Ramp,88.28,54988595.14
08/21/2023,Expense,The Commons Surry Hil,Mike ross,Credit Card - Ramp,6.63,54988601.77
08/21/2023,Expense,Paddington Alimentari,Mike ross,Credit Card - Ramp,35.79,54988637.56
08/21/2023,Expense,Henry Lee's,Harvey Spector,Meals & Entertainment,6.06,54988643.62
08/22/2023,Credit Card Payment,RAMP BUSINESS CO,RAMP STATEMENT,Account1,-8210.18,54980433.44
08/22/2023,Credit Card Payment,RAMP BUSINESS CO,RAMP STATEMENT,Credit Card - Ramp,-8210.18,54972223.26
08/22/2023,Credit Card Payment,RAMP BUSINESS CO,RAMP STATEMENT,Credit Card - Ramp,-8210.18,54964013.08
08/22/2023,Transfer,,PaymentServiceB Savings **6977,Savings (6977),50000,55014013.08
08/22/2023,Transfer,,PaymentServiceB Savings **6977,Savings (6977),50000,55064013.08
08/22/2023,Expense,Notion Labs,Mike ross,Credit Card - Ramp,3.13,55064016.21
08/22/2023,Expense,Paripe,Mike ross,Meals & Entertainment,98.1,55064114.31
08/22/2023,Expense,Notion Labs,Mike ross,Tools & Subscription - G&A,3.13,55064117.44
08/22/2023,Expense,Uber,Mike ross,Travelling Expenses,8.22,55064125.66
08/22/2023,Expense,Uber,Mike ross,Credit Card - Ramp,8.22,55064133.88
08/22/2023,Expense,Notion Labs,Mike ross,Credit Card - Ramp,3.13,55064137.01
08/22/2023,Expense,Notion Labs,Mike ross,Credit Card - Ramp,3.13,55064140.14
08/22/2023,Expense,Koi Iglu 6Cp Restaurant,Mike ross,Meals & Entertainment,45.66,55064185.8
08/22/2023,Expense,Koi Iglu 6Cp Restaurant,Mike ross,Credit Card - Ramp,45.66,55064231.46
08/22/2023,Expense,Koi Iglu 6Cp Restaurant,Mike ross,Meals & Entertainment,45.66,55064277.12
08/22/2023,Expense,Alex Lee Kitchen,Mike ross,Meals & Entertainment,11.98,55064289.1
08/22/2023,Expense,Koi Iglu 6Cp Restaurant,Mike ross,Credit Card - Ramp,45.66,55064334.76
08/22/2023,Expense,Paripe,Mike ross,Meals & Entertainment,98.1,55064432.86
08/22/2023,Credit Card Payment,RAMP BUSINESS CO,RAMP STATEMENT,Account1,-8210.18,55056222.68
08/22/2023,Expense,Uber,Mike ross,Credit Card - Ramp,29.05,55056251.73
08/22/2023,Credit Card Payment,RAMP BUSINESS CO,RAMP STATEMENT,Credit Card - Ramp,-8210.18,55048041.55
08/22/2023,Expense,Alex Lee Kitchen,Mike ross,Credit Card - Ramp,11.98,55048053.53
08/22/2023,Expense,Uber,Mike ross,Travelling Expenses,8.22,55048061.75
08/22/2023,Expense,Notion Labs,Mike ross,Tools & Subscription - G&A,3.13,55048064.88
08/22/2023,Transfer,,PaymentServiceB Savings **6977,Account1,-50000,54998064.88
08/22/2023,Expense,Paripe,Mike ross,Credit Card - Ramp,98.1,54998162.98
08/22/2023,Transfer,,PaymentServiceB Savings **6977,Savings (6977),50000,55048162.98
08/22/2023,Expense,Alex Lee Kitchen,Mike ross,Meals & Entertainment,11.98,55048174.96
08/22/2023,Credit Card Payment,RAMP BUSINESS CO,RAMP STATEMENT,Credit Card - Ramp,-8210.18,55039964.78
08/22/2023,Expense,Koi Iglu 6Cp Restaurant,Mike ross,Credit Card - Ramp,45.66,55040010.44
08/22/2023,Expense,Uber,Mike ross,Travelling Expenses,8.22,55040018.66
08/22/2023,Expense,Alex Lee Kitchen,Mike ross,Credit Card - Ramp,11.98,55040030.64
08/22/2023,Credit Card Payment,RAMP BUSINESS CO,RAMP STATEMENT,Account1,-8210.18,55031820.46
08/22/2023,Expense,Paripe,Mike ross,Credit Card - Ramp,98.1,55031918.56
08/22/2023,Transfer,,PaymentServiceB Savings **6977,Account1,-50000,54981918.56
08/22/2023,Expense,Uber,Mike ross,Travelling Expenses,29.05,54981947.61
08/22/2023,Transfer,,PaymentServiceB Savings **6977,Account1,-50000,54931947.61
08/22/2023,Expense,Uber,Mike ross,Travelling Expenses,29.05,54931976.66
08/22/2023,Expense,Notion Labs,Mike ross,Tools & Subscription - G&A,3.13,54931979.79
08/22/2023,Expense,Paripe,Mike ross,Meals & Entertainment,98.1,54932077.89
08/22/2023,Expense,Alex Lee Kitchen,Mike ross,Meals & Entertainment,11.98,54932089.87
08/22/2023,Credit Card Payment,RAMP BUSINESS CO,RAMP STATEMENT,Account1,-8210.18,54923879.69
08/22/2023,Expense,Koi Iglu 6Cp Restaurant,Mike ross,Credit Card - Ramp,45.66,54923925.35
08/22/2023,Expense,Alex Lee Kitchen,Mike ross,Credit Card - Ramp,11.98,54923937.33
08/22/2023,Expense,Uber,Mike ross,Travelling Expenses,29.05,54923966.38
08/22/2023,Expense,Uber,Mike ross,Travelling Expenses,29.05,54923995.43
08/22/2023,Expense,Koi Iglu 6Cp Restaurant,Mike ross,Meals & Entertainment,45.66,54924041.09
08/22/2023,Expense,Notion Labs,Mike ross,Tools & Subscription - G&A,3.13,54924044.22
08/22/2023,Expense,Koi Iglu 6Cp Restaurant,Mike ross,Meals & Entertainment,45.66,54924089.88
08/22/2023,Transfer,,PaymentServiceB Savings **6977,Account1,-50000,54874089.88
08/22/2023,Expense,Alex Lee Kitchen,Mike ross,Credit Card - Ramp,11.98,54874101.86
08/22/2023,Expense,Paripe,Mike ross,Credit Card - Ramp,98.1,54874199.96
08/22/2023,Expense,Alex Lee Kitchen,Mike ross,Meals & Entertainment,11.98,54874211.94
08/22/2023,Expense,Paripe,Mike ross,Meals & Entertainment,98.1,54874310.04
08/22/2023,Transfer,,PaymentServiceB Savings **6977,Savings (6977),50000,54924310.04
08/22/2023,Expense,Uber,Mike ross,Credit Card - Ramp,29.05,54924339.09
08/22/2023,Expense,Uber,Mike ross,Credit Card - Ramp,8.22,54924347.31
08/22/2023,Expense,Uber,Mike ross,Credit Card - Ramp,8.22,54924355.53
08/22/2023,Expense,Uber,Mike ross,Credit Card - Ramp,29.05,54924384.58
08/22/2023,Expense,Paripe,Mike ross,Credit Card - Ramp,98.1,54924482.68
08/22/2023,Expense,Uber,Mike ross,Travelling Expenses,8.22,54924490.9
08/23/2023,Expense,Super,Harvey Spector,Credit Card - Ramp,12,54924502.9
08/23/2023,Expense,Superhuman,Mike ross,Credit Card - Ramp,90,54924592.9
08/23/2023,Expense,Uber,Mike ross,Credit Card - Ramp,10.67,54924603.57
08/23/2023,Bill Payment (Check),ANSR Dubai,,HSBC A/c,-10874,54913729.57
08/23/2023,Expense,The Commons Surry Hil,Mike ross,Travel:Hotels,2.66,54913732.23
08/23/2023,Expense,Super,Harvey Spector,Tools & Subscription - G&A,12,54913744.23
08/23/2023,Expense,Superhuman,Mike ross,Professional Service Charges,90,54913834.23
08/23/2023,Expense,Heptabase,Mike ross,Tools & Subscription - G&A,9.99,54913844.22
08/23/2023,Expense,The Commons Surry Hil,Mike ross,Travel:Hotels,2.66,54913846.88
08/23/2023,Expense,Uber,Mike ross,Travelling Expenses,10.67,54913857.55
08/23/2023,Expense,Heptabase,Mike ross,Credit Card - Ramp,9.99,54913867.54
08/23/2023,Expense,Docusign,Harvey Spector,Credit Card - Ramp,15,54913882.54
08/23/2023,Bill Payment (Check),ANSR Dubai,,HSBC A/c,-10874,54903008.54
08/23/2023,Expense,Superhuman,Mike ross,Credit Card - Ramp,90,54903098.54
08/23/2023,Expense,Super,Harvey Spector,Tools & Subscription - G&A,12,54903110.54
08/23/2023,Expense,Uber,Mike ross,Travelling Expenses,10.67,54903121.21
08/23/2023,Expense,Superhuman,Mike ross,Credit Card - Ramp,90,54903211.21
08/23/2023,Expense,Heptabase,Mike ross,Tools & Subscription - G&A,9.99,54903221.2
08/23/2023,Expense,Docusign,Harvey Spector,Tools & Subscription - G&A,15,54903236.2
08/23/2023,Expense,Heptabase,Mike ross,Credit Card - Ramp,9.99,54903246.19
08/23/2023,Expense,Super,Harvey Spector,Credit Card - Ramp,12,54903258.19
08/23/2023,Expense,Superhuman,Mike ross,Professional Service Charges,90,54903348.19
08/23/2023,Expense,Docusign,Harvey Spector,Tools & Subscription - G&A,15,54903363.19
08/23/2023,Expense,The Commons Surry Hil,Mike ross,Credit Card - Ramp,2.66,54903365.85
08/23/2023,Bill Payment (Check),ANSR Dubai,BOOK TRANSFER DEBIT 45BOOK DEBIT CHRONICLEHQ INC.*BNF:ANSR (EMEA) GLOBAL SERVICES LIM ITED*BBI:/DAS/REF:10746OB00JAH*STBOOK*TIME:0732*YOUR REF:ANSREMEA /016*OUR REF:235496921,Accounts Payable (A/P),-10874,54892491.85
08/23/2023,Expense,Docusign,Harvey Spector,Credit Card - Ramp,15,54892506.85
08/23/2023,Expense,The Commons Surry Hil,Mike ross,Travel:Hotels,2.66,54892509.51
08/23/2023,Expense,Uber,Mike ross,Travelling Expenses,10.67,54892520.18
08/23/2023,Expense,Docusign,Harvey Spector,Credit Card - Ramp,15,54892535.18
08/23/2023,Expense,Superhuman,Mike ross,Professional Service Charges,90,54892625.18
08/23/2023,Expense,Heptabase,Mike ross,Credit Card - Ramp,9.99,54892635.17
08/23/2023,Expense,The Commons Surry Hil,Mike ross,Travel:Hotels,2.66,54892637.83
08/23/2023,Expense,Super,Harvey Spector,Credit Card - Ramp,12,54892649.83
08/23/2023,Expense,Super,Harvey Spector,Tools & Subscription - G&A,12,54892661.83
08/23/2023,Expense,Uber,Mike ross,Credit Card - Ramp,10.67,54892672.5
08/23/2023,Bill Payment (Check),ANSR Dubai,,HSBC A/c,-10874,54881798.5
08/23/2023,Expense,Uber,Mike ross,Credit Card - Ramp,10.67,54881809.17
08/23/2023,Expense,The Commons Surry Hil,Mike ross,Credit Card - Ramp,2.66,54881811.83
08/23/2023,Expense,Uber,Mike ross,Travelling Expenses,10.67,54881822.5
08/23/2023,Expense,Heptabase,Mike ross,Tools & Subscription - G&A,9.99,54881832.49
08/23/2023,Expense,Superhuman,Mike ross,Credit Card - Ramp,90,54881922.49
08/23/2023,Expense,Superhuman,Mike ross,Professional Service Charges,90,54882012.49
08/23/2023,Bill Payment (Check),ANSR Dubai,,HSBC A/c,-10874,54871138.49
08/23/2023,Expense,Heptabase,Mike ross,Tools & Subscription - G&A,9.99,54871148.48
08/23/2023,Expense,Docusign,Harvey Spector,Tools & Subscription - G&A,15,54871163.48
08/23/2023,Expense,Super,Harvey Spector,Tools & Subscription - G&A,12,54871175.48
08/23/2023,Bill Payment (Check),ANSR Dubai,BOOK TRANSFER DEBIT 45BOOK DEBIT CHRONICLEHQ INC.*BNF:ANSR (EMEA) GLOBAL SERVICES LIM ITED*BBI:/DAS/REF:10746OB00JAH*STBOOK*TIME:0732*YOUR REF:ANSREMEA /016*OUR REF:235496921,Accounts Payable (A/P),-10874,54860301.48
08/23/2023,Expense,Docusign,Harvey Spector,Tools & Subscription - G&A,15,54860316.48
08/23/2023,Bill Payment (Check),ANSR Dubai,BOOK TRANSFER DEBIT 45BOOK DEBIT CHRONICLEHQ INC.*BNF:ANSR (EMEA) GLOBAL SERVICES LIM ITED*BBI:/DAS/REF:10746OB00JAH*STBOOK*TIME:0732*YOUR REF:ANSREMEA /016*OUR REF:235496921,Accounts Payable (A/P),-10874,54849442.48
08/23/2023,Expense,The Commons Surry Hil,Mike ross,Credit Card - Ramp,2.66,54849445.14
08/23/2023,Bill Payment (Check),ANSR Dubai,BOOK TRANSFER DEBIT 45BOOK DEBIT CHRONICLEHQ INC.*BNF:ANSR (EMEA) GLOBAL SERVICES LIM ITED*BBI:/DAS/REF:10746OB00JAH*STBOOK*TIME:0732*YOUR REF:ANSREMEA /016*OUR REF:235496921,Accounts Payable (A/P),-10874,54838571.14
08/24/2023,Expense,Benedict Evans,Harvey Spector,Credit Card - Ramp,10,54838581.14
08/24/2023,Expense,Bourke Street Bakery,Mike ross,Meals & Entertainment,21.59,54838602.73
08/24/2023,Expense,Benedict Evans,Harvey Spector,Professional Service Charges,10,54838612.73
08/24/2023,Expense,Benedict Evans,Harvey Spector,Professional Service Charges,10,54838622.73
08/24/2023,Expense,Bourke Street Bakery,Mike ross,Meals & Entertainment,21.59,54838644.32
08/24/2023,Expense,Big Company ,Income Capitals ,Contract labor,-9554,54829090.32
08/24/2023,Expense,Big Company ,Income Capitals ,Contract labor,-9554,54819536.32
08/24/2023,Expense,Big Company ,Income Capitals ,Contract labor,-9554,54809982.32
08/24/2023,Expense,Big Company ,Income Capitals ,Account1,9554,54819536.32
08/24/2023,Expense,Big Company ,Income Capitals ,Account1,9554,54829090.32
08/24/2023,Expense,Bourke Street Bakery,Mike ross,Credit Card - Ramp,21.59,54829111.91
08/24/2023,Expense,Benedict Evans,Harvey Spector,Credit Card - Ramp,10,54829121.91
08/24/2023,Expense,Big Company ,Income Capitals ,Account1,9554,54838675.91
08/24/2023,Expense,Big Company ,Income Capitals ,Account1,9554,54848229.91
08/24/2023,Expense,Benedict Evans,Harvey Spector,Professional Service Charges,10,54848239.91
08/24/2023,Expense,Benedict Evans,Harvey Spector,Credit Card - Ramp,10,54848249.91
08/24/2023,Expense,Bourke Street Bakery,Mike ross,Credit Card - Ramp,21.59,54848271.5
08/24/2023,Expense,Benedict Evans,Harvey Spector,Credit Card - Ramp,10,54848281.5
08/24/2023,Expense,Bourke Street Bakery,Mike ross,Credit Card - Ramp,21.59,54848303.09
08/24/2023,Expense,Big Company ,Income Capitals ,Contract labor,-9554,54838749.09
08/24/2023,Expense,Bourke Street Bakery,Mike ross,Credit Card - Ramp,21.59,54838770.68
08/24/2023,Expense,Bourke Street Bakery,Mike ross,Meals & Entertainment,21.59,54838792.27
08/24/2023,Expense,Benedict Evans,Harvey Spector,Professional Service Charges,10,54838802.27
08/24/2023,Expense,Bourke Street Bakery,Mike ross,Meals & Entertainment,21.59,54838823.86
08/25/2023,Expense,Careem,Harvey Spector,Travelling Expenses,5.33,54838829.19
08/25/2023,Expense,Miro,Mike ross,Tools & Subscription - G&A,100,54838929.19
08/25/2023,Expense,Careem,Harvey Spector,Travelling Expenses,5.33,54838934.52
08/25/2023,Expense,Careem,Harvey Spector,Credit Card - Ramp,5.33,54838939.85
08/25/2023,Expense,Miro,Mike ross,Tools & Subscription - G&A,100,54839039.85
08/25/2023,Expense,Miro,Mike ross,Tools & Subscription - G&A,100,54839139.85
08/25/2023,Expense,Zoom,Chad Blumenthal,Tools & Subscription - G&A,15.99,54839155.84
08/25/2023,Expense,Zoom,Chad Blumenthal,Tools & Subscription - G&A,15.99,54839171.83
08/25/2023,Expense,Zoom,Chad Blumenthal,Tools & Subscription - G&A,15.99,54839187.82
08/25/2023,Expense,Zoom,Chad Blumenthal,Credit Card - Ramp,15.99,54839203.81
08/25/2023,Expense,Miro,Mike ross,Credit Card - Ramp,100,54839303.81
08/25/2023,Expense,Careem,Harvey Spector,Travelling Expenses,5.33,54839309.14
08/25/2023,Expense,Zoom,Chad Blumenthal,Tools & Subscription - G&A,15.99,54839325.13
08/25/2023,Expense,Miro,Mike ross,Credit Card - Ramp,100,54839425.13
08/25/2023,Expense,Zoom,Chad Blumenthal,Credit Card - Ramp,15.99,54839441.12
08/25/2023,Expense,Careem,Harvey Spector,Credit Card - Ramp,5.33,54839446.45
08/25/2023,Expense,Careem,Harvey Spector,Travelling Expenses,5.33,54839451.78
08/25/2023,Expense,Miro,Mike ross,Tools & Subscription - G&A,100,54839551.78
08/25/2023,Expense,Miro,Mike ross,Credit Card - Ramp,100,54839651.78
08/25/2023,Expense,Careem,Harvey Spector,Credit Card - Ramp,5.33,54839657.11
08/25/2023,Expense,Zoom,Chad Blumenthal,Credit Card - Ramp,15.99,54839673.1
08/26/2023,Expense,Uber,Mike ross,Credit Card - Ramp,8.88,54839681.98
08/26/2023,Expense,Uber,Mike ross,Travelling Expenses,11.94,54839693.92
08/26/2023,Expense,Uber,Mike ross,Credit Card - Ramp,8.63,54839702.55
08/26/2023,Expense,Uber,Mike ross,Travelling Expenses,8.88,54839711.43
08/26/2023,Expense,Uber,Mike ross,Credit Card - Ramp,8.88,54839720.31
08/26/2023,Expense,Uber,Mike ross,Credit Card - Ramp,8.63,54839728.94
08/26/2023,Expense,Uber,Mike ross,Travelling Expenses,8.63,54839737.57
08/26/2023,Expense,Uber,Mike ross,Travelling Expenses,8.63,54839746.2
08/26/2023,Expense,Uber,Mike ross,Credit Card - Ramp,11.94,54839758.14
08/26/2023,Expense,Uber,Mike ross,Travelling Expenses,8.88,54839767.02
08/26/2023,Expense,Uber,Mike ross,Travelling Expenses,8.63,54839775.65
08/26/2023,Expense,Uber,Mike ross,Credit Card - Ramp,11.94,54839787.59
08/26/2023,Expense,Uber,Mike ross,Travelling Expenses,11.94,54839799.53
08/26/2023,Expense,Uber,Mike ross,Travelling Expenses,8.88,54839808.41
08/26/2023,Expense,Uber,Mike ross,Credit Card - Ramp,11.94,54839820.35
08/26/2023,Expense,Uber,Mike ross,Credit Card - Ramp,8.63,54839828.98
08/26/2023,Expense,Uber,Mike ross,Credit Card - Ramp,8.88,54839837.86
08/26/2023,Expense,Uber,Mike ross,Travelling Expenses,8.88,54839846.74
08/26/2023,Expense,Uber,Mike ross,Travelling Expenses,11.94,54839858.68
08/26/2023,Expense,Uber,Mike ross,Travelling Expenses,8.63,54839867.31
08/26/2023,Expense,Uber,Mike ross,Travelling Expenses,11.94,54839879.25
08/27/2023,Expense,Splitbee,Harris Jose,Tools & Subscription - G&A,16.52,54839895.77
08/27/2023,Expense,Sentry,Balapavan Tirumani,Tools & Subscription - G&A,29,54839924.77
08/27/2023,Expense,Uber,Mike ross,Travelling Expenses,13.84,54839938.61
08/27/2023,Expense,Uber,Mike ross,Travelling Expenses,13.84,54839952.45
08/27/2023,Expense,Uber,Mike ross,Credit Card - Ramp,13.84,54839966.29
08/27/2023,Expense,Splitbee,Harris Jose,Credit Card - Ramp,16.52,54839982.81
08/27/2023,Expense,Splitbee,Harris Jose,Tools & Subscription - G&A,16.52,54839999.33
08/27/2023,Expense,Sentry,Balapavan Tirumani,Tools & Subscription - G&A,29,54840028.33
08/27/2023,Expense,Sentry,Balapavan Tirumani,Credit Card - Ramp,29,54840057.33
08/27/2023,Expense,Sendinblue,Balapavan Tirumani,Tools & Subscription - G&A,78.95,54840136.28
08/27/2023,Expense,Uber,Mike ross,Credit Card - Ramp,13.84,54840150.12
08/27/2023,Expense,Uber,Mike ross,Credit Card - Ramp,13.84,54840163.96
08/27/2023,Expense,Sendinblue,Balapavan Tirumani,Tools & Subscription - G&A,78.95,54840242.91
08/27/2023,Expense,Sendinblue,Balapavan Tirumani,Credit Card - Ramp,78.95,54840321.86
08/27/2023,Expense,Splitbee,Harris Jose,Credit Card - Ramp,16.52,54840338.38
08/27/2023,Expense,Splitbee,Harris Jose,Tools & Subscription - G&A,16.52,54840354.9
08/27/2023,Expense,Sentry,Balapavan Tirumani,Tools & Subscription - G&A,29,54840383.9
08/27/2023,Expense,Sendinblue,Balapavan Tirumani,Tools & Subscription - G&A,78.95,54840462.85
08/27/2023,Expense,Sendinblue,Balapavan Tirumani,Tools & Subscription - G&A,78.95,54840541.8
08/27/2023,Expense,Splitbee,Harris Jose,Tools & Subscription - G&A,16.52,54840558.32
08/27/2023,Expense,Uber,Mike ross,Travelling Expenses,13.84,54840572.16
08/27/2023,Expense,Sentry,Balapavan Tirumani,Tools & Subscription - G&A,29,54840601.16
08/27/2023,Expense,Uber,Mike ross,Travelling Expenses,13.84,54840615
08/27/2023,Expense,Sendinblue,Balapavan Tirumani,Credit Card - Ramp,78.95,54840693.95
08/27/2023,Expense,Sentry,Balapavan Tirumani,Credit Card - Ramp,29,54840722.95
08/27/2023,Expense,Splitbee,Harris Jose,Credit Card - Ramp,16.52,54840739.47
08/27/2023,Expense,Sentry,Balapavan Tirumani,Credit Card - Ramp,29,54840768.47
08/27/2023,Expense,Sendinblue,Balapavan Tirumani,Credit Card - Ramp,78.95,54840847.42
08/28/2023,Expense,Github,Balapavan Tirumani,Credit Card - Ramp,10,54840857.42
08/28/2023,Expense,bills,Mike ross,Meals & Entertainment,24.59,54840882.01
08/28/2023,Expense,bills,Mike ross,Credit Card - Ramp,24.59,54840906.6
08/28/2023,Expense,bills,Mike ross,Meals & Entertainment,24.59,54840931.19
08/28/2023,Expense,Github,Balapavan Tirumani,Tools & Subscription - G&A,10,54840941.19
08/28/2023,Expense,Github,Balapavan Tirumani,Tools & Subscription - G&A,44,54840985.19
08/28/2023,Expense,bills,Mike ross,Credit Card - Ramp,24.59,54841009.78
08/28/2023,Expense,bills,Mike ross,Meals & Entertainment,24.59,54841034.37
08/28/2023,Expense,Github,Balapavan Tirumani,Tools & Subscription - G&A,10,54841044.37
08/28/2023,Expense,Github,Balapavan Tirumani,Tools & Subscription - G&A,44,54841088.37
08/28/2023,Expense,Github,Balapavan Tirumani,Tools & Subscription - G&A,10,54841098.37
08/28/2023,Expense,Github,Balapavan Tirumani,Credit Card - Ramp,44,54841142.37
08/28/2023,Expense,Github,Balapavan Tirumani,Tools & Subscription - G&A,10,54841152.37
08/28/2023,Expense,bills,Mike ross,Credit Card - Ramp,24.59,54841176.96
08/28/2023,Expense,bills,Mike ross,Credit Card - Ramp,24.59,54841201.55
08/28/2023,Expense,bills,Mike ross,Meals & Entertainment,24.59,54841226.14
08/28/2023,Expense,Github,Balapavan Tirumani,Tools & Subscription - G&A,44,54841270.14
08/28/2023,Expense,Github,Balapavan Tirumani,Credit Card - Ramp,10,54841280.14
08/28/2023,Expense,Github,Balapavan Tirumani,Credit Card - Ramp,44,54841324.14
08/28/2023,Expense,Github,Balapavan Tirumani,Tools & Subscription - G&A,44,54841368.14
08/28/2023,Expense,Github,Balapavan Tirumani,Credit Card - Ramp,10,54841378.14
08/28/2023,Expense,Github,Balapavan Tirumani,Credit Card - Ramp,44,54841422.14
08/29/2023,Expense,Netlify,Balapavan Tirumani,Tools & Subscription - G&A,19,54841441.14
08/29/2023,Expense,Netlify,Balapavan Tirumani,Tools & Subscription - G&A,19,54841460.14
08/29/2023,Expense,Netlify,Balapavan Tirumani,Credit Card - Ramp,19,54841479.14
08/29/2023,Expense,Netlify,Balapavan Tirumani,Credit Card - Ramp,19,54841498.14
08/29/2023,Expense,Netlify,Balapavan Tirumani,Tools & Subscription - G&A,19,54841517.14
08/29/2023,Expense,Netlify,Balapavan Tirumani,Credit Card - Ramp,19,54841536.14
08/29/2023,Expense,Netlify,Balapavan Tirumani,Tools & Subscription - G&A,19,54841555.14
08/30/2023,Expense,Mecca Coffee Roasters Restaurant,Mike ross,Meals & Entertainment,47.47,54841602.61
08/30/2023,Expense,Mecca Coffee Roasters Restaurant,Mike ross,Credit Card - Ramp,47.47,54841650.08
08/30/2023,Expense,Mecca Coffee Roasters Restaurant,Mike ross,Credit Card - Ramp,47.47,54841697.55
08/30/2023,Expense,Mecca Coffee Roasters Restaurant,Mike ross,Credit Card - Ramp,47.47,54841745.02
08/30/2023,Expense,Mecca Coffee Roasters Restaurant,Mike ross,Meals & Entertainment,47.47,54841792.49
08/30/2023,Expense,inkle,Harvey Spector,Tools & Subscription - G&A,30,54841822.49
08/30/2023,Expense,inkle,Harvey Spector,Tools & Subscription - G&A,30,54841852.49
08/30/2023,Expense,inkle,Harvey Spector,Credit Card - Ramp,30,54841882.49
08/30/2023,Expense,inkle,Harvey Spector,Credit Card - Ramp,30,54841912.49
08/30/2023,Expense,inkle,Harvey Spector,Tools & Subscription - G&A,30,54841942.49
08/30/2023,Expense,Mecca Coffee Roasters Restaurant,Mike ross,Meals & Entertainment,47.47,54841989.96
08/30/2023,Expense,Mecca Coffee Roasters Restaurant,Mike ross,Meals & Entertainment,47.47,54842037.43
08/30/2023,Expense,inkle,Harvey Spector,Credit Card - Ramp,30,54842067.43
08/30/2023,Expense,Mecca Coffee Roasters Restaurant,Mike ross,Credit Card - Ramp,47.47,54842114.9
08/30/2023,Expense,inkle,Harvey Spector,Tools & Subscription - G&A,30,54842144.9
08/31/2023,Expense,The Commons Surry Hil,Mike ross,Credit Card - Ramp,8.06,54842152.96
08/31/2023,Bill,Big Company ,,Outsources Services - India,29950,54872102.96
08/31/2023,Bill,Big Company ,"Service Expenses for the month of August 2023 
INR   24,75,991   @ 82.6717",Accounts Payable (A/P),29950,54902052.96
08/31/2023,Expense,Adobe,Mike ross,Credit Card - Ramp,14.78,54902067.74
08/31/2023,Expense,Adobe,Mike ross,Tools & Subscription - S&M,14.78,54902082.52
08/31/2023,Bill,Big Company ,"Service Expenses for the month of August 2023 
INR   24,75,991   @ 82.6717",Accounts Payable (A/P),29950,54932032.52
08/31/2023,Bill,Big Company ,,Outsources Services - India,29950,54961982.52
08/31/2023,Expense,The Commons Surry Hil,Mike ross,Travel:Hotels,8.06,54961990.58
08/31/2023,Bill,Big Company ,,Outsources Services - India,29950,54991940.58
08/31/2023,Bill,Big Company ,"Service Expenses for the month of August 2023 
INR   24,75,991   @ 82.6717",Accounts Payable (A/P),29950,55021890.58
08/31/2023,Expense,Adobe,Mike ross,Tools & Subscription - S&M,14.78,55021905.36
08/31/2023,Expense,The Commons Surry Hil,Mike ross,Credit Card - Ramp,8.06,55021913.42
08/31/2023,Expense,Adobe,Mike ross,Credit Card - Ramp,14.78,55021928.2
08/31/2023,Bill,Big Company ,"Service Expenses for the month of August 2023 
INR   24,75,991   @ 82.6717",Accounts Payable (A/P),29950,55051878.2
08/31/2023,Bill,Big Company ,,Outsources Services - India,29950,55081828.2
08/31/2023,Expense,Adobe,Mike ross,Credit Card - Ramp,14.78,55081842.98
08/31/2023,Expense,The Commons Surry Hil,Mike ross,Travel:Hotels,8.06,55081851.04
08/31/2023,Expense,Adobe,Mike ross,Tools & Subscription - S&M,14.78,55081865.82
08/31/2023,Expense,The Commons Surry Hil,Mike ross,Travel:Hotels,8.06,55081873.88
08/31/2023,Expense,The Commons Surry Hil,Mike ross,Credit Card - Ramp,8.06,55081881.94
08/31/2023,Expense,The Commons Surry Hil,Mike ross,Travel:Hotels,8.06,55081890
08/31/2023,Expense,Adobe,Mike ross,Tools & Subscription - S&M,14.78,55081904.78
09/01/2023,Expense,Typeform,Harvey Spector,Tools & Subscription - G&A,990,55082894.78
09/01/2023,Expense,Google G Suite,Mike ross,Tools & Subscription - G&A,139.34,55083034.12
09/01/2023,Expense,Typeform,Harvey Spector,Credit Card - Ramp,990,55084024.12
09/01/2023,Expense,Render,Balapavan Tirumani,Credit Card - Ramp,264.24,55084288.36
09/01/2023,Expense,Render,Balapavan Tirumani,Credit Card - Ramp,264.24,55084552.6
09/01/2023,Expense,Google G Suite,Mike ross,Credit Card - Ramp,139.34,55084691.94
09/01/2023,Expense,Render,Balapavan Tirumani,Tools & Subscription - G&A,264.24,55084956.18
09/01/2023,Expense,Typeform,Harvey Spector,Credit Card - Ramp,990,55085946.18
09/01/2023,Expense,Google G Suite,Mike ross,Credit Card - Ramp,139.34,55086085.52
09/01/2023,Expense,Render,Balapavan Tirumani,Tools & Subscription - G&A,264.24,55086349.76
09/01/2023,Expense,Adobe,Chris George,Credit Card - Ramp,31.49,55086381.25
09/01/2023,Expense,Adobe,Chris George,Tools & Subscription - S&M,31.49,55086412.74
09/01/2023,Expense,Typeform,Harvey Spector,Tools & Subscription - G&A,990,55087402.74
09/01/2023,Expense,Adobe,Chris George,Credit Card - Ramp,31.49,55087434.23
09/01/2023,Expense,Render,Balapavan Tirumani,Tools & Subscription - G&A,264.24,55087698.47
09/01/2023,Expense,Google G Suite,Mike ross,Credit Card - Ramp,139.34,55087837.81
09/01/2023,Expense,Adobe,Chris George,Credit Card - Ramp,31.49,55087869.3
09/01/2023,Expense,Render,Balapavan Tirumani,Tools & Subscription - G&A,264.24,55088133.54
09/01/2023,Expense,Google G Suite,Mike ross,Tools & Subscription - G&A,139.34,55088272.88
09/01/2023,Expense,Adobe,Chris George,Tools & Subscription - S&M,31.49,55088304.37
09/01/2023,Expense,Render,Balapavan Tirumani,Credit Card - Ramp,264.24,55088568.61
09/01/2023,Expense,Typeform,Harvey Spector,Credit Card - Ramp,990,55089558.61
09/01/2023,Expense,Typeform,Harvey Spector,Tools & Subscription - G&A,990,55090548.61
09/01/2023,Expense,Google G Suite,Mike ross,Tools & Subscription - G&A,139.34,55090687.95
09/01/2023,Expense,Adobe,Chris George,Tools & Subscription - S&M,31.49,55090719.44
09/01/2023,Expense,Typeform,Harvey Spector,Tools & Subscription - G&A,990,55091709.44
09/01/2023,Expense,Google G Suite,Mike ross,Tools & Subscription - G&A,139.34,55091848.78
09/01/2023,Expense,Adobe,Chris George,Tools & Subscription - S&M,31.49,55091880.27
09/02/2023,Expense,Uber,Mike ross,Travelling Expenses,14.72,55091894.99
09/02/2023,Expense,Uber,Mike ross,Credit Card - Ramp,38.77,55091933.76
09/02/2023,Expense,June,Balapavan Tirumani,Tools & Subscription - G&A,149,55092082.76
09/02/2023,Expense,Uber,Mike ross,Travelling Expenses,38.77,55092121.53
09/02/2023,Expense,Uber,Mike ross,Travelling Expenses,14.72,55092136.25
09/02/2023,Expense,June,Balapavan Tirumani,Credit Card - Ramp,149,55092285.25
09/02/2023,Expense,Uber,Mike ross,Credit Card - Ramp,14.72,55092299.97
09/02/2023,Expense,Uber,Mike ross,Credit Card - Ramp,38.77,55092338.74
09/02/2023,Expense,June,Balapavan Tirumani,Tools & Subscription - G&A,149,55092487.74
09/02/2023,Expense,Uber,Mike ross,Travelling Expenses,38.77,55092526.51
09/02/2023,Expense,Uber,Mike ross,Credit Card - Ramp,14.72,55092541.23
09/02/2023,Expense,June,Balapavan Tirumani,Credit Card - Ramp,149,55092690.23
09/02/2023,Expense,Uber,Mike ross,Travelling Expenses,38.77,55092729
09/02/2023,Expense,June,Balapavan Tirumani,Tools & Subscription - G&A,149,55092878
09/02/2023,Expense,Uber,Mike ross,Travelling Expenses,38.77,55092916.77
09/02/2023,Expense,June,Balapavan Tirumani,Credit Card - Ramp,149,55093065.77
09/02/2023,Expense,June,Balapavan Tirumani,Tools & Subscription - G&A,149,55093214.77
09/02/2023,Expense,Uber,Mike ross,Credit Card - Ramp,14.72,55093229.49
09/02/2023,Expense,Uber,Mike ross,Travelling Expenses,14.72,55093244.21
09/02/2023,Expense,Uber,Mike ross,Credit Card - Ramp,38.77,55093282.98
09/02/2023,Expense,Uber,Mike ross,Travelling Expenses,14.72,55093297.7
09/03/2023,Expense,VirtualPostMail,Harvey Spector,General business expenses:Memberships & subscriptions,35,55093332.7
09/03/2023,Expense,VirtualPostMail,Harvey Spector,Credit Card - Ramp,35,55093367.7
09/03/2023,Deposit,,Interest Accrual INTEREST,Interest Received,2.2,55093369.9
09/03/2023,Expense,The New York Times,Mike ross,General business expenses:Memberships & subscriptions,8.06,55093377.96
09/03/2023,Expense,Fey,Harvey Spector,Tools & Subscription - G&A,30,55093407.96
09/03/2023,Deposit,,Interest Accrual INTEREST,Interest Received,2.2,55093410.16
09/03/2023,Expense,Fey,Harvey Spector,Tools & Subscription - G&A,30,55093440.16
09/03/2023,Expense,Fey,Harvey Spector,Credit Card - Ramp,30,55093470.16
09/03/2023,Expense,The New York Times,Mike ross,General business expenses:Memberships & subscriptions,8.06,55093478.22
09/03/2023,Expense,The New York Times,Mike ross,Credit Card - Ramp,8.06,55093486.28
09/03/2023,Expense,Fey,Harvey Spector,Credit Card - Ramp,30,55093516.28
09/03/2023,Expense,VirtualPostMail,Harvey Spector,General business expenses:Memberships & subscriptions,35,55093551.28
09/03/2023,Expense,VirtualPostMail,Harvey Spector,General business expenses:Memberships & subscriptions,35,55093586.28
09/03/2023,Deposit,,Interest Accrual INTEREST,Interest Received,2.2,55093588.48
09/03/2023,Deposit,,Interest Accrual INTEREST,Savings (6977),2.2,55093590.68
09/03/2023,Expense,Fey,Harvey Spector,Credit Card - Ramp,30,55093620.68
09/03/2023,Deposit,,Interest Accrual INTEREST,Savings (6977),2.2,55093622.88
09/03/2023,Expense,VirtualPostMail,Harvey Spector,Credit Card - Ramp,35,55093657.88
09/03/2023,Deposit,,Interest Accrual INTEREST,Savings (6977),2.2,55093660.08
09/03/2023,Expense,VirtualPostMail,Harvey Spector,Credit Card - Ramp,35,55093695.08
09/03/2023,Expense,The New York Times,Mike ross,Credit Card - Ramp,8.06,55093703.14
09/03/2023,Expense,VirtualPostMail,Harvey Spector,General business expenses:Memberships & subscriptions,35,55093738.14
09/03/2023,Deposit,,Interest Accrual INTEREST,Interest Received,2.2,55093740.34
09/03/2023,Expense,The New York Times,Mike ross,Credit Card - Ramp,8.06,55093748.4
09/03/2023,Expense,VirtualPostMail,Harvey Spector,Credit Card - Ramp,35,55093783.4
09/03/2023,Expense,Fey,Harvey Spector,Tools & Subscription - G&A,30,55093813.4
09/03/2023,Expense,The New York Times,Mike ross,General business expenses:Memberships & subscriptions,8.06,55093821.46
09/03/2023,Expense,Fey,Harvey Spector,Tools & Subscription - G&A,30,55093851.46
09/03/2023,Expense,The New York Times,Mike ross,General business expenses:Memberships & subscriptions,8.06,55093859.52
09/03/2023,Expense,The New York Times,Mike ross,Credit Card - Ramp,8.06,55093867.58
09/04/2023,Expense,Four Ate Five,Mike ross,Credit Card - Ramp,14.68,55093882.26
09/04/2023,Expense,Four Ate Five,Mike ross,Meals & Entertainment,14.68,55093896.94
09/04/2023,Expense,OpenAI,Mike ross,Credit Card - Ramp,20,55093916.94
09/04/2023,Expense,Four Ate Five,Mike ross,Meals & Entertainment,14.68,55093931.62
09/04/2023,Expense,OpenAI,Mike ross,Credit Card - Ramp,20,55093951.62
09/04/2023,Expense,OpenAI,Mike ross,Tools & Subscription - G&A,20,55093971.62
09/04/2023,Expense,OpenAI,Mike ross,Tools & Subscription - G&A,20,55093991.62
09/04/2023,Expense,OpenAI,Mike ross,Tools & Subscription - G&A,20,55094011.62
09/04/2023,Expense,OpenAI,Mike ross,Credit Card - Ramp,20,55094031.62
09/04/2023,Expense,OpenAI,Mike ross,Tools & Subscription - G&A,20,55094051.62
09/04/2023,Expense,Four Ate Five,Mike ross,Meals & Entertainment,14.68,55094066.3
09/04/2023,Expense,Four Ate Five,Mike ross,Credit Card - Ramp,14.68,55094080.98
09/04/2023,Expense,Four Ate Five,Mike ross,Credit Card - Ramp,14.68,55094095.66
09/04/2023,Expense,Four Ate Five,Mike ross,Meals & Entertainment,14.68,55094110.34
09/04/2023,Expense,Four Ate Five,Mike ross,Credit Card - Ramp,14.68,55094125.02
09/05/2023,Expense,Four Ate Five,Mike ross,Credit Card - Ramp,14.92,55094139.94
09/05/2023,Expense,Four Ate Five,Mike ross,Meals & Entertainment,14.92,55094154.86
09/05/2023,Expense,Four Ate Five,Mike ross,Credit Card - Ramp,14.92,55094169.78
09/05/2023,Expense,Four Ate Five,Mike ross,Meals & Entertainment,14.92,55094184.7
09/05/2023,Expense,Four Ate Five,Mike ross,Credit Card - Ramp,14.92,55094199.62
09/05/2023,Expense,Four Ate Five,Mike ross,Meals & Entertainment,14.92,55094214.54
09/05/2023,Expense,Four Ate Five,Mike ross,Meals & Entertainment,14.92,55094229.46
09/05/2023,Expense,Four Ate Five,Mike ross,Credit Card - Ramp,14.92,55094244.38
09/06/2023,Expense,Adobe,Mike ross,Tools & Subscription - S&M,81.27,55094325.65
09/06/2023,Expense,Adobe,Mike ross,Tools & Subscription - S&M,81.27,55094406.92
09/06/2023,Expense,Adobe,Mike ross,Credit Card - Ramp,81.27,55094488.19
09/06/2023,Expense,Adobe,Mike ross,Credit Card - Ramp,81.27,55094569.46
09/06/2023,Expense,Adobe,Mike ross,Tools & Subscription - S&M,81.27,55094650.73
09/06/2023,Expense,Adobe,Mike ross,Credit Card - Ramp,81.27,55094732
09/06/2023,Expense,Adobe,Mike ross,Tools & Subscription - S&M,81.27,55094813.27
09/07/2023,Expense,Heroku,Balapavan Tirumani,Tools & Subscription - S&M,85,55094898.27
09/07/2023,Expense,Heroku,Balapavan Tirumani,Credit Card - Ramp,85,55094983.27
09/07/2023,Expense,Heroku,Balapavan Tirumani,Tools & Subscription - S&M,85,55095068.27
09/07/2023,Expense,Heroku,Balapavan Tirumani,Credit Card - Ramp,85,55095153.27
09/07/2023,Expense,Heroku,Balapavan Tirumani,Tools & Subscription - S&M,85,55095238.27
09/07/2023,Expense,Heroku,Balapavan Tirumani,Credit Card - Ramp,85,55095323.27
09/07/2023,Expense,Heroku,Balapavan Tirumani,Tools & Subscription - S&M,85,55095408.27
09/09/2023,Expense,Uber,Mike ross,Credit Card - Ramp,33.11,55095441.38
09/09/2023,Expense,Usersnap,Harris Jose,Tools & Subscription - G&A,99,55095540.38
09/09/2023,Expense,OpenAI,Balapavan Tirumani,Tools & Subscription - G&A,20,55095560.38
09/09/2023,Expense,Uber,Mike ross,Travelling Expenses,33.11,55095593.49
09/09/2023,Expense,OpenAI,Balapavan Tirumani,Credit Card - Ramp,20,55095613.49
09/09/2023,Expense,Uber,Mike ross,Travelling Expenses,41.21,55095654.7
09/09/2023,Expense,Taplio,Harvey Spector,Tools & Subscription - G&A,39,55095693.7
09/09/2023,Expense,Uber,Mike ross,Credit Card - Ramp,33.11,55095726.81
09/09/2023,Expense,Uber,Mike ross,Credit Card - Ramp,41.21,55095768.02
09/09/2023,Expense,Uber,Mike ross,Travelling Expenses,41.21,55095809.23
09/09/2023,Expense,Taplio,Harvey Spector,Credit Card - Ramp,39,55095848.23
09/09/2023,Expense,Uber,Mike ross,Credit Card - Ramp,33.11,55095881.34
09/09/2023,Expense,Uber,Mike ross,Credit Card - Ramp,41.21,55095922.55
09/09/2023,Expense,OpenAI,Balapavan Tirumani,Credit Card - Ramp,20,55095942.55
09/09/2023,Expense,Usersnap,Harris Jose,Credit Card - Ramp,99,55096041.55
09/09/2023,Expense,Uber,Mike ross,Travelling Expenses,33.11,55096074.66
09/09/2023,Expense,Uber,Mike ross,Credit Card - Ramp,41.21,55096115.87
09/09/2023,Expense,OpenAI,Balapavan Tirumani,Tools & Subscription - G&A,20,55096135.87
09/09/2023,Expense,Usersnap,Harris Jose,Tools & Subscription - G&A,99,55096234.87
09/09/2023,Expense,Taplio,Harvey Spector,Tools & Subscription - G&A,39,55096273.87
09/09/2023,Expense,Taplio,Harvey Spector,Tools & Subscription - G&A,39,55096312.87
09/09/2023,Expense,Uber,Mike ross,Travelling Expenses,41.21,55096354.08
09/09/2023,Expense,OpenAI,Balapavan Tirumani,Credit Card - Ramp,20,55096374.08
09/09/2023,Expense,Taplio,Harvey Spector,Credit Card - Ramp,39,55096413.08
09/09/2023,Expense,Usersnap,Harris Jose,Tools & Subscription - G&A,99,55096512.08
09/09/2023,Expense,Taplio,Harvey Spector,Tools & Subscription - G&A,39,55096551.08
09/09/2023,Expense,OpenAI,Balapavan Tirumani,Tools & Subscription - G&A,20,55096571.08
09/09/2023,Expense,Uber,Mike ross,Travelling Expenses,33.11,55096604.19
09/09/2023,Expense,OpenAI,Balapavan Tirumani,Tools & Subscription - G&A,20,55096624.19
09/09/2023,Expense,Usersnap,Harris Jose,Credit Card - Ramp,99,55096723.19
09/09/2023,Expense,Uber,Mike ross,Travelling Expenses,33.11,55096756.3
09/09/2023,Expense,Usersnap,Harris Jose,Tools & Subscription - G&A,99,55096855.3
09/09/2023,Expense,Taplio,Harvey Spector,Credit Card - Ramp,39,55096894.3
09/09/2023,Expense,Usersnap,Harris Jose,Credit Card - Ramp,99,55096993.3
09/09/2023,Expense,Uber,Mike ross,Travelling Expenses,41.21,55097034.51
09/10/2023,Expense,Pause Cafe,Harvey Spector,Credit Card - Ramp,14,55097048.51
09/10/2023,Expense,Zoom,Max Kausman,Credit Card - Ramp,15.99,55097064.5
09/10/2023,Expense,Zoom,Max Kausman,Tools & Subscription - G&A,15.99,55097080.49
09/10/2023,Expense,Pause Cafe,Harvey Spector,Meals & Entertainment,14,55097094.49
09/10/2023,Expense,Zoom,Max Kausman,Tools & Subscription - G&A,15.99,55097110.48
09/10/2023,Expense,Pause Cafe,Harvey Spector,Meals & Entertainment,14,55097124.48
09/10/2023,Expense,Pause Cafe,Harvey Spector,Meals & Entertainment,14,55097138.48
09/10/2023,Expense,Zoom,Max Kausman,Credit Card - Ramp,15.99,55097154.47
09/10/2023,Expense,Zoom,Max Kausman,Tools & Subscription - G&A,15.99,55097170.46
09/10/2023,Expense,Zoom,Max Kausman,Tools & Subscription - G&A,15.99,55097186.45
09/10/2023,Expense,Pause Cafe,Harvey Spector,Credit Card - Ramp,14,55097200.45
09/10/2023,Expense,Pause Cafe,Harvey Spector,Credit Card - Ramp,14,55097214.45
09/10/2023,Expense,Zoom,Max Kausman,Credit Card - Ramp,15.99,55097230.44
09/10/2023,Expense,Pause Cafe,Harvey Spector,Meals & Entertainment,14,55097244.44
09/10/2023,Expense,Pause Cafe,Harvey Spector,Credit Card - Ramp,14,55097258.44
09/11/2023,Expense,Careem,Harvey Spector,Travelling Expenses,36.16,55097294.6
09/11/2023,Expense,Careem,Harvey Spector,Credit Card - Ramp,36.16,55097330.76
09/11/2023,Expense,Four Ate Five,Mike ross,Meals & Entertainment,10.74,55097341.5
09/11/2023,Expense,Four Ate Five,Mike ross,Credit Card - Ramp,10.74,55097352.24
09/11/2023,Expense,Four Ate Five,Mike ross,Credit Card - Ramp,10.74,55097362.98
09/11/2023,Expense,Careem,Harvey Spector,Credit Card - Ramp,36.16,55097399.14
09/11/2023,Expense,Four Ate Five,Mike ross,Meals & Entertainment,10.74,55097409.88
09/11/2023,Expense,Four Ate Five,Mike ross,Meals & Entertainment,10.74,55097420.62
09/11/2023,Expense,Four Ate Five,Mike ross,Credit Card - Ramp,10.74,55097431.36
09/11/2023,Expense,Four Ate Five,Mike ross,Credit Card - Ramp,10.74,55097442.1
09/11/2023,Expense,Careem,Harvey Spector,Credit Card - Ramp,36.16,55097478.26
09/11/2023,Expense,Careem,Harvey Spector,Travelling Expenses,36.16,55097514.42
09/11/2023,Expense,Four Ate Five,Mike ross,Meals & Entertainment,10.74,55097525.16
09/11/2023,Expense,Careem,Harvey Spector,Travelling Expenses,36.16,55097561.32
09/11/2023,Expense,Careem,Harvey Spector,Travelling Expenses,36.16,55097597.48
09/12/2023,Expense,,"BOOK TRANSFER DEBIT 46BOOK DEBIT CHRONICLEHQ INC.*BBK:HK+SHANGHAI BANKING CORPORATION LTD,560 001,NO 7 MAHATMA*BNF:TEJAS GAWANDE*BBI:/DAS/REF:13036OR0 0Y54*EXCH:INR 316348.00 AT 0.0123953*STBOOK*TIME:0602*YOUR REF:RE IMBURSEMENT*OUR REF:255405770*TMS:2023-09-12T10:02:49 GMT*MID:0.0 1205960",Cost of goods sold:Supplies & materials - COGS:Reimbursement-Tejas,-3921.24,55093676.24
09/12/2023,Expense,WordPress,Harris Jose,Credit Card - Ramp,15.68,55093691.92
09/12/2023,Expense,WordPress,Harris Jose,Credit Card - Ramp,15.68,55093707.6
09/12/2023,Expense,,"BOOK TRANSFER DEBIT 46BOOK DEBIT CHRONICLEHQ INC.*BBK:HK+SHANGHAI BANKING CORPORATION LTD,560 001,NO 7 MAHATMA*BNF:TEJAS GAWANDE*BBI:/DAS/REF:13036OR0 0Y54*EXCH:INR 316348.00 AT 0.0123953*STBOOK*TIME:0602*YOUR REF:RE IMBURSEMENT*OUR REF:255405770*TMS:2023-09-12T10:02:49 GMT*MID:0.0 1205960",Cost of goods sold:Supplies & materials - COGS:Reimbursement-Tejas,-3921.24,55089786.36
09/12/2023,Expense,WordPress,Harris Jose,Tools & Subscription - G&A,15.68,55089802.04
09/12/2023,Expense,,Reimbursement,HSBC A/c,3921.24,55093723.28
09/12/2023,Expense,Adobe,Chris George,Tools & Subscription - S&M,20.99,55093744.27
09/12/2023,Expense,,Reimbursement,HSBC A/c,3921.24,55097665.51
09/12/2023,Expense,Adobe,Chris George,Tools & Subscription - S&M,20.99,55097686.5
09/12/2023,Expense,Adobe,Chris George,Credit Card - Ramp,20.99,55097707.49
09/12/2023,Expense,WordPress,Harris Jose,Credit Card - Ramp,15.68,55097723.17
09/12/2023,Expense,,Reimbursement,HSBC A/c,3921.24,55101644.41
09/12/2023,Expense,Adobe,Chris George,Credit Card - Ramp,20.99,55101665.4
09/12/2023,Expense,WordPress,Harris Jose,Tools & Subscription - G&A,15.68,55101681.08
09/12/2023,Expense,,"BOOK TRANSFER DEBIT 46BOOK DEBIT CHRONICLEHQ INC.*BBK:HK+SHANGHAI BANKING CORPORATION LTD,560 001,NO 7 MAHATMA*BNF:TEJAS GAWANDE*BBI:/DAS/REF:13036OR0 0Y54*EXCH:INR 316348.00 AT 0.0123953*STBOOK*TIME:0602*YOUR REF:RE IMBURSEMENT*OUR REF:255405770*TMS:2023-09-12T10:02:49 GMT*MID:0.0 1205960",Cost of goods sold:Supplies & materials - COGS:Reimbursement-Tejas,-3921.24,55097759.84
09/12/2023,Expense,WordPress,Harris Jose,Tools & Subscription - G&A,15.68,55097775.52
09/12/2023,Expense,,Reimbursement,HSBC A/c,3921.24,55101696.76
09/12/2023,Expense,Adobe,Chris George,Credit Card - Ramp,20.99,55101717.75
09/12/2023,Expense,Adobe,Chris George,Tools & Subscription - S&M,20.99,55101738.74
09/12/2023,Expense,WordPress,Harris Jose,Tools & Subscription - G&A,15.68,55101754.42
09/12/2023,Expense,,"BOOK TRANSFER DEBIT 46BOOK DEBIT CHRONICLEHQ INC.*BBK:HK+SHANGHAI BANKING CORPORATION LTD,560 001,NO 7 MAHATMA*BNF:TEJAS GAWANDE*BBI:/DAS/REF:13036OR0 0Y54*EXCH:INR 316348.00 AT 0.0123953*STBOOK*TIME:0602*YOUR REF:RE IMBURSEMENT*OUR REF:255405770*TMS:2023-09-12T10:02:49 GMT*MID:0.0 1205960",Cost of goods sold:Supplies & materials - COGS:Reimbursement-Tejas,-3921.24,55097833.18
09/12/2023,Expense,Adobe,Chris George,Tools & Subscription - S&M,20.99,55097854.17
09/13/2023,Expense,Interact32,Harvey Spector,Credit Card - Ramp,10.12,55097864.29
09/13/2023,Expense,Figma,Mike ross,Credit Card - Ramp,105,55097969.29
09/13/2023,Expense,Lenny Rachitsky,Max Kausman,Credit Card - Ramp,15,55097984.29
09/13/2023,Expense,Lenny Rachitsky,Max Kausman,Credit Card - Ramp,15,55097999.29
09/13/2023,Expense,Vercel,Harris Jose,Credit Card - Ramp,240,55098239.29
09/13/2023,Expense,Figma,Mike ross,Tools & Subscription - G&A,105,55098344.29
09/13/2023,Expense,Interact32,Harvey Spector,Tools & Subscription - G&A,10.12,55098354.41
09/13/2023,Expense,Lenny Rachitsky,Max Kausman,General business expenses:Memberships & subscriptions,15,55098369.41
09/13/2023,Expense,Figma,Mike ross,Tools & Subscription - G&A,105,55098474.41
09/13/2023,Expense,Vercel,Harris Jose,Tools & Subscription - G&A,240,55098714.41
09/13/2023,Expense,Lenny Rachitsky,Max Kausman,General business expenses:Memberships & subscriptions,15,55098729.41
09/13/2023,Expense,Figma,Mike ross,Tools & Subscription - G&A,105,55098834.41
09/13/2023,Expense,Figma,Mike ross,Tools & Subscription - G&A,105,55098939.41
09/13/2023,Expense,Vercel,Harris Jose,Tools & Subscription - G&A,240,55099179.41
09/13/2023,Expense,Lenny Rachitsky,Max Kausman,Credit Card - Ramp,15,55099194.41
09/13/2023,Expense,Interact32,Harvey Spector,Credit Card - Ramp,10.12,55099204.53
09/13/2023,Expense,Vercel,Harris Jose,Tools & Subscription - G&A,240,55099444.53
09/13/2023,Expense,Figma,Mike ross,Credit Card - Ramp,105,55099549.53
09/13/2023,Expense,Interact32,Harvey Spector,Credit Card - Ramp,10.12,55099559.65
09/13/2023,Expense,Lenny Rachitsky,Max Kausman,General business expenses:Memberships & subscriptions,15,55099574.65
09/13/2023,Expense,Interact32,Harvey Spector,Tools & Subscription - G&A,10.12,55099584.77
09/13/2023,Expense,Vercel,Harris Jose,Tools & Subscription - G&A,240,55099824.77
09/13/2023,Expense,Vercel,Harris Jose,Credit Card - Ramp,240,55100064.77
09/13/2023,Expense,Lenny Rachitsky,Max Kausman,General business expenses:Memberships & subscriptions,15,55100079.77
09/13/2023,Expense,Interact32,Harvey Spector,Tools & Subscription - G&A,10.12,55100089.89
09/13/2023,Expense,Lenny Rachitsky,Max Kausman,Credit Card - Ramp,15,55100104.89
09/13/2023,Expense,Vercel,Harris Jose,Credit Card - Ramp,240,55100344.89
09/13/2023,Expense,Figma,Mike ross,Credit Card - Ramp,105,55100449.89
09/13/2023,Expense,Interact32,Harvey Spector,Tools & Subscription - G&A,10.12,55100460.01
09/14/2023,Expense,Intuit,Harvey Spector,Credit Card - Ramp,60,55100520.01
09/14/2023,Expense,Uber,Mike ross,Travelling Expenses,38.16,55100558.17
09/14/2023,Expense,Uber,Mike ross,Travelling Expenses,38.16,55100596.33
09/14/2023,Expense,Intuit,Harvey Spector,Tools & Subscription - G&A,60,55100656.33
09/14/2023,Expense,Uber,Mike ross,Credit Card - Ramp,38.16,55100694.49
09/14/2023,Expense,Uber,Mike ross,Travelling Expenses,38.16,55100732.65
09/14/2023,Expense,Intuit,Harvey Spector,Tools & Subscription - G&A,60,55100792.65
09/14/2023,Expense,Uber,Mike ross,Travelling Expenses,38.16,55100830.81
09/14/2023,Expense,Intuit,Harvey Spector,Credit Card - Ramp,60,55100890.81
09/14/2023,Expense,Intuit,Harvey Spector,Tools & Subscription - G&A,60,55100950.81
09/14/2023,Expense,Uber,Mike ross,Credit Card - Ramp,38.16,55100988.97
09/14/2023,Expense,Uber,Mike ross,Credit Card - Ramp,38.16,55101027.13
09/14/2023,Expense,Intuit,Harvey Spector,Credit Card - Ramp,60,55101087.13
09/14/2023,Expense,Intuit,Harvey Spector,Tools & Subscription - G&A,60,55101147.13
09/16/2023,Expense,Uber,Mike ross,Credit Card - Ramp,33.01,55101180.14
09/16/2023,Expense,Uber,Mike ross,Travelling Expenses,36.04,55101216.18
09/16/2023,Expense,Zapier,Harvey Spector,Tools & Subscription - G&A,29.99,55101246.17
09/16/2023,Expense,Zapier,Harvey Spector,Credit Card - Ramp,29.99,55101276.16
09/16/2023,Expense,Uber,Mike ross,Travelling Expenses,33.01,55101309.17
09/16/2023,Expense,Zapier,Harvey Spector,Credit Card - Ramp,29.99,55101339.16
09/16/2023,Expense,Zapier,Harvey Spector,Tools & Subscription - G&A,29.99,55101369.15
09/16/2023,Expense,Zapier,Harvey Spector,Tools & Subscription - G&A,29.99,55101399.14
09/16/2023,Expense,Zapier,Harvey Spector,Credit Card - Ramp,29.99,55101429.13
09/16/2023,Expense,Uber,Mike ross,Credit Card - Ramp,36.04,55101465.17
09/16/2023,Expense,Uber,Mike ross,Travelling Expenses,36.04,55101501.21
09/16/2023,Expense,Uber,Mike ross,Credit Card - Ramp,36.04,55101537.25
09/16/2023,Expense,Uber,Mike ross,Travelling Expenses,33.01,55101570.26
09/16/2023,Expense,Uber,Mike ross,Travelling Expenses,36.04,55101606.3
09/16/2023,Expense,Uber,Mike ross,Travelling Expenses,33.01,55101639.31
09/16/2023,Expense,Uber,Mike ross,Credit Card - Ramp,33.01,55101672.32
09/16/2023,Expense,Zapier,Harvey Spector,Tools & Subscription - G&A,29.99,55101702.31
09/16/2023,Expense,Uber,Mike ross,Travelling Expenses,36.04,55101738.35
09/16/2023,Expense,Uber,Mike ross,Travelling Expenses,33.01,55101771.36
09/16/2023,Expense,Uber,Mike ross,Credit Card - Ramp,36.04,55101807.4
09/16/2023,Expense,Uber,Mike ross,Credit Card - Ramp,33.01,55101840.41
09/17/2023,Expense,Uber,Mike ross,Credit Card - Ramp,20.91,55101861.32
09/17/2023,Expense,TOD,Harvey Spector,Credit Card - Ramp,18.9,55101880.22
09/17/2023,Expense,Uber,Mike ross,Travelling Expenses,20.91,55101901.13
09/17/2023,Expense,TOD,Harvey Spector,Office expenses:Office supplies,18.9,55101920.03
09/17/2023,Expense,TOD,Harvey Spector,Office expenses:Office supplies,18.9,55101938.93
09/17/2023,Expense,Uber,Mike ross,Credit Card - Ramp,15.42,55101954.35
09/17/2023,Expense,Uber,Mike ross,Credit Card - Ramp,20.91,55101975.26
09/17/2023,Expense,Uber,Mike ross,Credit Card - Ramp,15.42,55101990.68
09/17/2023,Expense,TOD,Harvey Spector,Credit Card - Ramp,18.9,55102009.58
09/17/2023,Expense,Uber,Mike ross,Travelling Expenses,15.42,55102025
09/17/2023,Expense,Uber,Mike ross,Travelling Expenses,15.42,55102040.42
09/17/2023,Expense,TOD,Harvey Spector,Office expenses:Office supplies,18.9,55102059.32
09/17/2023,Expense,Uber,Mike ross,Travelling Expenses,20.91,55102080.23
09/17/2023,Expense,Uber,Mike ross,Travelling Expenses,20.91,55102101.14
09/17/2023,Expense,TOD,Harvey Spector,Credit Card - Ramp,18.9,55102120.04
09/17/2023,Expense,Uber,Mike ross,Travelling Expenses,15.42,55102135.46
09/17/2023,Expense,TOD,Harvey Spector,Office expenses:Office supplies,18.9,55102154.36
09/17/2023,Expense,Uber,Mike ross,Credit Card - Ramp,20.91,55102175.27
09/17/2023,Expense,Uber,Mike ross,Travelling Expenses,20.91,55102196.18
09/17/2023,Expense,Uber,Mike ross,Travelling Expenses,15.42,55102211.6
09/17/2023,Expense,TOD,Harvey Spector,Credit Card - Ramp,18.9,55102230.5
09/17/2023,Expense,Uber,Mike ross,Credit Card - Ramp,15.42,55102245.92
09/18/2023,Expense,Reclaim.ai,Max Kausman,Credit Card - Ramp,8,55102253.92
09/18/2023,Bill,ANSR Dubai,,Professional Service Charges,10874,55113127.92
09/18/2023,Expense,Segment,Balapavan Tirumani,Credit Card - Ramp,120,55113247.92
09/18/2023,Bill,ANSR Dubai,Service Fees for September 2023,Accounts Payable (A/P),10874,55124121.92
09/18/2023,Expense,,MONTHLY CHARGE Bank Charges for the per 01AUG2023 TO 31AUG2023 Invoice No 1687995,General business expenses:Bank fees & service charges,-28.8,55124093.12
09/18/2023,Expense,Reclaim.ai,Max Kausman,Credit Card - Ramp,8,55124101.12
09/18/2023,Expense,Segment,Balapavan Tirumani,Credit Card - Ramp,120,55124221.12
09/18/2023,Expense,Segment,Balapavan Tirumani,Credit Card - Ramp,120,55124341.12
09/18/2023,Expense,Reclaim.ai,Max Kausman,Credit Card - Ramp,8,55124349.12
09/18/2023,Expense,Linkedin Recruiter,Mike ross,Credit Card - Ramp,150.1,55124499.22
09/18/2023,Expense,Linkedin Recruiter,Mike ross,General business expenses:Memberships & subscriptions,150.1,55124649.32
09/18/2023,Expense,,Fees,HSBC A/c,28.8,55124678.12
09/18/2023,Bill,ANSR Dubai,Service Fees for September 2023,Accounts Payable (A/P),10874,55135552.12
09/18/2023,Expense,,Fees,HSBC A/c,28.8,55135580.92
09/18/2023,Expense,,MONTHLY CHARGE Bank Charges for the per 01AUG2023 TO 31AUG2023 Invoice No 1687995,General business expenses:Bank fees & service charges,-28.8,55135552.12
09/18/2023,Expense,Linkedin Recruiter,Mike ross,Credit Card - Ramp,150.1,55135702.22
09/18/2023,Expense,Reclaim.ai,Max Kausman,Tools & Subscription - G&A,8,55135710.22
09/18/2023,Bill,ANSR Dubai,,Professional Service Charges,10874,55146584.22
09/18/2023,Expense,Reclaim.ai,Max Kausman,Tools & Subscription - G&A,8,55146592.22
09/18/2023,Expense,Reclaim.ai,Max Kausman,Tools & Subscription - G&A,8,55146600.22
09/18/2023,Expense,,MONTHLY CHARGE Bank Charges for the per 01AUG2023 TO 31AUG2023 Invoice No 1687995,General business expenses:Bank fees & service charges,-28.8,55146571.42
09/18/2023,Expense,Segment,Balapavan Tirumani,Tools & Subscription - G&A,120,55146691.42
09/18/2023,Expense,Segment,Balapavan Tirumani,Tools & Subscription - G&A,120,55146811.42
09/18/2023,Expense,Linkedin Recruiter,Mike ross,Credit Card - Ramp,150.1,55146961.52
09/18/2023,Expense,Segment,Balapavan Tirumani,Tools & Subscription - G&A,120,55147081.52
09/18/2023,Expense,,Fees,HSBC A/c,28.8,55147110.32
09/18/2023,Expense,Linkedin Recruiter,Mike ross,General business expenses:Memberships & subscriptions,150.1,55147260.42
09/18/2023,Expense,,Fees,HSBC A/c,28.8,55147289.22
09/18/2023,Bill,ANSR Dubai,Service Fees for September 2023,Accounts Payable (A/P),10874,55158163.22
09/18/2023,Expense,,MONTHLY CHARGE Bank Charges for the per 01AUG2023 TO 31AUG2023 Invoice No 1687995,General business expenses:Bank fees & service charges,-28.8,55158134.42
09/18/2023,Expense,Reclaim.ai,Max Kausman,Tools & Subscription - G&A,8,55158142.42
09/18/2023,Expense,Linkedin Recruiter,Mike ross,Credit Card - Ramp,150.1,55158292.52
09/18/2023,Expense,Segment,Balapavan Tirumani,Tools & Subscription - G&A,120,55158412.52
09/18/2023,Bill,ANSR Dubai,Service Fees for September 2023,Accounts Payable (A/P),10874,55169286.52
09/18/2023,Expense,Linkedin Recruiter,Mike ross,General business expenses:Memberships & subscriptions,150.1,55169436.62
09/18/2023,Bill,ANSR Dubai,,Professional Service Charges,10874,55180310.62
09/18/2023,Bill,ANSR Dubai,,Professional Service Charges,10874,55191184.62
09/18/2023,Expense,Linkedin Recruiter,Mike ross,General business expenses:Memberships & subscriptions,150.1,55191334.72
09/19/2023,Expense,Zoom,Mike ross,Tools & Subscription - G&A,140.03,55191474.75
09/19/2023,Expense,Twitter,Harvey Spector,Tools & Subscription - G&A,8.05,55191482.8
09/19/2023,Expense,BuildBetter,Max Kausman,Tools & Subscription - G&A,100,55191582.8
09/19/2023,Bill Payment (Check),ANSR Dubai,BOOK TRANSFER DEBIT 45BOOK DEBIT CHRONICLEHQ INC.*BNF:ANSR (EMEA) GLOBAL SERVICES LIM ITED*BBI:/DAS/REF:28886P301EVB*STBOOK*TIME:0804*YOUR REF:ANSRMEA0 22*OUR REF:262485058,Accounts Payable (A/P),-10874,55180708.8
09/19/2023,Bill Payment (Check),Big Company ,,Accounts Payable (A/P),-130000,55050708.8
09/19/2023,Expense,Zoom,Mike ross,Tools & Subscription - G&A,140.03,55050848.83
09/19/2023,Bill Payment (Check),ANSR Dubai,,HSBC A/c,-10874,55039974.83
09/19/2023,Bill Payment (Check),Big Company ,,HSBC A/c,-130000,54909974.83
09/19/2023,Bill Payment (Check),ANSR Dubai,BOOK TRANSFER DEBIT 45BOOK DEBIT CHRONICLEHQ INC.*BNF:ANSR (EMEA) GLOBAL SERVICES LIM ITED*BBI:/DAS/REF:28886P301EVB*STBOOK*TIME:0804*YOUR REF:ANSRMEA0 22*OUR REF:262485058,Accounts Payable (A/P),-10874,54899100.83
09/19/2023,Expense,Twitter,Harvey Spector,Credit Card - Ramp,8.05,54899108.88
09/19/2023,Bill Payment (Check),Big Company ,,Accounts Payable (A/P),-130000,54769108.88
09/19/2023,Expense,BuildBetter,Max Kausman,Credit Card - Ramp,100,54769208.88
09/19/2023,Bill Payment (Check),Big Company ,,HSBC A/c,-130000,54639208.88
09/19/2023,Expense,Zoom,Mike ross,Credit Card - Ramp,140.03,54639348.91
09/19/2023,Expense,BuildBetter,Max Kausman,Tools & Subscription - G&A,100,54639448.91
09/19/2023,Bill Payment (Check),ANSR Dubai,,HSBC A/c,-10874,54628574.91
09/19/2023,Bill Payment (Check),Big Company ,,Accounts Payable (A/P),-130000,54498574.91
09/19/2023,Expense,Twitter,Harvey Spector,Credit Card - Ramp,8.05,54498582.96
09/19/2023,Bill Payment (Check),Big Company ,,HSBC A/c,-130000,54368582.96
09/19/2023,Expense,Zoom,Mike ross,Credit Card - Ramp,140.03,54368722.99
09/19/2023,Expense,BuildBetter,Max Kausman,Credit Card - Ramp,100,54368822.99
09/19/2023,Expense,Zoom,Mike ross,Credit Card - Ramp,140.03,54368963.02
09/19/2023,Expense,Zoom,Mike ross,Tools & Subscription - G&A,140.03,54369103.05
09/19/2023,Bill Payment (Check),ANSR Dubai,,HSBC A/c,-10874,54358229.05
09/19/2023,Bill Payment (Check),Big Company ,,HSBC A/c,-130000,54228229.05
09/19/2023,Expense,Twitter,Harvey Spector,Tools & Subscription - G&A,8.05,54228237.1
09/19/2023,Expense,Twitter,Harvey Spector,Tools & Subscription - G&A,8.05,54228245.15
09/19/2023,Expense,Zoom,Mike ross,Tools & Subscription - G&A,140.03,54228385.18
09/19/2023,Expense,Twitter,Harvey Spector,Credit Card - Ramp,8.05,54228393.23
09/19/2023,Expense,BuildBetter,Max Kausman,Tools & Subscription - G&A,100,54228493.23
09/19/2023,Expense,BuildBetter,Max Kausman,Tools & Subscription - G&A,100,54228593.23
09/19/2023,Bill Payment (Check),ANSR Dubai,,HSBC A/c,-10874,54217719.23
09/19/2023,Bill Payment (Check),Big Company ,,Accounts Payable (A/P),-130000,54087719.23
09/19/2023,Bill Payment (Check),ANSR Dubai,BOOK TRANSFER DEBIT 45BOOK DEBIT CHRONICLEHQ INC.*BNF:ANSR (EMEA) GLOBAL SERVICES LIM ITED*BBI:/DAS/REF:28886P301EVB*STBOOK*TIME:0804*YOUR REF:ANSRMEA0 22*OUR REF:262485058,Accounts Payable (A/P),-10874,54076845.23
09/19/2023,Expense,Twitter,Harvey Spector,Tools & Subscription - G&A,8.05,54076853.28
09/19/2023,Bill Payment (Check),ANSR Dubai,BOOK TRANSFER DEBIT 45BOOK DEBIT CHRONICLEHQ INC.*BNF:ANSR (EMEA) GLOBAL SERVICES LIM ITED*BBI:/DAS/REF:28886P301EVB*STBOOK*TIME:0804*YOUR REF:ANSRMEA0 22*OUR REF:262485058,Accounts Payable (A/P),-10874,54065979.28
09/19/2023,Expense,BuildBetter,Max Kausman,Credit Card - Ramp,100,54066079.28
09/20/2023,Expense,Icare,Mike ross,Credit Card - Ramp,2.41,54066081.69
09/20/2023,Expense,carta,Mike ross,Credit Card - Ramp,2996,54069077.69
09/20/2023,Expense,Icare,Mike ross,Credit Card - Ramp,382.24,54069459.93
09/20/2023,Expense,OpenAI,Mike ross,Credit Card - Ramp,22,54069481.93
09/20/2023,Expense,carta,Mike ross,Tools & Subscription - G&A,2996,54072477.93
09/20/2023,Expense,Icare,Mike ross,Credit Card - Ramp,382.24,54072860.17
09/20/2023,Expense,RAMP BUSINESS CO,RAMP STATEMENT,Credit Card - Ramp,-4161.2,54068698.97
09/20/2023,Expense,carta,Mike ross,Tools & Subscription - G&A,2996,54071694.97
09/20/2023,Expense,Gumrd,Harvey Spector,Credit Card - Ramp,5.99,54071700.96
09/20/2023,Expense,RAMP BUSINESS CO,RAMP STATEMENT,Account1,-4161.2,54067539.76
09/20/2023,Expense,carta,Mike ross,Credit Card - Ramp,2996,54070535.76
09/20/2023,Expense,Icare,Mike ross,Insurance,2.41,54070538.17
09/20/2023,Expense,Icare,Mike ross,Insurance,382.24,54070920.41
09/20/2023,Expense,Gumrd,Harvey Spector,General business expenses:Memberships & subscriptions,5.99,54070926.4
09/20/2023,Expense,carta,Mike ross,Credit Card - Ramp,2996,54073922.4
09/20/2023,Expense,Icare,Mike ross,Insurance,2.41,54073924.81
09/20/2023,Expense,Icare,Mike ross,Insurance,382.24,54074307.05
09/20/2023,Expense,Gumrd,Harvey Spector,General business expenses:Memberships & subscriptions,5.99,54074313.04
09/20/2023,Expense,OpenAI,Mike ross,Credit Card - Ramp,22,54074335.04
09/20/2023,Expense,OpenAI,Mike ross,Credit Card - Ramp,22,54074357.04
09/20/2023,Expense,Icare,Mike ross,Credit Card - Ramp,2.41,54074359.45
09/20/2023,Expense,OpenAI,Mike ross,Tools & Subscription - G&A,22,54074381.45
09/20/2023,Expense,RAMP BUSINESS CO,RAMP STATEMENT,Credit Card - Ramp,-4161.2,54070220.25
09/20/2023,Expense,Icare,Mike ross,Insurance,382.24,54070602.49
09/20/2023,Expense,Icare,Mike ross,Credit Card - Ramp,382.24,54070984.73
09/20/2023,Expense,RAMP BUSINESS CO,RAMP STATEMENT,Credit Card - Ramp,-4161.2,54066823.53
09/20/2023,Expense,carta,Mike ross,Tools & Subscription - G&A,2996,54069819.53
09/20/2023,Expense,Gumrd,Harvey Spector,Credit Card - Ramp,5.99,54069825.52
09/20/2023,Expense,Icare,Mike ross,Credit Card - Ramp,382.24,54070207.76
09/20/2023,Expense,Gumrd,Harvey Spector,General business expenses:Memberships & subscriptions,5.99,54070213.75
09/20/2023,Expense,Icare,Mike ross,Insurance,382.24,54070595.99
09/20/2023,Expense,Icare,Mike ross,Insurance,2.41,54070598.4
09/20/2023,Expense,OpenAI,Mike ross,Tools & Subscription - G&A,22,54070620.4
09/20/2023,Expense,Icare,Mike ross,Credit Card - Ramp,2.41,54070622.81
09/20/2023,Expense,RAMP BUSINESS CO,RAMP STATEMENT,Account1,-4161.2,54066461.61
09/20/2023,Expense,Gumrd,Harvey Spector,General business expenses:Memberships & subscriptions,5.99,54066467.6
09/20/2023,Expense,RAMP BUSINESS CO,RAMP STATEMENT,Account1,-4161.2,54062306.4
09/20/2023,Expense,Gumrd,Harvey Spector,Credit Card - Ramp,5.99,54062312.39
09/20/2023,Expense,Gumrd,Harvey Spector,Credit Card - Ramp,5.99,54062318.38
09/20/2023,Expense,Icare,Mike ross,Insurance,2.41,54062320.79
09/20/2023,Expense,OpenAI,Mike ross,Tools & Subscription - G&A,22,54062342.79
09/20/2023,Expense,RAMP BUSINESS CO,RAMP STATEMENT,Credit Card - Ramp,-4161.2,54058181.59
09/20/2023,Expense,RAMP BUSINESS CO,RAMP STATEMENT,Account1,-4161.2,54054020.39
09/20/2023,Expense,carta,Mike ross,Tools & Subscription - G&A,2996,54057016.39
09/20/2023,Expense,OpenAI,Mike ross,Tools & Subscription - G&A,22,54057038.39
09/20/2023,Expense,Icare,Mike ross,Credit Card - Ramp,2.41,54057040.8
09/21/2023,Expense,Careem,Harvey Spector,Travelling Expenses,5.47,54057046.27
09/21/2023,Expense,Careem,Harvey Spector,Travelling Expenses,5.47,54057051.74
09/21/2023,Expense,Careem,Harvey Spector,Credit Card - Ramp,5.47,54057057.21
09/21/2023,Expense,Careem,Harvey Spector,Travelling Expenses,5.47,54057062.68
09/21/2023,Expense,Careem,Harvey Spector,Credit Card - Ramp,5.47,54057068.15
09/21/2023,Expense,Careem,Harvey Spector,Credit Card - Ramp,5.47,54057073.62
09/21/2023,Expense,Careem,Harvey Spector,Travelling Expenses,5.47,54057079.09
09/22/2023,Expense,Fabric internet OS,Harvey Spector,Tools & Subscription - G&A,190,54057269.09
09/22/2023,Expense,Fabric internet OS,Harvey Spector,Credit Card - Ramp,190,54057459.09
09/22/2023,Expense,Fabric internet OS,Harvey Spector,Tools & Subscription - G&A,190,54057649.09
09/22/2023,Expense,Dovetail,Harvey Spector,Tools & Subscription - G&A,28.1,54057677.19
09/22/2023,Expense,Fabric internet OS,Harvey Spector,Credit Card - Ramp,190,54057867.19
09/22/2023,Expense,Fabric internet OS,Harvey Spector,Tools & Subscription - G&A,190,54058057.19
09/22/2023,Expense,Dovetail,Harvey Spector,Tools & Subscription - G&A,28.1,54058085.29
09/22/2023,Expense,Dovetail,Harvey Spector,Credit Card - Ramp,28.1,54058113.39
09/22/2023,Expense,Dovetail,Harvey Spector,Credit Card - Ramp,28.1,54058141.49
09/22/2023,Expense,Dovetail,Harvey Spector,Tools & Subscription - G&A,28.1,54058169.59
09/22/2023,Expense,Fabric internet OS,Harvey Spector,Tools & Subscription - G&A,190,54058359.59
09/22/2023,Expense,Dovetail,Harvey Spector,Tools & Subscription - G&A,28.1,54058387.69
09/22/2023,Expense,Fabric internet OS,Harvey Spector,Credit Card - Ramp,190,54058577.69
09/22/2023,Expense,Dovetail,Harvey Spector,Credit Card - Ramp,28.1,54058605.79
09/23/2023,Expense,Google Storage,Harvey Spector,Credit Card - Ramp,26.14,54058631.93
09/23/2023,Expense,Super,Harvey Spector,Credit Card - Ramp,12,54058643.93
09/23/2023,Expense,Google Storage,Harvey Spector,Credit Card - Ramp,26.14,54058670.07
09/23/2023,Expense,Super,Harvey Spector,Tools & Subscription - G&A,12,54058682.07
09/23/2023,Expense,Superhuman,Mike ross,Credit Card - Ramp,90,54058772.07
09/23/2023,Expense,Google Storage,Harvey Spector,Tools & Subscription - G&A,26.14,54058798.21
09/23/2023,Expense,Careem,Harvey Spector,Travelling Expenses,11.36,54058809.57
09/23/2023,Expense,Superhuman,Mike ross,Professional Service Charges,90,54058899.57
09/23/2023,Expense,Superhuman,Mike ross,Credit Card - Ramp,90,54058989.57
09/23/2023,Expense,Heptabase,Mike ross,Credit Card - Ramp,9.99,54058999.56
09/23/2023,Expense,Careem,Harvey Spector,Credit Card - Ramp,11.36,54059010.92
09/23/2023,Expense,Superhuman,Mike ross,Credit Card - Ramp,90,54059100.92
09/23/2023,Expense,Heptabase,Mike ross,Tools & Subscription - G&A,9.99,54059110.91
09/23/2023,Expense,Super,Harvey Spector,Tools & Subscription - G&A,12,54059122.91
09/23/2023,Expense,Google Storage,Harvey Spector,Tools & Subscription - G&A,26.14,54059149.05
09/23/2023,Expense,Heptabase,Mike ross,Credit Card - Ramp,9.99,54059159.04
09/23/2023,Expense,Heptabase,Mike ross,Tools & Subscription - G&A,9.99,54059169.03
09/23/2023,Expense,Careem,Harvey Spector,Travelling Expenses,11.36,54059180.39
09/23/2023,Expense,Superhuman,Mike ross,Professional Service Charges,90,54059270.39
09/23/2023,Expense,Heptabase,Mike ross,Tools & Subscription - G&A,9.99,54059280.38
09/23/2023,Expense,Google Storage,Harvey Spector,Tools & Subscription - G&A,26.14,54059306.52
09/23/2023,Expense,Super,Harvey Spector,Tools & Subscription - G&A,12,54059318.52
09/23/2023,Expense,Super,Harvey Spector,Tools & Subscription - G&A,12,54059330.52
09/23/2023,Expense,Superhuman,Mike ross,Professional Service Charges,90,54059420.52
09/23/2023,Expense,Careem,Harvey Spector,Credit Card - Ramp,11.36,54059431.88
09/23/2023,Expense,Superhuman,Mike ross,Credit Card - Ramp,90,54059521.88
09/23/2023,Expense,Careem,Harvey Spector,Credit Card - Ramp,11.36,54059533.24
09/23/2023,Expense,Super,Harvey Spector,Credit Card - Ramp,12,54059545.24
09/23/2023,Expense,Superhuman,Mike ross,Professional Service Charges,90,54059635.24
09/23/2023,Expense,Google Storage,Harvey Spector,Tools & Subscription - G&A,26.14,54059661.38
09/23/2023,Expense,Careem,Harvey Spector,Travelling Expenses,11.36,54059672.74
09/23/2023,Expense,Heptabase,Mike ross,Tools & Subscription - G&A,9.99,54059682.73
09/23/2023,Expense,Super,Harvey Spector,Credit Card - Ramp,12,54059694.73
09/23/2023,Expense,Google Storage,Harvey Spector,Credit Card - Ramp,26.14,54059720.87
09/23/2023,Expense,Heptabase,Mike ross,Credit Card - Ramp,9.99,54059730.86
09/23/2023,Expense,Careem,Harvey Spector,Travelling Expenses,11.36,54059742.22
09/24/2023,Expense,Benedict Evans,Harvey Spector,Professional Service Charges,10,54059752.22
09/24/2023,Expense,Benedict Evans,Harvey Spector,Credit Card - Ramp,10,54059762.22
09/24/2023,Expense,Vratislav Pecka,Harvey Spector,Tools & Subscription - G&A,10.89,54059773.11
09/24/2023,Expense,Benedict Evans,Harvey Spector,Credit Card - Ramp,10,54059783.11
09/24/2023,Expense,Vratislav Pecka,Harvey Spector,Credit Card - Ramp,10.89,54059794
09/24/2023,Expense,Vratislav Pecka,Harvey Spector,Credit Card - Ramp,10.89,54059804.89
09/24/2023,Expense,Vratislav Pecka,Harvey Spector,Tools & Subscription - G&A,10.89,54059815.78
09/24/2023,Expense,Benedict Evans,Harvey Spector,Professional Service Charges,10,54059825.78
09/24/2023,Expense,Benedict Evans,Harvey Spector,Credit Card - Ramp,10,54059835.78
09/24/2023,Expense,Benedict Evans,Harvey Spector,Professional Service Charges,10,54059845.78
09/24/2023,Expense,Benedict Evans,Harvey Spector,Professional Service Charges,10,54059855.78
09/24/2023,Expense,Vratislav Pecka,Harvey Spector,Tools & Subscription - G&A,10.89,54059866.67
09/24/2023,Expense,Benedict Evans,Harvey Spector,Credit Card - Ramp,10,54059876.67
09/24/2023,Expense,Vratislav Pecka,Harvey Spector,Tools & Subscription - G&A,10.89,54059887.56
09/24/2023,Expense,Vratislav Pecka,Harvey Spector,Credit Card - Ramp,10.89,54059898.45
09/25/2023,Expense,Careem,Harvey Spector,Travelling Expenses,5.33,54059903.78
09/25/2023,Expense,Careem,Harvey Spector,Credit Card - Ramp,5.33,54059909.11
09/25/2023,Expense,Miro,Mike ross,Credit Card - Ramp,115.33,54060024.44
09/25/2023,Bill,EntityA,September 2023 Quarter expenses incurred plus 10% mark up per the MSA,Account2,208208.26,54268232.7
09/25/2023,Bill,EntityA,September 2023 Quarter expenses incurred plus 10% mark up per the MSA,Account2,208208.26,54476440.96
09/25/2023,Expense,Miro,Mike ross,Tools & Subscription - G&A,115.33,54476556.29
09/25/2023,Bill,EntityA,,outsources Services - Australia,208208.26,54684764.55
09/25/2023,Bill,EntityA,,outsources Services - Australia,208208.26,54892972.81
09/25/2023,Bill,EntityA,,outsources Services - Australia,208208.26,55101181.07
09/25/2023,Expense,Miro,Mike ross,Credit Card - Ramp,115.33,55101296.4
09/25/2023,Expense,Careem,Harvey Spector,Travelling Expenses,5.33,55101301.73
09/25/2023,Expense,Careem,Harvey Spector,Travelling Expenses,5.33,55101307.06
09/25/2023,Bill,EntityA,September 2023 Quarter expenses incurred plus 10% mark up per the MSA,Account2,208208.26,55309515.32
09/25/2023,Expense,Miro,Mike ross,Tools & Subscription - G&A,115.33,55309630.65
09/25/2023,Expense,Careem,Harvey Spector,Travelling Expenses,5.33,55309635.98
09/25/2023,Bill,EntityA,,outsources Services - Australia,208208.26,55517844.24
09/25/2023,Expense,Miro,Mike ross,Credit Card - Ramp,115.33,55517959.57
09/25/2023,Expense,Miro,Mike ross,Tools & Subscription - G&A,115.33,55518074.9
09/25/2023,Bill,EntityA,September 2023 Quarter expenses incurred plus 10% mark up per the MSA,Account2,208208.26,55726283.16
09/25/2023,Expense,Careem,Harvey Spector,Credit Card - Ramp,5.33,55726288.49
09/25/2023,Expense,Careem,Harvey Spector,Credit Card - Ramp,5.33,55726293.82
09/25/2023,Expense,Miro,Mike ross,Tools & Subscription - G&A,115.33,55726409.15
09/27/2023,Expense,Splitbee,Harris Jose,Credit Card - Ramp,16.52,55726425.67
09/27/2023,Expense,Sendinblue,Balapavan Tirumani,Tools & Subscription - G&A,78.33,55726504
09/27/2023,Expense,Sentry,Balapavan Tirumani,Credit Card - Ramp,29,55726533
09/27/2023,Expense,Uber,Mike ross,Travelling Expenses,8.91,55726541.91
09/27/2023,Expense,Sendinblue,Balapavan Tirumani,Credit Card - Ramp,78.33,55726620.24
09/27/2023,Expense,Namecheap,Harris Jose,Credit Card - Ramp,16.06,55726636.3
09/27/2023,Expense,Splitbee,Harris Jose,Credit Card - Ramp,16.52,55726652.82
09/27/2023,Expense,Splitbee,Harris Jose,Tools & Subscription - G&A,16.52,55726669.34
09/27/2023,Expense,Namecheap,Harris Jose,Tools & Subscription - G&A,16.06,55726685.4
09/27/2023,Expense,Namecheap,Harris Jose,Tools & Subscription - G&A,16.06,55726701.46
09/27/2023,Credit Card Credit,Taplio,Harvey Spector,Credit Card - Ramp,-39,55726662.46
09/27/2023,Expense,Uber,Mike ross,Travelling Expenses,8.91,55726671.37
09/27/2023,Credit Card Credit,Taplio,Harvey Spector,Tools & Subscription - G&A,-39,55726632.37
09/27/2023,Expense,Splitbee,Harris Jose,Tools & Subscription - G&A,16.52,55726648.89
09/27/2023,Credit Card Credit,Taplio,Harvey Spector,Tools & Subscription - G&A,-39,55726609.89
09/27/2023,Expense,Uber,Mike ross,Credit Card - Ramp,8.91,55726618.8
09/27/2023,Expense,Sentry,Balapavan Tirumani,Tools & Subscription - G&A,29,55726647.8
09/27/2023,Expense,Sendinblue,Balapavan Tirumani,Tools & Subscription - G&A,78.33,55726726.13
09/27/2023,Expense,Uber,Mike ross,Credit Card - Ramp,8.91,55726735.04
09/27/2023,Expense,Uber,Mike ross,Credit Card - Ramp,8.91,55726743.95
09/27/2023,Expense,Uber,Mike ross,Travelling Expenses,8.91,55726752.86
09/27/2023,Expense,Uber,Mike ross,Travelling Expenses,8.91,55726761.77
09/27/2023,Expense,Sendinblue,Balapavan Tirumani,Tools & Subscription - G&A,78.33,55726840.1
09/27/2023,Expense,Namecheap,Harris Jose,Tools & Subscription - G&A,16.06,55726856.16
09/27/2023,Expense,Sentry,Balapavan Tirumani,Tools & Subscription - G&A,29,55726885.16
09/27/2023,Expense,Namecheap,Harris Jose,Credit Card - Ramp,16.06,55726901.22
09/27/2023,Credit Card Credit,Taplio,Harvey Spector,Tools & Subscription - G&A,-39,55726862.22
09/27/2023,Expense,Sentry,Balapavan Tirumani,Credit Card - Ramp,29,55726891.22
09/27/2023,Expense,Sendinblue,Balapavan Tirumani,Credit Card - Ramp,78.33,55726969.55
09/27/2023,Credit Card Credit,Taplio,Harvey Spector,Credit Card - Ramp,-39,55726930.55
09/27/2023,Credit Card Credit,Taplio,Harvey Spector,Tools & Subscription - G&A,-39,55726891.55
09/27/2023,Expense,Splitbee,Harris Jose,Tools & Subscription - G&A,16.52,55726908.07
09/27/2023,Expense,Sentry,Balapavan Tirumani,Tools & Subscription - G&A,29,55726937.07
09/27/2023,Expense,Namecheap,Harris Jose,Tools & Subscription - G&A,16.06,55726953.13
09/27/2023,Expense,Sendinblue,Balapavan Tirumani,Credit Card - Ramp,78.33,55727031.46
09/27/2023,Expense,Namecheap,Harris Jose,Credit Card - Ramp,16.06,55727047.52
09/27/2023,Expense,Splitbee,Harris Jose,Credit Card - Ramp,16.52,55727064.04
09/27/2023,Credit Card Credit,Taplio,Harvey Spector,Credit Card - Ramp,-39,55727025.04
09/27/2023,Expense,Sentry,Balapavan Tirumani,Credit Card - Ramp,29,55727054.04
09/27/2023,Expense,Sentry,Balapavan Tirumani,Tools & Subscription - G&A,29,55727083.04
09/27/2023,Expense,Splitbee,Harris Jose,Tools & Subscription - G&A,16.52,55727099.56
09/27/2023,Expense,Sendinblue,Balapavan Tirumani,Tools & Subscription - G&A,78.33,55727177.89
09/28/2023,Expense,Github,Balapavan Tirumani,Tools & Subscription - G&A,44,55727221.89
09/28/2023,Expense,Github,Balapavan Tirumani,Credit Card - Ramp,10,55727231.89
09/28/2023,Expense,Github,Balapavan Tirumani,Tools & Subscription - G&A,10,55727241.89
09/28/2023,Expense,Github,Balapavan Tirumani,Credit Card - Ramp,44,55727285.89
09/28/2023,Expense,Github,Balapavan Tirumani,Tools & Subscription - G&A,10,55727295.89
09/28/2023,Expense,Github,Balapavan Tirumani,Tools & Subscription - G&A,10,55727305.89
09/28/2023,Expense,Github,Balapavan Tirumani,Credit Card - Ramp,44,55727349.89
09/28/2023,Expense,Github,Balapavan Tirumani,Tools & Subscription - G&A,44,55727393.89
09/28/2023,Expense,Github,Balapavan Tirumani,Credit Card - Ramp,10,55727403.89
09/28/2023,Expense,Github,Balapavan Tirumani,Tools & Subscription - G&A,10,55727413.89
09/28/2023,Expense,Github,Balapavan Tirumani,Tools & Subscription - G&A,44,55727457.89
09/28/2023,Expense,Github,Balapavan Tirumani,Credit Card - Ramp,44,55727501.89
09/28/2023,Expense,Github,Balapavan Tirumani,Credit Card - Ramp,10,55727511.89
09/28/2023,Expense,Github,Balapavan Tirumani,Tools & Subscription - G&A,44,55727555.89
09/29/2023,Expense,Transport for NSW,Mike ross,Travelling Expenses,1.5,55727557.39
09/29/2023,Expense,Transport for NSW,Mike ross,Travelling Expenses,1.5,55727558.89
09/29/2023,Expense,Netlify,Balapavan Tirumani,Tools & Subscription - G&A,19,55727577.89
09/29/2023,Expense,Transport for NSW,Mike ross,Travelling Expenses,1.5,55727579.39
09/29/2023,Expense,Transport for NSW,Mike ross,Credit Card - Ramp,1.5,55727580.89
09/29/2023,Expense,Transport for NSW,Mike ross,Travelling Expenses,1.5,55727582.39
09/29/2023,Expense,Netlify,Balapavan Tirumani,Tools & Subscription - G&A,19,55727601.39
09/29/2023,Expense,Netlify,Balapavan Tirumani,Credit Card - Ramp,19,55727620.39
09/29/2023,Expense,Netlify,Balapavan Tirumani,Credit Card - Ramp,19,55727639.39
09/29/2023,Expense,Netlify,Balapavan Tirumani,Credit Card - Ramp,19,55727658.39
09/29/2023,Expense,Netlify,Balapavan Tirumani,Tools & Subscription - G&A,19,55727677.39
09/29/2023,Expense,Transport for NSW,Mike ross,Credit Card - Ramp,1.5,55727678.89
09/29/2023,Expense,Netlify,Balapavan Tirumani,Tools & Subscription - G&A,19,55727697.89
09/29/2023,Expense,Transport for NSW,Mike ross,Credit Card - Ramp,1.5,55727699.39
09/30/2023,Bill,Big Company ,"Service Expenses for the month of September 2023 
INR   24,68,804   @ 83.2511",Accounts Payable (A/P),29655,55757354.39
09/30/2023,Expense,Uber,Mike ross,Credit Card - Ramp,15.11,55757369.5
09/30/2023,Expense,Uber,Mike ross,Credit Card - Ramp,12.58,55757382.08
09/30/2023,Bill,Big Company ,"Service Expenses for the month of September 2023 
INR   24,68,804   @ 83.2511",Accounts Payable (A/P),29655,55787037.08
09/30/2023,Expense,inkle,Harvey Spector,Tools & Subscription - G&A,30,55787067.08
09/30/2023,Expense,Uber,Mike ross,Travelling Expenses,15.11,55787082.19
09/30/2023,Expense,inkle,Harvey Spector,Tools & Subscription - G&A,30,55787112.19
09/30/2023,Expense,Uber,Mike ross,Credit Card - Ramp,12.58,55787124.77
09/30/2023,Bill,Big Company ,,Outsources Services - India,29655,55816779.77
09/30/2023,Expense,Uber,Mike ross,Credit Card - Ramp,15.11,55816794.88
09/30/2023,Expense,Uber,Mike ross,Credit Card - Ramp,15.11,55816809.99
09/30/2023,Expense,Uber,Mike ross,Travelling Expenses,15.11,55816825.1
09/30/2023,Expense,Uber,Mike ross,Travelling Expenses,12.58,55816837.68
09/30/2023,Expense,Adobe,Mike ross,Tools & Subscription - S&M,19.43,55816857.11
09/30/2023,Expense,inkle,Harvey Spector,Credit Card - Ramp,30,55816887.11
09/30/2023,Expense,Uber,Mike ross,Travelling Expenses,12.58,55816899.69
09/30/2023,Expense,Adobe,Mike ross,Credit Card - Ramp,19.43,55816919.12
09/30/2023,Expense,Adobe,Mike ross,Tools & Subscription - S&M,19.43,55816938.55
09/30/2023,Bill,Big Company ,,Outsources Services - India,29655,55846593.55
09/30/2023,Expense,inkle,Harvey Spector,Credit Card - Ramp,30,55846623.55
09/30/2023,Expense,Uber,Mike ross,Travelling Expenses,15.11,55846638.66
09/30/2023,Expense,inkle,Harvey Spector,Tools & Subscription - G&A,30,55846668.66
09/30/2023,Expense,Uber,Mike ross,Travelling Expenses,12.58,55846681.24
09/30/2023,Bill,Big Company ,"Service Expenses for the month of September 2023 
INR   24,68,804   @ 83.2511",Accounts Payable (A/P),29655,55876336.24
09/30/2023,Bill,Big Company ,"Service Expenses for the month of September 2023 
INR   24,68,804   @ 83.2511",Accounts Payable (A/P),29655,55905991.24
09/30/2023,Expense,Adobe,Mike ross,Credit Card - Ramp,19.43,55906010.67
09/30/2023,Expense,Adobe,Mike ross,Credit Card - Ramp,19.43,55906030.1
09/30/2023,Bill,Big Company ,,Outsources Services - India,29655,55935685.1
09/30/2023,Expense,Uber,Mike ross,Travelling Expenses,15.11,55935700.21
09/30/2023,Expense,Adobe,Mike ross,Tools & Subscription - S&M,19.43,55935719.64
09/30/2023,Expense,Uber,Mike ross,Credit Card - Ramp,12.58,55935732.22
09/30/2023,Expense,Uber,Mike ross,Travelling Expenses,12.58,55935744.8
09/30/2023,Expense,inkle,Harvey Spector,Credit Card - Ramp,30,55935774.8
09/30/2023,Bill,Big Company ,,Outsources Services - India,29655,55965429.8
09/30/2023,Expense,Adobe,Mike ross,Tools & Subscription - S&M,19.43,55965449.23
09/30/2023,Expense,inkle,Harvey Spector,Tools & Subscription - G&A,30,55965479.23
10/01/2023,Expense,Uber,Mike ross,Travelling Expenses,5.58,55965484.81
10/01/2023,Expense,Google G Suite,Mike ross,Tools & Subscription - G&A,141.13,55965625.94
10/01/2023,Expense,The New York Times,Mike ross,General business expenses:Memberships & subscriptions,8.03,55965633.97
10/01/2023,Expense,Transport for NSW,Mike ross,Credit Card - Ramp,2.49,55965636.46
10/01/2023,Expense,Adobe,Chris George,Tools & Subscription - S&M,31.49,55965667.95
10/01/2023,Expense,Uber,Mike ross,Credit Card - Ramp,39.67,55965707.62
10/01/2023,Expense,Uber,Mike ross,Credit Card - Ramp,39.67,55965747.29
10/01/2023,Expense,Transport for NSW,Mike ross,Travelling Expenses,2.49,55965749.78
10/01/2023,Expense,The New York Times,Mike ross,Credit Card - Ramp,8.03,55965757.81
10/01/2023,Expense,Adobe,Chris George,Credit Card - Ramp,31.49,55965789.3
10/01/2023,Expense,Adobe,Chris George,Tools & Subscription - S&M,31.49,55965820.79
10/01/2023,Expense,Uber,Mike ross,Credit Card - Ramp,5.58,55965826.37
10/01/2023,Expense,Adobe,Chris George,Tools & Subscription - S&M,31.49,55965857.86
10/01/2023,Expense,Transport for NSW,Mike ross,Travelling Expenses,2.49,55965860.35
10/01/2023,Expense,The New York Times,Mike ross,General business expenses:Memberships & subscriptions,8.03,55965868.38
10/01/2023,Expense,Google G Suite,Mike ross,Tools & Subscription - G&A,141.13,55966009.51
10/01/2023,Expense,Uber,Mike ross,Travelling Expenses,5.58,55966015.09
10/01/2023,Expense,Uber,Mike ross,Credit Card - Ramp,5.58,55966020.67
10/01/2023,Expense,Google G Suite,Mike ross,Credit Card - Ramp,141.13,55966161.8
10/01/2023,Expense,Uber,Mike ross,Travelling Expenses,39.67,55966201.47
10/01/2023,Expense,Uber,Mike ross,Travelling Expenses,5.58,55966207.05
10/01/2023,Expense,Uber,Mike ross,Travelling Expenses,39.67,55966246.72
10/01/2023,Expense,Adobe,Chris George,Credit Card - Ramp,31.49,55966278.21
10/01/2023,Expense,Google G Suite,Mike ross,Tools & Subscription - G&A,141.13,55966419.34
10/01/2023,Expense,Transport for NSW,Mike ross,Credit Card - Ramp,2.49,55966421.83
10/01/2023,Expense,Uber,Mike ross,Credit Card - Ramp,39.67,55966461.5
10/01/2023,Expense,Adobe,Chris George,Credit Card - Ramp,31.49,55966492.99
10/01/2023,Expense,Adobe,Chris George,Tools & Subscription - S&M,31.49,55966524.48
10/01/2023,Expense,Google G Suite,Mike ross,Credit Card - Ramp,141.13,55966665.61
10/01/2023,Expense,The New York Times,Mike ross,General business expenses:Memberships & subscriptions,8.03,55966673.64
10/01/2023,Expense,The New York Times,Mike ross,Credit Card - Ramp,8.03,55966681.67
10/01/2023,Expense,Google G Suite,Mike ross,Tools & Subscription - G&A,141.13,55966822.8
10/01/2023,Expense,Google G Suite,Mike ross,Credit Card - Ramp,141.13,55966963.93
10/01/2023,Expense,Uber,Mike ross,Travelling Expenses,5.58,55966969.51
10/01/2023,Expense,The New York Times,Mike ross,Credit Card - Ramp,8.03,55966977.54
10/01/2023,Expense,The New York Times,Mike ross,General business expenses:Memberships & subscriptions,8.03,55966985.57
10/01/2023,Expense,Transport for NSW,Mike ross,Credit Card - Ramp,2.49,55966988.06
10/01/2023,Expense,Uber,Mike ross,Travelling Expenses,39.67,55967027.73
10/01/2023,Expense,Transport for NSW,Mike ross,Travelling Expenses,2.49,55967030.22
10/01/2023,Expense,Transport for NSW,Mike ross,Travelling Expenses,2.49,55967032.71
10/01/2023,Expense,The New York Times,Mike ross,Credit Card - Ramp,8.03,55967040.74
10/01/2023,Expense,Uber,Mike ross,Travelling Expenses,39.67,55967080.41
10/01/2023,Expense,Uber,Mike ross,Credit Card - Ramp,5.58,55967085.99
10/02/2023,Expense,Render,Balapavan Tirumani,Tools & Subscription - G&A,264.02,55967350.01
10/02/2023,Expense,June,Balapavan Tirumani,Tools & Subscription - G&A,149,55967499.01
10/02/2023,Expense,Render,Balapavan Tirumani,Tools & Subscription - G&A,264.02,55967763.03
10/02/2023,Expense,June,Balapavan Tirumani,Tools & Subscription - G&A,149,55967912.03
10/02/2023,Expense,June,Balapavan Tirumani,Credit Card - Ramp,149,55968061.03
10/02/2023,Expense,Render,Balapavan Tirumani,Credit Card - Ramp,264.02,55968325.05
10/02/2023,Expense,June,Balapavan Tirumani,Tools & Subscription - G&A,149,55968474.05
10/02/2023,Expense,June,Balapavan Tirumani,Credit Card - Ramp,149,55968623.05
10/02/2023,Expense,Render,Balapavan Tirumani,Tools & Subscription - G&A,264.02,55968887.07
10/02/2023,Expense,June,Balapavan Tirumani,Tools & Subscription - G&A,149,55969036.07
10/02/2023,Expense,Render,Balapavan Tirumani,Credit Card - Ramp,264.02,55969300.09
10/02/2023,Expense,June,Balapavan Tirumani,Credit Card - Ramp,149,55969449.09
10/02/2023,Expense,Render,Balapavan Tirumani,Tools & Subscription - G&A,264.02,55969713.11
10/02/2023,Expense,Render,Balapavan Tirumani,Credit Card - Ramp,264.02,55969977.13
10/03/2023,Expense,VirtualPostMail,Harvey Spector,Credit Card - Ramp,35,55970012.13
10/03/2023,Expense,Uber,Harvey Spector,Travelling Expenses,10.96,55970023.09
10/03/2023,Expense,Uber,Harvey Spector,Travelling Expenses,10.96,55970034.05
10/03/2023,Expense,VirtualPostMail,Harvey Spector,General business expenses:Memberships & subscriptions,35,55970069.05
10/03/2023,Expense,VirtualPostMail,Harvey Spector,Credit Card - Ramp,35,55970104.05
10/03/2023,Expense,Uber,Harvey Spector,Travelling Expenses,10.96,55970115.01
10/03/2023,Expense,VirtualPostMail,Harvey Spector,General business expenses:Memberships & subscriptions,35,55970150.01
10/03/2023,Expense,Uber,Harvey Spector,Credit Card - Ramp,10.96,55970160.97
10/03/2023,Expense,VirtualPostMail,Harvey Spector,General business expenses:Memberships & subscriptions,35,55970195.97
10/03/2023,Expense,VirtualPostMail,Harvey Spector,Credit Card - Ramp,35,55970230.97
10/03/2023,Expense,Uber,Harvey Spector,Travelling Expenses,10.96,55970241.93
10/03/2023,Expense,VirtualPostMail,Harvey Spector,Credit Card - Ramp,35,55970276.93
10/03/2023,Expense,Uber,Harvey Spector,Credit Card - Ramp,10.96,55970287.89
10/03/2023,Expense,VirtualPostMail,Harvey Spector,General business expenses:Memberships & subscriptions,35,55970322.89
10/03/2023,Expense,Uber,Harvey Spector,Credit Card - Ramp,10.96,55970333.85
10/04/2023,Expense,OpenAI,Mike ross,Tools & Subscription - G&A,20,55970353.85
10/04/2023,Expense,OpenAI,Mike ross,Credit Card - Ramp,20,55970373.85
10/04/2023,Expense,OpenAI,Mike ross,Credit Card - Ramp,20,55970393.85
10/04/2023,Expense,OpenAI,Mike ross,Tools & Subscription - G&A,20,55970413.85
10/04/2023,Expense,OpenAI,Mike ross,Tools & Subscription - G&A,20,55970433.85
10/04/2023,Expense,OpenAI,Mike ross,Tools & Subscription - G&A,20,55970453.85
10/04/2023,Expense,OpenAI,Mike ross,Credit Card - Ramp,20,55970473.85
10/05/2023,Expense,Transport for NSW,Mike ross,Credit Card - Ramp,1.47,55970475.32
10/05/2023,Expense,Rewind AI,Harvey Spector,Credit Card - Ramp,29,55970504.32
10/05/2023,Expense,Rewind AI,Harvey Spector,Tools & Subscription - G&A,29,55970533.32
10/05/2023,Expense,Careem,Harvey Spector,Credit Card - Ramp,18.65,55970551.97
10/05/2023,Expense,Transport for NSW,Mike ross,Credit Card - Ramp,1.47,55970553.44
10/05/2023,Expense,Careem,Harvey Spector,Credit Card - Ramp,18.65,55970572.09
10/05/2023,Expense,Rewind AI,Harvey Spector,Credit Card - Ramp,29,55970601.09
10/05/2023,Expense,Careem,Harvey Spector,Travelling Expenses,18.65,55970619.74
10/05/2023,Expense,Rewind AI,Harvey Spector,Tools & Subscription - G&A,29,55970648.74
10/05/2023,Expense,Transport for NSW,Mike ross,Credit Card - Ramp,1.47,55970650.21
10/05/2023,Expense,Careem,Harvey Spector,Travelling Expenses,18.65,55970668.86
10/05/2023,Expense,Transport for NSW,Mike ross,Travelling Expenses,1.47,55970670.33
10/05/2023,Expense,Transport for NSW,Mike ross,Travelling Expenses,1.47,55970671.8
10/05/2023,Expense,Careem,Harvey Spector,Travelling Expenses,18.65,55970690.45
10/05/2023,Expense,Careem,Harvey Spector,Travelling Expenses,18.65,55970709.1
10/05/2023,Expense,Rewind AI,Harvey Spector,Tools & Subscription - G&A,29,55970738.1
10/05/2023,Expense,Transport for NSW,Mike ross,Travelling Expenses,1.47,55970739.57
10/05/2023,Expense,Transport for NSW,Mike ross,Travelling Expenses,1.47,55970741.04
10/05/2023,Expense,Careem,Harvey Spector,Credit Card - Ramp,18.65,55970759.69
10/05/2023,Expense,Rewind AI,Harvey Spector,Credit Card - Ramp,29,55970788.69
10/05/2023,Expense,Rewind AI,Harvey Spector,Tools & Subscription - G&A,29,55970817.69
10/06/2023,Expense,inkle,Harvey Spector,Tools & Subscription - G&A,400,55971217.69
10/06/2023,Expense,inkle,Harvey Spector,Tools & Subscription - G&A,100,55971317.69
10/06/2023,Expense,Adobe,Mike ross,Credit Card - Ramp,80.18,55971397.87
10/06/2023,Expense,inkle,Harvey Spector,Credit Card - Ramp,100,55971497.87
10/06/2023,Expense,inkle,Harvey Spector,Credit Card - Ramp,400,55971897.87
10/06/2023,Expense,inkle,Harvey Spector,Tools & Subscription - G&A,100,55971997.87
10/06/2023,Deposit,,Interest Accrual INTEREST,Interest Received,1.84,55971999.71
10/06/2023,Expense,inkle,Harvey Spector,Credit Card - Ramp,400,55972399.71
10/06/2023,Expense,inkle,Harvey Spector,Credit Card - Ramp,100,55972499.71
10/06/2023,Deposit,,Interest Accrual INTEREST,Savings (6977),1.84,55972501.55
10/06/2023,Expense,Adobe,Mike ross,Tools & Subscription - S&M,80.18,55972581.73
10/06/2023,Deposit,,Interest Accrual INTEREST,Interest Received,1.84,55972583.57
10/06/2023,Deposit,,Interest Accrual INTEREST,Savings (6977),1.84,55972585.41
10/06/2023,Expense,inkle,Harvey Spector,Credit Card - Ramp,100,55972685.41
10/06/2023,Deposit,,Interest Accrual INTEREST,Interest Received,1.84,55972687.25
10/06/2023,Deposit,,Interest Accrual INTEREST,Savings (6977),1.84,55972689.09
10/06/2023,Expense,inkle,Harvey Spector,Credit Card - Ramp,400,55973089.09
10/06/2023,Expense,Adobe,Mike ross,Tools & Subscription - S&M,80.18,55973169.27
10/06/2023,Expense,inkle,Harvey Spector,Tools & Subscription - G&A,400,55973569.27
10/06/2023,Expense,inkle,Harvey Spector,Tools & Subscription - G&A,100,55973669.27
10/06/2023,Expense,inkle,Harvey Spector,Tools & Subscription - G&A,400,55974069.27
10/06/2023,Expense,inkle,Harvey Spector,Tools & Subscription - G&A,400,55974469.27
10/06/2023,Expense,Adobe,Mike ross,Credit Card - Ramp,80.18,55974549.45
10/06/2023,Expense,inkle,Harvey Spector,Tools & Subscription - G&A,100,55974649.45
10/06/2023,Expense,Adobe,Mike ross,Tools & Subscription - S&M,80.18,55974729.63
10/06/2023,Expense,Adobe,Mike ross,Credit Card - Ramp,80.18,55974809.81
10/06/2023,Deposit,,Interest Accrual INTEREST,Interest Received,1.84,55974811.65
10/06/2023,Expense,Adobe,Mike ross,Tools & Subscription - S&M,80.18,55974891.83
10/07/2023,Expense,Transport for NSW,Mike ross,Travelling Expenses,4.55,55974896.38
10/07/2023,Expense,Transport for NSW,Mike ross,Credit Card - Ramp,4.55,55974900.93
10/07/2023,Expense,Transport for NSW,Mike ross,Travelling Expenses,4.55,55974905.48
10/07/2023,Expense,Transport for NSW,Mike ross,Travelling Expenses,4.55,55974910.03
10/07/2023,Expense,Transport for NSW,Mike ross,Credit Card - Ramp,4.55,55974914.58
10/07/2023,Expense,Transport for NSW,Mike ross,Travelling Expenses,4.55,55974919.13
10/07/2023,Expense,Transport for NSW,Mike ross,Credit Card - Ramp,4.55,55974923.68
10/08/2023,Expense,Careem,Harvey Spector,Credit Card - Ramp,22.72,55974946.4
10/08/2023,Expense,Transport for NSW,Mike ross,Travelling Expenses,5.55,55974951.95
10/08/2023,Expense,Transport for NSW,Mike ross,Credit Card - Ramp,5.55,55974957.5
10/08/2023,Expense,Careem,Harvey Spector,Travelling Expenses,22.72,55974980.22
10/08/2023,Expense,Transport for NSW,Mike ross,Travelling Expenses,5.55,55974985.77
10/08/2023,Expense,Transport for NSW,Mike ross,Credit Card - Ramp,5.55,55974991.32
10/08/2023,Expense,Careem,Harvey Spector,Travelling Expenses,22.72,55975014.04
10/08/2023,Expense,Transport for NSW,Mike ross,Credit Card - Ramp,5.55,55975019.59
10/08/2023,Expense,Careem,Harvey Spector,Travelling Expenses,22.72,55975042.31
10/08/2023,Expense,Careem,Harvey Spector,Credit Card - Ramp,22.72,55975065.03
10/08/2023,Expense,Transport for NSW,Mike ross,Travelling Expenses,5.55,55975070.58
10/08/2023,Expense,Transport for NSW,Mike ross,Travelling Expenses,5.55,55975076.13
10/08/2023,Expense,Careem,Harvey Spector,Travelling Expenses,22.72,55975098.85
10/08/2023,Expense,Careem,Harvey Spector,Credit Card - Ramp,22.72,55975121.57
10/09/2023,Expense,Usersnap,Harris Jose,Credit Card - Ramp,99,55975220.57
10/09/2023,Expense,OpenAI,Balapavan Tirumani,Credit Card - Ramp,20,55975240.57
10/09/2023,Expense,Heroku,Balapavan Tirumani,Credit Card - Ramp,85,55975325.57
10/09/2023,Expense,OpenAI,Balapavan Tirumani,Tools & Subscription - G&A,20,55975345.57
10/09/2023,Expense,OpenAI,Balapavan Tirumani,Tools & Subscription - G&A,20,55975365.57
10/09/2023,Expense,Usersnap,Harris Jose,Tools & Subscription - G&A,99,55975464.57
10/09/2023,Expense,inkle,Harvey Spector,Credit Card - Ramp,100,55975564.57
10/09/2023,Expense,OpenAI,Balapavan Tirumani,Credit Card - Ramp,20,55975584.57
10/09/2023,Expense,Heroku,Balapavan Tirumani,Tools & Subscription - S&M,85,55975669.57
10/09/2023,Expense,Heroku,Balapavan Tirumani,Credit Card - Ramp,85,55975754.57
10/09/2023,Expense,Usersnap,Harris Jose,Tools & Subscription - G&A,99,55975853.57
10/09/2023,Expense,inkle,Harvey Spector,Credit Card - Ramp,400,55976253.57
10/09/2023,Expense,inkle,Harvey Spector,Tools & Subscription - G&A,400,55976653.57
10/09/2023,Expense,Heroku,Balapavan Tirumani,Tools & Subscription - S&M,85,55976738.57
10/09/2023,Expense,inkle,Harvey Spector,Credit Card - Ramp,400,55977138.57
10/09/2023,Expense,inkle,Harvey Spector,Tools & Subscription - G&A,400,55977538.57
10/09/2023,Expense,Heroku,Balapavan Tirumani,Credit Card - Ramp,85,55977623.57
10/09/2023,Expense,inkle,Harvey Spector,Tools & Subscription - G&A,100,55977723.57
10/09/2023,Expense,OpenAI,Balapavan Tirumani,Tools & Subscription - G&A,20,55977743.57
10/09/2023,Expense,Usersnap,Harris Jose,Tools & Subscription - G&A,99,55977842.57
10/09/2023,Expense,inkle,Harvey Spector,Tools & Subscription - G&A,100,55977942.57
10/09/2023,Expense,inkle,Harvey Spector,Credit Card - Ramp,100,55978042.57
10/09/2023,Expense,OpenAI,Balapavan Tirumani,Tools & Subscription - G&A,20,55978062.57
10/09/2023,Expense,Usersnap,Harris Jose,Tools & Subscription - G&A,99,55978161.57
10/09/2023,Expense,Heroku,Balapavan Tirumani,Tools & Subscription - S&M,85,55978246.57
10/09/2023,Expense,inkle,Harvey Spector,Tools & Subscription - G&A,400,55978646.57
10/09/2023,Expense,Usersnap,Harris Jose,Credit Card - Ramp,99,55978745.57
10/09/2023,Expense,inkle,Harvey Spector,Tools & Subscription - G&A,100,55978845.57
10/09/2023,Expense,Usersnap,Harris Jose,Credit Card - Ramp,99,55978944.57
10/09/2023,Expense,inkle,Harvey Spector,Credit Card - Ramp,100,55979044.57
10/09/2023,Expense,inkle,Harvey Spector,Credit Card - Ramp,400,55979444.57
10/09/2023,Expense,Heroku,Balapavan Tirumani,Tools & Subscription - S&M,85,55979529.57
10/09/2023,Expense,inkle,Harvey Spector,Tools & Subscription - G&A,400,55979929.57
10/09/2023,Expense,OpenAI,Balapavan Tirumani,Credit Card - Ramp,20,55979949.57
10/09/2023,Expense,inkle,Harvey Spector,Tools & Subscription - G&A,100,55980049.57
10/10/2023,Expense,Pause Cafe,Harvey Spector,Meals & Entertainment,14,55980063.57
10/10/2023,Expense,Zoom,Max Kausman,Tools & Subscription - G&A,15.99,55980079.56
10/10/2023,Expense,Pause Cafe,Harvey Spector,Credit Card - Ramp,14,55980093.56
10/10/2023,Expense,Uber,Mike ross,Travelling Expenses,17.05,55980110.61
10/10/2023,Expense,Pause Cafe,Harvey Spector,Meals & Entertainment,14,55980124.61
10/10/2023,Expense,Amazon Au,Max Kausman,Tools & Subscription,16.95,55980141.56
10/10/2023,Expense,Pause Cafe,Harvey Spector,Meals & Entertainment,14,55980155.56
10/10/2023,Expense,Pause Cafe,Harvey Spector,Credit Card - Ramp,14,55980169.56
10/10/2023,Expense,Uber,Mike ross,Credit Card - Ramp,17.05,55980186.61
10/10/2023,Expense,Amazon Au,Max Kausman,Credit Card - Ramp,16.95,55980203.56
10/10/2023,Expense,Zoom,Max Kausman,Tools & Subscription - G&A,15.99,55980219.55
10/10/2023,Expense,Uber,Mike ross,Travelling Expenses,17.05,55980236.6
10/10/2023,Expense,Amazon Au,Max Kausman,Tools & Subscription,16.95,55980253.55
10/10/2023,Expense,Amazon Au,Max Kausman,Tools & Subscription,16.95,55980270.5
10/10/2023,Expense,Pause Cafe,Harvey Spector,Credit Card - Ramp,14,55980284.5
10/10/2023,Expense,Zoom,Max Kausman,Tools & Subscription - G&A,15.99,55980300.49
10/10/2023,Expense,Uber,Mike ross,Credit Card - Ramp,17.05,55980317.54
10/10/2023,Expense,Uber,Mike ross,Credit Card - Ramp,17.05,55980334.59
10/10/2023,Expense,Pause Cafe,Harvey Spector,Credit Card - Ramp,14,55980348.59
10/10/2023,Expense,Uber,Mike ross,Travelling Expenses,17.05,55980365.64
10/10/2023,Expense,Zoom,Max Kausman,Credit Card - Ramp,15.99,55980381.63
10/10/2023,Expense,Uber,Mike ross,Travelling Expenses,17.05,55980398.68
10/10/2023,Expense,Zoom,Max Kausman,Tools & Subscription - G&A,15.99,55980414.67
10/10/2023,Expense,Amazon Au,Max Kausman,Tools & Subscription,16.95,55980431.62
10/10/2023,Expense,Amazon Au,Max Kausman,Credit Card - Ramp,16.95,55980448.57
10/10/2023,Expense,Zoom,Max Kausman,Credit Card - Ramp,15.99,55980464.56
10/10/2023,Expense,Zoom,Max Kausman,Credit Card - Ramp,15.99,55980480.55
10/10/2023,Expense,Amazon Au,Max Kausman,Credit Card - Ramp,16.95,55980497.5
10/10/2023,Expense,Pause Cafe,Harvey Spector,Meals & Entertainment,14,55980511.5
10/11/2023,Expense,Grammarly,Harvey Spector,Credit Card - Ramp,144,55980655.5
10/11/2023,Expense,Lucky Pickle Dumpling Co,Mike ross,Meals & Entertainment,21.49,55980676.99
10/11/2023,Expense,Grammarly,Harvey Spector,Tools & Subscription - G&A,144,55980820.99
10/11/2023,Expense,Lucky Pickle Dumpling Co,Mike ross,Meals & Entertainment,21.49,55980842.48
10/11/2023,Expense,Grammarly,Harvey Spector,Credit Card - Ramp,144,55980986.48
10/11/2023,Expense,Lucky Pickle Dumpling Co,Mike ross,Credit Card - Ramp,21.49,55981007.97
10/11/2023,Expense,Lucky Pickle Dumpling Co,Mike ross,Meals & Entertainment,21.49,55981029.46
10/11/2023,Expense,Grammarly,Harvey Spector,Tools & Subscription - G&A,144,55981173.46
10/11/2023,Expense,Lucky Pickle Dumpling Co,Mike ross,Credit Card - Ramp,21.49,55981194.95
10/11/2023,Expense,Grammarly,Harvey Spector,Credit Card - Ramp,144,55981338.95
10/11/2023,Expense,Grammarly,Harvey Spector,Tools & Subscription - G&A,144,55981482.95
10/11/2023,Expense,Lucky Pickle Dumpling Co,Mike ross,Meals & Entertainment,21.49,55981504.44
10/11/2023,Expense,Lucky Pickle Dumpling Co,Mike ross,Credit Card - Ramp,21.49,55981525.93
10/11/2023,Expense,Lucky Pickle Dumpling Co,Mike ross,Credit Card - Ramp,21.49,55981547.42
10/11/2023,Expense,Grammarly,Harvey Spector,Tools & Subscription - G&A,144,55981691.42
10/12/2023,Expense,WordPress,Harris Jose,Tools & Subscription - G&A,15.61,55981707.03
10/12/2023,Expense,WordPress,Harris Jose,Tools & Subscription - G&A,15.61,55981722.64
10/12/2023,Expense,WordPress,Harris Jose,Credit Card - Ramp,15.61,55981738.25
10/12/2023,Expense,Adobe,Chris George,Tools & Subscription - S&M,20.99,55981759.24
10/12/2023,Expense,Adobe,Chris George,Tools & Subscription - S&M,20.99,55981780.23
10/12/2023,Expense,WordPress,Harris Jose,Tools & Subscription - G&A,15.61,55981795.84
10/12/2023,Transfer,,PaymentServiceB Savings **6977,Savings (6977),700000,56681795.84
10/12/2023,Expense,Adobe,Chris George,Tools & Subscription - S&M,20.99,56681816.83
10/12/2023,Expense,WordPress,Harris Jose,Credit Card - Ramp,15.61,56681832.44
10/12/2023,Transfer,,PaymentServiceB Savings **6977,Savings (6977),700000,57381832.44
10/12/2023,Expense,Adobe,Chris George,Credit Card - Ramp,20.99,57381853.43
10/12/2023,Expense,Adobe,Chris George,Credit Card - Ramp,20.99,57381874.42
10/12/2023,Transfer,,PaymentServiceB Savings **6977,Account1,-700000,56681874.42
10/12/2023,Expense,Adobe,Chris George,Tools & Subscription - S&M,20.99,56681895.41
10/12/2023,Expense,WordPress,Harris Jose,Credit Card - Ramp,15.61,56681911.02
10/12/2023,Transfer,,PaymentServiceB Savings **6977,Savings (6977),700000,57381911.02
10/12/2023,Expense,Adobe,Chris George,Credit Card - Ramp,20.99,57381932.01
10/12/2023,Transfer,,PaymentServiceB Savings **6977,Account1,-700000,56681932.01
10/12/2023,Expense,WordPress,Harris Jose,Tools & Subscription - G&A,15.61,56681947.62
10/12/2023,Transfer,,PaymentServiceB Savings **6977,Savings (6977),700000,57381947.62
10/12/2023,Transfer,,PaymentServiceB Savings **6977,Account1,-700000,56681947.62
10/12/2023,Transfer,,PaymentServiceB Savings **6977,Account1,-700000,55981947.62
10/13/2023,Expense,Vercel,Harris Jose,Tools & Subscription - G&A,240,55982187.62
10/13/2023,Expense,Interact32,Harvey Spector,Tools & Subscription - G&A,10.09,55982197.71
10/13/2023,Expense,Lenny Rachitsky,Max Kausman,General business expenses:Memberships & subscriptions,15,55982212.71
10/13/2023,Expense,Figma,Mike ross,Tools & Subscription - G&A,75,55982287.71
10/13/2023,Expense,Lenny Rachitsky,Max Kausman,General business expenses:Memberships & subscriptions,15,55982302.71
10/13/2023,Expense,Interact32,Harvey Spector,Tools & Subscription - G&A,10.09,55982312.8
10/13/2023,Expense,Lenny Rachitsky,Max Kausman,Credit Card - Ramp,15,55982327.8
10/13/2023,Expense,Figma,Mike ross,Tools & Subscription - G&A,75,55982402.8
10/13/2023,Expense,Vercel,Harris Jose,Credit Card - Ramp,240,55982642.8
10/13/2023,Expense,Interact32,Harvey Spector,Credit Card - Ramp,10.09,55982652.89
10/13/2023,Expense,Vercel,Harris Jose,Credit Card - Ramp,240,55982892.89
10/13/2023,Expense,Vercel,Harris Jose,Tools & Subscription - G&A,240,55983132.89
10/13/2023,Expense,zamp finance,Zamp Finance,Account1,700000,56683132.89
10/13/2023,Expense,Figma,Mike ross,Credit Card - Ramp,75,56683207.89
10/13/2023,Expense,Vercel,Harris Jose,Credit Card - Ramp,240,56683447.89
10/13/2023,Expense,Interact32,Harvey Spector,Credit Card - Ramp,10.09,56683457.98
10/13/2023,Expense,Figma,Mike ross,Tools & Subscription - G&A,75,56683532.98
10/13/2023,Expense,zamp finance,Zamp Finance,Zamp Investments - Other,-700000,55983532.98
10/13/2023,Expense,Lenny Rachitsky,Max Kausman,General business expenses:Memberships & subscriptions,15,55983547.98
10/13/2023,Expense,Figma,Mike ross,Credit Card - Ramp,75,55983622.98
10/13/2023,Expense,Interact32,Harvey Spector,Tools & Subscription - G&A,10.09,55983633.07
10/13/2023,Expense,Figma,Mike ross,Tools & Subscription - G&A,75,55983708.07
10/13/2023,Expense,zamp finance,Zamp Finance,Zamp Investments - Other,-700000,55283708.07
10/13/2023,Expense,Lenny Rachitsky,Max Kausman,Credit Card - Ramp,15,55283723.07
10/13/2023,Expense,zamp finance,Zamp Finance,Account1,700000,55983723.07
10/13/2023,Expense,Lenny Rachitsky,Max Kausman,Credit Card - Ramp,15,55983738.07
10/13/2023,Expense,Vercel,Harris Jose,Tools & Subscription - G&A,240,55983978.07
10/13/2023,Expense,Interact32,Harvey Spector,Tools & Subscription - G&A,10.09,55983988.16
10/13/2023,Expense,zamp finance,Zamp Finance,Account1,700000,56683988.16
10/13/2023,Expense,Vercel,Harris Jose,Tools & Subscription - G&A,240,56684228.16
10/13/2023,Expense,zamp finance,Zamp Finance,Zamp Investments - Other,-700000,55984228.16
10/13/2023,Expense,Lenny Rachitsky,Max Kausman,General business expenses:Memberships & subscriptions,15,55984243.16
10/13/2023,Expense,zamp finance,Zamp Finance,Account1,700000,56684243.16
10/13/2023,Expense,Lenny Rachitsky,Max Kausman,Credit Card - Ramp,15,56684258.16
10/13/2023,Expense,Figma,Mike ross,Credit Card - Ramp,75,56684333.16
10/13/2023,Expense,zamp finance,Zamp Finance,Zamp Investments - Other,-700000,55984333.16
10/13/2023,Expense,Interact32,Harvey Spector,Credit Card - Ramp,10.09,55984343.25
10/14/2023,Expense,Uber,Harvey Spector,Travelling Expenses,8.06,55984351.31
10/14/2023,Expense,Uber,Harvey Spector,Travelling Expenses,10.91,55984362.22
10/14/2023,Expense,Uber,Harvey Spector,Credit Card - Ramp,8.06,55984370.28
10/14/2023,Expense,Uber,Mike ross,Credit Card - Ramp,12.65,55984382.93
10/14/2023,Expense,Uber,Harvey Spector,Credit Card - Ramp,10.91,55984393.84
10/14/2023,Expense,Uber,Harvey Spector,Credit Card - Ramp,10.91,55984404.75
10/14/2023,Expense,Intuit,Harvey Spector,Tools & Subscription - G&A,60,55984464.75
10/14/2023,Expense,Uber,Mike ross,Travelling Expenses,12.65,55984477.4
10/14/2023,Expense,Intuit,Harvey Spector,Credit Card - Ramp,60,55984537.4
10/14/2023,Expense,Intuit,Harvey Spector,Credit Card - Ramp,60,55984597.4
10/14/2023,Expense,Uber,Harvey Spector,Credit Card - Ramp,8.06,55984605.46
10/14/2023,Expense,Intuit,Harvey Spector,Tools & Subscription - G&A,60,55984665.46
10/14/2023,Expense,Uber,Mike ross,Credit Card - Ramp,12.65,55984678.11
10/14/2023,Expense,Uber,Mike ross,Travelling Expenses,12.65,55984690.76
10/14/2023,Expense,Intuit,Harvey Spector,Tools & Subscription - G&A,60,55984750.76
10/14/2023,Expense,Intuit,Harvey Spector,Credit Card - Ramp,60,55984810.76
10/14/2023,Expense,Uber,Mike ross,Travelling Expenses,12.65,55984823.41
10/14/2023,Expense,Uber,Harvey Spector,Travelling Expenses,10.91,55984834.32
10/14/2023,Expense,Uber,Harvey Spector,Travelling Expenses,8.06,55984842.38
10/14/2023,Expense,Intuit,Harvey Spector,Tools & Subscription - G&A,60,55984902.38
10/14/2023,Expense,Uber,Harvey Spector,Credit Card - Ramp,10.91,55984913.29
10/14/2023,Expense,Uber,Harvey Spector,Travelling Expenses,10.91,55984924.2
10/14/2023,Expense,Uber,Mike ross,Travelling Expenses,12.65,55984936.85
10/14/2023,Expense,Uber,Harvey Spector,Travelling Expenses,8.06,55984944.91
10/14/2023,Expense,Uber,Harvey Spector,Travelling Expenses,8.06,55984952.97
10/14/2023,Expense,Uber,Mike ross,Credit Card - Ramp,12.65,55984965.62
10/14/2023,Expense,Uber,Harvey Spector,Credit Card - Ramp,8.06,55984973.68
10/14/2023,Expense,Uber,Harvey Spector,Travelling Expenses,10.91,55984984.59
10/16/2023,Expense,Zapier,Harvey Spector,Tools & Subscription - G&A,29.99,55985014.58
10/16/2023,Bill,ANSR Dubai,Service Fees for October 2023,Accounts Payable (A/P),10874,55995888.58
10/16/2023,Bill,ANSR Dubai,Service Fees for October 2023,Accounts Payable (A/P),10874,56006762.58
10/16/2023,Expense,Amazon Au,Max Kausman,Credit Card - Ramp,15.53,56006778.11
10/16/2023,Expense,Zapier,Harvey Spector,Tools & Subscription - G&A,29.99,56006808.1
10/16/2023,Bill,ANSR Dubai,,Professional Service Charges,10874,56017682.1
10/16/2023,Expense,Amazon Au,Max Kausman,Tools & Subscription,15.53,56017697.63
10/16/2023,Expense,Zapier,Harvey Spector,Credit Card - Ramp,29.99,56017727.62
10/16/2023,Bill,ANSR Dubai,,Professional Service Charges,10874,56028601.62
10/16/2023,Expense,Zapier,Harvey Spector,Tools & Subscription - G&A,29.99,56028631.61
10/16/2023,Expense,Amazon Au,Max Kausman,Tools & Subscription,15.53,56028647.14
10/16/2023,Expense,Zapier,Harvey Spector,Credit Card - Ramp,29.99,56028677.13
10/16/2023,Expense,Amazon Au,Max Kausman,Credit Card - Ramp,15.53,56028692.66
10/16/2023,Expense,Amazon Au,Max Kausman,Credit Card - Ramp,15.53,56028708.19
10/16/2023,Expense,Amazon Au,Max Kausman,Tools & Subscription,15.53,56028723.72
10/16/2023,Bill,ANSR Dubai,Service Fees for October 2023,Accounts Payable (A/P),10874,56039597.72
10/16/2023,Expense,Zapier,Harvey Spector,Credit Card - Ramp,29.99,56039627.71
10/16/2023,Bill,ANSR Dubai,,Professional Service Charges,10874,56050501.71
10/16/2023,Bill,ANSR Dubai,Service Fees for October 2023,Accounts Payable (A/P),10874,56061375.71
10/16/2023,Expense,Zapier,Harvey Spector,Tools & Subscription - G&A,29.99,56061405.7
10/16/2023,Bill,ANSR Dubai,,Professional Service Charges,10874,56072279.7
10/16/2023,Expense,Amazon Au,Max Kausman,Tools & Subscription,15.53,56072295.23
10/17/2023,Expense,inkle,Harvey Spector,Credit Card - Ramp,50,56072345.23
10/17/2023,Expense,,MONTHLY CHARGE Bank Charges for the per 01SEP2023 TO 30SEP2023 Invoice No 1707509,General business expenses:Bank fees & service charges,-44.92,56072300.31
10/17/2023,Expense,inkle,Harvey Spector,Tools & Subscription - G&A,50,56072350.31
10/17/2023,Expense,inkle,Harvey Spector,Tools & Subscription - G&A,25,56072375.31
10/17/2023,Expense,beIN SPORTS,Harvey Spector,Office expenses:Office supplies,18.9,56072394.21
10/17/2023,Expense,,MONTHLY CHARGE Bank Charges for the per 01SEP2023 TO 30SEP2023 Invoice No 1707509,General business expenses:Bank fees & service charges,-44.92,56072349.29
10/17/2023,Expense,beIN SPORTS,Harvey Spector,Credit Card - Ramp,18.9,56072368.19
10/17/2023,Expense,,MONTHLY CHARGE Bank Charges for the per 01SEP2023 TO 30SEP2023 Invoice No 1707509,General business expenses:Bank fees & service charges,-44.92,56072323.27
10/17/2023,Expense,,Fees,HSBC A/c,44.92,56072368.19
10/17/2023,Expense,inkle,Harvey Spector,Credit Card - Ramp,25,56072393.19
10/17/2023,Expense,,Fees,HSBC A/c,44.92,56072438.11
10/17/2023,Expense,,Fees,HSBC A/c,44.92,56072483.03
10/17/2023,Expense,inkle,Harvey Spector,Credit Card - Ramp,25,56072508.03
10/17/2023,Expense,beIN SPORTS,Harvey Spector,Credit Card - Ramp,18.9,56072526.93
10/17/2023,Expense,inkle,Harvey Spector,Tools & Subscription - G&A,25,56072551.93
10/17/2023,Expense,inkle,Harvey Spector,Tools & Subscription - G&A,50,56072601.93
10/17/2023,Expense,inkle,Harvey Spector,Tools & Subscription - G&A,25,56072626.93
10/17/2023,Expense,inkle,Harvey Spector,Tools & Subscription - G&A,25,56072651.93
10/17/2023,Expense,beIN SPORTS,Harvey Spector,Credit Card - Ramp,18.9,56072670.83
10/17/2023,Expense,beIN SPORTS,Harvey Spector,Office expenses:Office supplies,18.9,56072689.73
10/17/2023,Expense,inkle,Harvey Spector,Credit Card - Ramp,50,56072739.73
10/17/2023,Expense,inkle,Harvey Spector,Credit Card - Ramp,25,56072764.73
10/17/2023,Expense,inkle,Harvey Spector,Tools & Subscription - G&A,50,56072814.73
10/17/2023,Expense,,Fees,HSBC A/c,44.92,56072859.65
10/17/2023,Expense,inkle,Harvey Spector,Credit Card - Ramp,50,56072909.65
10/17/2023,Expense,beIN SPORTS,Harvey Spector,Credit Card - Ramp,18.9,56072928.55
10/17/2023,Expense,inkle,Harvey Spector,Tools & Subscription - G&A,50,56072978.55
10/17/2023,Expense,beIN SPORTS,Harvey Spector,Office expenses:Office supplies,18.9,56072997.45
10/17/2023,Expense,beIN SPORTS,Harvey Spector,Office expenses:Office supplies,18.9,56073016.35
10/17/2023,Expense,,MONTHLY CHARGE Bank Charges for the per 01SEP2023 TO 30SEP2023 Invoice No 1707509,General business expenses:Bank fees & service charges,-44.92,56072971.43
10/18/2023,Expense,Discord,Harvey Spector,Credit Card - Ramp,9.99,56072981.42
10/18/2023,Expense,Discord,Harvey Spector,Credit Card - Ramp,9.99,56072991.41
10/18/2023,Expense,Discord,Harvey Spector,Credit Card - Ramp,9.99,56073001.4
10/18/2023,Expense,Reclaim.ai,Max Kausman,Credit Card - Ramp,8,56073009.4
10/18/2023,Expense,Discord,Harvey Spector,Credit Card - Ramp,9.99,56073019.39
10/18/2023,Expense,Discord,Harvey Spector,Credit Card - Ramp,9.99,56073029.38
10/18/2023,Expense,Discord,Harvey Spector,Credit Card - Ramp,9.99,56073039.37
10/18/2023,Expense,Discord,Harvey Spector,Tools & Subscription - G&A,9.99,56073049.36
10/18/2023,Expense,Discord,Harvey Spector,Tools & Subscription - G&A,9.99,56073059.35
10/18/2023,Expense,Discord,Harvey Spector,Tools & Subscription - G&A,9.99,56073069.34
10/18/2023,Expense,Discord,Harvey Spector,Tools & Subscription - G&A,9.99,56073079.33
10/18/2023,Expense,Discord,Harvey Spector,Tools & Subscription - G&A,9.99,56073089.32
10/18/2023,Expense,Segment,Balapavan Tirumani,Tools & Subscription - G&A,120,56073209.32
10/18/2023,Expense,Discord,Harvey Spector,Credit Card - Ramp,9.99,56073219.31
10/18/2023,Expense,Discord,Harvey Spector,Tools & Subscription - G&A,9.99,56073229.3
10/18/2023,Expense,Discord,Harvey Spector,Credit Card - Ramp,9.99,56073239.29
10/18/2023,Expense,Discord,Harvey Spector,Tools & Subscription - G&A,9.99,56073249.28
10/18/2023,Expense,Discord,Harvey Spector,Credit Card - Ramp,9.99,56073259.27
10/18/2023,Expense,Discord,Harvey Spector,Tools & Subscription - G&A,9.99,56073269.26
10/18/2023,Expense,Reclaim.ai,Max Kausman,Tools & Subscription - G&A,8,56073277.26
10/18/2023,Expense,Discord,Harvey Spector,Tools & Subscription - G&A,9.99,56073287.25
10/18/2023,Expense,Discord,Harvey Spector,Tools & Subscription - G&A,9.99,56073297.24
10/18/2023,Expense,Discord,Harvey Spector,Credit Card - Ramp,9.99,56073307.23
10/18/2023,Expense,Discord,Harvey Spector,Credit Card - Ramp,9.99,56073317.22
10/18/2023,Expense,Reclaim.ai,Max Kausman,Tools & Subscription - G&A,8,56073325.22
10/18/2023,Expense,Discord,Harvey Spector,Tools & Subscription - G&A,9.99,56073335.21
10/18/2023,Expense,Discord,Harvey Spector,Tools & Subscription - G&A,9.99,56073345.2
10/18/2023,Expense,Discord,Harvey Spector,Credit Card - Ramp,9.99,56073355.19
10/18/2023,Expense,Discord,Harvey Spector,Tools & Subscription - G&A,9.99,56073365.18
10/18/2023,Expense,Discord,Harvey Spector,Tools & Subscription - G&A,9.99,56073375.17
10/18/2023,Expense,Discord,Harvey Spector,Tools & Subscription - G&A,9.99,56073385.16
10/18/2023,Expense,Segment,Balapavan Tirumani,Tools & Subscription - G&A,120,56073505.16
10/18/2023,Expense,Discord,Harvey Spector,Tools & Subscription - G&A,9.99,56073515.15
10/18/2023,Expense,Discord,Harvey Spector,Credit Card - Ramp,9.99,56073525.14
10/18/2023,Expense,Reclaim.ai,Max Kausman,Credit Card - Ramp,8,56073533.14
10/18/2023,Expense,Discord,Harvey Spector,Tools & Subscription - G&A,9.99,56073543.13
10/18/2023,Expense,Discord,Harvey Spector,Tools & Subscription - G&A,9.99,56073553.12
10/18/2023,Expense,Discord,Harvey Spector,Credit Card - Ramp,9.99,56073563.11
10/18/2023,Expense,Segment,Balapavan Tirumani,Tools & Subscription - G&A,120,56073683.11
10/18/2023,Expense,Discord,Harvey Spector,Credit Card - Ramp,9.99,56073693.1
10/18/2023,Expense,Discord,Harvey Spector,Credit Card - Ramp,9.99,56073703.09
10/18/2023,Expense,Discord,Harvey Spector,Credit Card - Ramp,9.99,56073713.08
10/18/2023,Expense,Discord,Harvey Spector,Tools & Subscription - G&A,9.99,56073723.07
10/18/2023,Expense,Discord,Harvey Spector,Credit Card - Ramp,9.99,56073733.06
10/18/2023,Expense,Discord,Harvey Spector,Tools & Subscription - G&A,9.99,56073743.05
10/18/2023,Expense,Discord,Harvey Spector,Tools & Subscription - G&A,9.99,56073753.04
10/18/2023,Expense,Discord,Harvey Spector,Tools & Subscription - G&A,9.99,56073763.03
10/18/2023,Expense,Reclaim.ai,Max Kausman,Credit Card - Ramp,8,56073771.03
10/18/2023,Expense,Discord,Harvey Spector,Tools & Subscription - G&A,9.99,56073781.02
10/18/2023,Expense,Discord,Harvey Spector,Tools & Subscription - G&A,9.99,56073791.01
10/18/2023,Expense,Discord,Harvey Spector,Tools & Subscription - G&A,9.99,56073801
10/18/2023,Expense,Discord,Harvey Spector,Tools & Subscription - G&A,9.99,56073810.99
10/18/2023,Expense,Discord,Harvey Spector,Tools & Subscription - G&A,9.99,56073820.98
10/18/2023,Expense,Discord,Harvey Spector,Tools & Subscription - G&A,9.99,56073830.97
10/18/2023,Expense,Discord,Harvey Spector,Credit Card - Ramp,9.99,56073840.96
10/18/2023,Expense,Discord,Harvey Spector,Tools & Subscription - G&A,9.99,56073850.95
10/18/2023,Expense,Discord,Harvey Spector,Tools & Subscription - G&A,9.99,56073860.94
10/18/2023,Expense,Discord,Harvey Spector,Credit Card - Ramp,9.99,56073870.93
10/18/2023,Expense,Discord,Harvey Spector,Credit Card - Ramp,9.99,56073880.92
10/18/2023,Expense,Discord,Harvey Spector,Credit Card - Ramp,9.99,56073890.91
10/18/2023,Expense,Discord,Harvey Spector,Credit Card - Ramp,9.99,56073900.9
10/18/2023,Expense,Discord,Harvey Spector,Credit Card - Ramp,9.99,56073910.89
10/18/2023,Expense,Discord,Harvey Spector,Tools & Subscription - G&A,9.99,56073920.88
10/18/2023,Expense,Discord,Harvey Spector,Tools & Subscription - G&A,9.99,56073930.87
10/18/2023,Expense,Discord,Harvey Spector,Credit Card - Ramp,9.99,56073940.86
10/18/2023,Expense,Segment,Balapavan Tirumani,Credit Card - Ramp,120,56074060.86
10/18/2023,Expense,Discord,Harvey Spector,Tools & Subscription - G&A,9.99,56074070.85
10/18/2023,Expense,Discord,Harvey Spector,Tools & Subscription - G&A,9.99,56074080.84
10/18/2023,Expense,Discord,Harvey Spector,Tools & Subscription - G&A,9.99,56074090.83
10/18/2023,Expense,Reclaim.ai,Max Kausman,Tools & Subscription - G&A,8,56074098.83
10/18/2023,Expense,Reclaim.ai,Max Kausman,Tools & Subscription - G&A,8,56074106.83
10/18/2023,Expense,Segment,Balapavan Tirumani,Credit Card - Ramp,120,56074226.83
10/18/2023,Expense,Segment,Balapavan Tirumani,Tools & Subscription - G&A,120,56074346.83
10/18/2023,Expense,Discord,Harvey Spector,Credit Card - Ramp,9.99,56074356.82
10/18/2023,Expense,Segment,Balapavan Tirumani,Credit Card - Ramp,120,56074476.82
10/18/2023,Expense,Discord,Harvey Spector,Credit Card - Ramp,9.99,56074486.81
10/18/2023,Expense,Discord,Harvey Spector,Tools & Subscription - G&A,9.99,56074496.8
10/19/2023,Expense,Transport for NSW,Mike ross,Travelling Expenses,4.43,56074501.23
10/19/2023,Credit Card Credit,inkle,Harvey Spector,Credit Card - Ramp,-100,56074401.23
10/19/2023,Credit Card Credit,inkle,Harvey Spector,Credit Card - Ramp,-100,56074301.23
10/19/2023,Expense,Transport for NSW,Mike ross,Travelling Expenses,4.43,56074305.66
10/19/2023,Credit Card Credit,inkle,Harvey Spector,Tools & Subscription - G&A,-100,56074205.66
10/19/2023,Expense,Transport for NSW,Mike ross,Credit Card - Ramp,4.43,56074210.09
10/19/2023,Credit Card Credit,inkle,Harvey Spector,Credit Card - Ramp,-100,56074110.09
10/19/2023,Expense,Transport for NSW,Mike ross,Credit Card - Ramp,4.43,56074114.52
10/19/2023,Credit Card Credit,inkle,Harvey Spector,Tools & Subscription - G&A,-100,56074014.52
10/19/2023,Credit Card Credit,inkle,Harvey Spector,Tools & Subscription - G&A,-100,56073914.52
10/19/2023,Expense,Transport for NSW,Mike ross,Credit Card - Ramp,4.43,56073918.95
10/19/2023,Credit Card Credit,inkle,Harvey Spector,Tools & Subscription - G&A,-100,56073818.95
10/19/2023,Expense,Transport for NSW,Mike ross,Travelling Expenses,4.43,56073823.38
10/19/2023,Expense,Transport for NSW,Mike ross,Travelling Expenses,4.43,56073827.81
10/20/2023,Expense,BuildBetter,Max Kausman,Credit Card - Ramp,100,56073927.81
10/20/2023,Expense,RAMP BUSINESS CO,RAMP STATEMENT,Account1,-7657.9,56066269.91
10/20/2023,Expense,BuildBetter,Max Kausman,Tools & Subscription - G&A,100,56066369.91
10/20/2023,Expense,RAMP BUSINESS CO,RAMP STATEMENT,Account1,-7657.9,56058712.01
10/20/2023,Expense,RAMP BUSINESS CO,RAMP STATEMENT,Account1,-7657.9,56051054.11
10/20/2023,Expense,BuildBetter,Max Kausman,Tools & Subscription - G&A,100,56051154.11
10/20/2023,Expense,BuildBetter,Max Kausman,Tools & Subscription - G&A,100,56051254.11
10/20/2023,Expense,RAMP BUSINESS CO,RAMP STATEMENT,Credit Card - Ramp,-7657.9,56043596.21
10/20/2023,Expense,RAMP BUSINESS CO,RAMP STATEMENT,Credit Card - Ramp,-7657.9,56035938.31
10/20/2023,Expense,RAMP BUSINESS CO,RAMP STATEMENT,Credit Card - Ramp,-7657.9,56028280.41
10/20/2023,Expense,RAMP BUSINESS CO,RAMP STATEMENT,Credit Card - Ramp,-7657.9,56020622.51
10/20/2023,Expense,BuildBetter,Max Kausman,Tools & Subscription - G&A,100,56020722.51
10/20/2023,Expense,RAMP BUSINESS CO,RAMP STATEMENT,Account1,-7657.9,56013064.61
10/20/2023,Expense,BuildBetter,Max Kausman,Credit Card - Ramp,100,56013164.61
10/20/2023,Expense,BuildBetter,Max Kausman,Credit Card - Ramp,100,56013264.61
10/21/2023,Expense,Uber,Mike ross,Credit Card - Ramp,8.66,56013273.27
10/21/2023,Expense,Uber,Mike ross,Credit Card - Ramp,9.88,56013283.15
10/21/2023,Expense,Uber,Mike ross,Travelling Expenses,8.66,56013291.81
10/21/2023,Expense,Uber,Mike ross,Credit Card - Ramp,9.88,56013301.69
10/21/2023,Expense,Uber,Mike ross,Travelling Expenses,9.88,56013311.57
10/21/2023,Expense,Uber,Mike ross,Credit Card - Ramp,8.66,56013320.23
10/21/2023,Expense,Uber,Mike ross,Credit Card - Ramp,8.66,56013328.89
10/21/2023,Expense,Uber,Mike ross,Travelling Expenses,8.66,56013337.55
10/21/2023,Expense,Uber,Mike ross,Travelling Expenses,9.88,56013347.43
10/21/2023,Expense,Uber,Mike ross,Travelling Expenses,9.88,56013357.31
10/21/2023,Expense,Uber,Mike ross,Travelling Expenses,8.66,56013365.97
10/21/2023,Expense,Uber,Mike ross,Credit Card - Ramp,9.88,56013375.85
10/21/2023,Expense,Uber,Mike ross,Travelling Expenses,9.88,56013385.73
10/21/2023,Expense,Uber,Mike ross,Travelling Expenses,8.66,56013394.39
10/22/2023,Expense,Uber,Mike ross,Credit Card - Ramp,12.43,56013406.82
10/22/2023,Expense,Uber,Mike ross,Travelling Expenses,12.43,56013419.25
10/22/2023,Expense,Uber,Mike ross,Travelling Expenses,12.43,56013431.68
10/22/2023,Expense,Uber,Mike ross,Travelling Expenses,12.43,56013444.11
10/22/2023,Expense,Uber,Mike ross,Credit Card - Ramp,12.43,56013456.54
10/22/2023,Expense,Uber,Mike ross,Credit Card - Ramp,12.43,56013468.97
10/22/2023,Expense,Uber,Mike ross,Travelling Expenses,12.43,56013481.4
10/23/2023,Expense,Maloneys Grocer,Mike ross,Meals & Entertainment,7.2,56013488.6
10/23/2023,Expense,Maloneys Grocer,Mike ross,Credit Card - Ramp,7.2,56013495.8
10/23/2023,Expense,Officeworks,Mike ross,Credit Card - Ramp,5.84,56013501.64
10/23/2023,Expense,Officeworks,Mike ross,Office expenses,5.84,56013507.48
10/23/2023,Expense,Superhuman,Mike ross,Professional Service Charges,90,56013597.48
10/23/2023,Bill Payment (Check),ANSR Dubai,,HSBC A/c,-10874,56002723.48
10/23/2023,Expense,Heptabase,Mike ross,Tools & Subscription - G&A,9.99,56002733.47
10/23/2023,Expense,Maloneys Grocer,Mike ross,Meals & Entertainment,7.2,56002740.67
10/23/2023,Bill Payment (Check),ANSR Dubai,,HSBC A/c,-10874,55991866.67
10/23/2023,Expense,Superhuman,Mike ross,Credit Card - Ramp,90,55991956.67
10/23/2023,Expense,Officeworks,Mike ross,Credit Card - Ramp,5.84,55991962.51
10/23/2023,Expense,Heptabase,Mike ross,Credit Card - Ramp,9.99,55991972.5
10/23/2023,Expense,Maloneys Grocer,Mike ross,Meals & Entertainment,7.2,55991979.7
10/23/2023,Bill Payment (Check),ANSR Dubai,,HSBC A/c,-10874,55981105.7
10/23/2023,Expense,Maloneys Grocer,Mike ross,Credit Card - Ramp,7.2,55981112.9
10/23/2023,Expense,Officeworks,Mike ross,Office expenses,5.84,55981118.74
10/23/2023,Expense,Superhuman,Mike ross,Professional Service Charges,90,55981208.74
10/23/2023,Expense,Heptabase,Mike ross,Tools & Subscription - G&A,9.99,55981218.73
10/23/2023,Expense,Heptabase,Mike ross,Tools & Subscription - G&A,9.99,55981228.72
10/23/2023,Expense,Superhuman,Mike ross,Credit Card - Ramp,90,55981318.72
10/23/2023,Expense,EntityB,,Bank account - Airwallex,2533,55983851.72
10/23/2023,Expense,Superhuman,Mike ross,Professional Service Charges,90,55983941.72
10/23/2023,Bill Payment (Check),ANSR Dubai,BOOK TRANSFER DEBIT 45BOOK DEBIT CHRONICLEHQ INC.*BNF:ANSR (EMEA) GLOBAL SERVICES LIM ITED*OBI:/INV/ANSREMEA/031*BBI:/DAS/REF:67476Q201W9H*STBOOK*TIME: 0731*YOUR REF:ANSRMEA/031*OUR REF:296463348,Accounts Payable (A/P),-10874,55973067.72
10/23/2023,Expense,Officeworks,Mike ross,Office expenses,5.84,55973073.56
10/23/2023,Expense,EntityB,,General business expenses:Bank fees & service charges,-2533,55970540.56
10/23/2023,Expense,Maloneys Grocer,Mike ross,Credit Card - Ramp,7.2,55970547.76
10/23/2023,Expense,Superhuman,Mike ross,Credit Card - Ramp,90,55970637.76
10/23/2023,Expense,EntityB,,General business expenses:Bank fees & service charges,-2533,55968104.76
10/23/2023,Expense,EntityB,,General business expenses:Bank fees & service charges,-2533,55965571.76
10/23/2023,Expense,EntityB,,General business expenses:Bank fees & service charges,-2533,55963038.76
10/23/2023,Bill Payment (Check),ANSR Dubai,BOOK TRANSFER DEBIT 45BOOK DEBIT CHRONICLEHQ INC.*BNF:ANSR (EMEA) GLOBAL SERVICES LIM ITED*OBI:/INV/ANSREMEA/031*BBI:/DAS/REF:67476Q201W9H*STBOOK*TIME: 0731*YOUR REF:ANSRMEA/031*OUR REF:296463348,Accounts Payable (A/P),-10874,55952164.76
10/23/2023,Bill Payment (Check),ANSR Dubai,,HSBC A/c,-10874,55941290.76
10/23/2023,Bill Payment (Check),ANSR Dubai,BOOK TRANSFER DEBIT 45BOOK DEBIT CHRONICLEHQ INC.*BNF:ANSR (EMEA) GLOBAL SERVICES LIM ITED*OBI:/INV/ANSREMEA/031*BBI:/DAS/REF:67476Q201W9H*STBOOK*TIME: 0731*YOUR REF:ANSRMEA/031*OUR REF:296463348,Accounts Payable (A/P),-10874,55930416.76
10/23/2023,Expense,Superhuman,Mike ross,Credit Card - Ramp,90,55930506.76
10/23/2023,Expense,EntityB,,Bank account - Airwallex,2533,55933039.76
10/23/2023,Expense,EntityB,,Bank account - Airwallex,2533,55935572.76
10/23/2023,Expense,Officeworks,Mike ross,Credit Card - Ramp,5.84,55935578.6
10/23/2023,Expense,Officeworks,Mike ross,Office expenses,5.84,55935584.44
10/23/2023,Expense,Maloneys Grocer,Mike ross,Meals & Entertainment,7.2,55935591.64
10/23/2023,Expense,Officeworks,Mike ross,Credit Card - Ramp,5.84,55935597.48
10/23/2023,Expense,Heptabase,Mike ross,Credit Card - Ramp,9.99,55935607.47
10/23/2023,Expense,Heptabase,Mike ross,Credit Card - Ramp,9.99,55935617.46
10/23/2023,Expense,Heptabase,Mike ross,Tools & Subscription - G&A,9.99,55935627.45
10/23/2023,Expense,Maloneys Grocer,Mike ross,Credit Card - Ramp,7.2,55935634.65
10/23/2023,Bill Payment (Check),ANSR Dubai,BOOK TRANSFER DEBIT 45BOOK DEBIT CHRONICLEHQ INC.*BNF:ANSR (EMEA) GLOBAL SERVICES LIM ITED*OBI:/INV/ANSREMEA/031*BBI:/DAS/REF:67476Q201W9H*STBOOK*TIME: 0731*YOUR REF:ANSRMEA/031*OUR REF:296463348,Accounts Payable (A/P),-10874,55924760.65
10/23/2023,Expense,Superhuman,Mike ross,Professional Service Charges,90,55924850.65
10/23/2023,Expense,EntityB,,Bank account - Airwallex,2533,55927383.65
10/24/2023,Expense,Thebrowser.Com,Harvey Spector,Tools & Subscription - G&A,48,55927431.65
10/24/2023,Expense,Thebrowser.Com,Harvey Spector,Tools & Subscription - G&A,48,55927479.65
10/24/2023,Expense,Maloneys Grocer,Mike ross,Meals & Entertainment,20.92,55927500.57
10/24/2023,Expense,Uber Eats,Mike ross,Credit Card - Ramp,13.13,55927513.7
10/24/2023,Expense,Maloneys Grocer,Mike ross,Credit Card - Ramp,20.92,55927534.62
10/24/2023,Expense,Maloneys Grocer,Mike ross,Credit Card - Ramp,20.92,55927555.54
10/24/2023,Expense,Uber Eats,Mike ross,Credit Card - Ramp,13.13,55927568.67
10/24/2023,Expense,Maloneys Grocer,Mike ross,Meals & Entertainment,20.92,55927589.59
10/24/2023,Expense,Uber Eats,Mike ross,Meals & Entertainment,13.13,55927602.72
10/24/2023,Expense,Maloneys Grocer,Mike ross,Meals & Entertainment,20.92,55927623.64
10/24/2023,Expense,Uber Eats,Mike ross,Meals & Entertainment,13.13,55927636.77
10/24/2023,Expense,Uber Eats,Mike ross,Meals & Entertainment,13.13,55927649.9
10/24/2023,Expense,Thebrowser.Com,Harvey Spector,Tools & Subscription - G&A,48,55927697.9
10/24/2023,Expense,Thebrowser.Com,Harvey Spector,Credit Card - Ramp,48,55927745.9
10/24/2023,Expense,Thebrowser.Com,Harvey Spector,Credit Card - Ramp,48,55927793.9
10/24/2023,Expense,Uber Eats,Mike ross,Meals & Entertainment,13.13,55927807.03
10/24/2023,Expense,Thebrowser.Com,Harvey Spector,Tools & Subscription - G&A,48,55927855.03
10/24/2023,Expense,Maloneys Grocer,Mike ross,Credit Card - Ramp,20.92,55927875.95
10/24/2023,Expense,Uber Eats,Mike ross,Credit Card - Ramp,13.13,55927889.08
10/24/2023,Expense,Thebrowser.Com,Harvey Spector,Credit Card - Ramp,48,55927937.08
10/24/2023,Expense,Maloneys Grocer,Mike ross,Credit Card - Ramp,20.92,55927958
10/24/2023,Expense,Uber Eats,Mike ross,Credit Card - Ramp,13.13,55927971.13
10/24/2023,Expense,Maloneys Grocer,Mike ross,Meals & Entertainment,20.92,55927992.05
10/25/2023,Expense,Careem,Harvey Spector,Credit Card - Ramp,5.33,55927997.38
10/25/2023,Expense,Careem,Harvey Spector,Travelling Expenses,5.33,55928002.71
10/25/2023,Expense,Careem,Harvey Spector,Travelling Expenses,5.33,55928008.04
10/25/2023,Expense,Careem,Harvey Spector,Travelling Expenses,5.33,55928013.37
10/25/2023,Expense,Careem,Harvey Spector,Credit Card - Ramp,5.33,55928018.7
10/25/2023,Expense,Careem,Harvey Spector,Travelling Expenses,5.33,55928024.03
10/25/2023,Expense,Careem,Harvey Spector,Credit Card - Ramp,5.33,55928029.36
10/26/2023,Expense,Dubai Taxi,Harvey Spector,Travelling Expenses,11.08,55928040.44
10/26/2023,Expense,Namecheap,Harvey Spector,Credit Card - Ramp,17.16,55928057.6
10/26/2023,Expense,AutoGrill,Harvey Spector,Credit Card - Ramp,16.83,55928074.43
10/26/2023,Expense,Namecheap,Harvey Spector,Tools & Subscription - G&A,17.16,55928091.59
10/26/2023,Expense,Dubai Taxi,Harvey Spector,Travelling Expenses,11.08,55928102.67
10/26/2023,Expense,AutoGrill,Harvey Spector,Meals & Entertainment,16.83,55928119.5
10/26/2023,Expense,Namecheap,Harvey Spector,Credit Card - Ramp,17.16,55928136.66
10/26/2023,Expense,Namecheap,Harvey Spector,Tools & Subscription - G&A,17.16,55928153.82
10/26/2023,Expense,Dubai Taxi,Harvey Spector,Credit Card - Ramp,11.08,55928164.9
10/26/2023,Expense,Namecheap,Harvey Spector,Credit Card - Ramp,17.16,55928182.06
10/26/2023,Expense,Dubai Taxi,Harvey Spector,Travelling Expenses,11.08,55928193.14
10/26/2023,Expense,Namecheap,Harvey Spector,Tools & Subscription - G&A,17.16,55928210.3
10/26/2023,Expense,AutoGrill,Harvey Spector,Meals & Entertainment,16.83,55928227.13
10/26/2023,Expense,AutoGrill,Harvey Spector,Meals & Entertainment,16.83,55928243.96
10/26/2023,Expense,Dubai Taxi,Harvey Spector,Credit Card - Ramp,11.08,55928255.04
10/26/2023,Expense,AutoGrill,Harvey Spector,Meals & Entertainment,16.83,55928271.87
10/26/2023,Expense,Dubai Taxi,Harvey Spector,Travelling Expenses,11.08,55928282.95
10/26/2023,Expense,Dubai Taxi,Harvey Spector,Credit Card - Ramp,11.08,55928294.03
10/26/2023,Expense,AutoGrill,Harvey Spector,Credit Card - Ramp,16.83,55928310.86
10/26/2023,Expense,AutoGrill,Harvey Spector,Credit Card - Ramp,16.83,55928327.69
10/26/2023,Expense,AutoGrill,Harvey Spector,Credit Card - Ramp,16.83,55928344.52
10/26/2023,Expense,Namecheap,Harvey Spector,Tools & Subscription - G&A,17.16,55928361.68
10/27/2023,Expense,Splitbee,Harris Jose,Tools & Subscription - G&A,16.52,55928378.2
10/27/2023,Expense,Sendinblue,Balapavan Tirumani,Tools & Subscription - G&A,78.38,55928456.58
10/27/2023,Expense,Sendinblue,Balapavan Tirumani,Credit Card - Ramp,78.38,55928534.96
10/27/2023,Expense,The Carrington,Mike ross,Meals & Entertainment,23.72,55928558.68
10/27/2023,Expense,Splitbee,Harris Jose,Tools & Subscription - G&A,16.52,55928575.2
10/27/2023,Expense,Sendinblue,Balapavan Tirumani,Tools & Subscription - G&A,78.38,55928653.58
10/27/2023,Expense,Sentry,Balapavan Tirumani,Tools & Subscription - G&A,29,55928682.58
10/27/2023,Expense,Sentry,Balapavan Tirumani,Tools & Subscription - G&A,29,55928711.58
10/27/2023,Expense,Sendinblue,Balapavan Tirumani,Credit Card - Ramp,78.38,55928789.96
10/27/2023,Expense,Splitbee,Harris Jose,Credit Card - Ramp,16.52,55928806.48
10/27/2023,Expense,Sentry,Balapavan Tirumani,Credit Card - Ramp,29,55928835.48
10/27/2023,Expense,Sendinblue,Balapavan Tirumani,Tools & Subscription - G&A,78.38,55928913.86
10/27/2023,Expense,The Carrington,Mike ross,Meals & Entertainment,23.72,55928937.58
10/27/2023,Expense,The Carrington,Mike ross,Meals & Entertainment,23.72,55928961.3
10/27/2023,Expense,Sendinblue,Balapavan Tirumani,Credit Card - Ramp,78.38,55929039.68
10/27/2023,Expense,The Carrington,Mike ross,Credit Card - Ramp,23.72,55929063.4
10/27/2023,Expense,Sentry,Balapavan Tirumani,Credit Card - Ramp,29,55929092.4
10/27/2023,Expense,Splitbee,Harris Jose,Tools & Subscription - G&A,16.52,55929108.92
10/27/2023,Expense,The Carrington,Mike ross,Meals & Entertainment,23.72,55929132.64
10/27/2023,Expense,Splitbee,Harris Jose,Credit Card - Ramp,16.52,55929149.16
10/27/2023,Expense,Sentry,Balapavan Tirumani,Tools & Subscription - G&A,29,55929178.16
10/27/2023,Expense,Splitbee,Harris Jose,Tools & Subscription - G&A,16.52,55929194.68
10/27/2023,Expense,Sendinblue,Balapavan Tirumani,Tools & Subscription - G&A,78.38,55929273.06
10/27/2023,Expense,Sentry,Balapavan Tirumani,Credit Card - Ramp,29,55929302.06
10/27/2023,Expense,The Carrington,Mike ross,Credit Card - Ramp,23.72,55929325.78
10/27/2023,Expense,The Carrington,Mike ross,Credit Card - Ramp,23.72,55929349.5
10/27/2023,Expense,The Carrington,Mike ross,Credit Card - Ramp,23.72,55929373.22
10/27/2023,Expense,Sentry,Balapavan Tirumani,Tools & Subscription - G&A,29,55929402.22
10/27/2023,Expense,Splitbee,Harris Jose,Credit Card - Ramp,16.52,55929418.74
10/28/2023,Expense,Uber,Mike ross,Travelling Expenses,41.13,55929459.87
10/28/2023,Expense,Uber,Mike ross,Credit Card - Ramp,41.13,55929501
10/28/2023,Expense,Uber,Mike ross,Credit Card - Ramp,41.13,55929542.13
10/28/2023,Expense,Github,Balapavan Tirumani,Tools & Subscription - G&A,44,55929586.13
10/28/2023,Expense,Uber,Mike ross,Travelling Expenses,41.13,55929627.26
10/28/2023,Expense,Github,Balapavan Tirumani,Tools & Subscription - G&A,10,55929637.26
10/28/2023,Expense,Github,Balapavan Tirumani,Tools & Subscription - G&A,44,55929681.26
10/28/2023,Expense,Github,Balapavan Tirumani,Credit Card - Ramp,10,55929691.26
10/28/2023,Expense,Uber,Mike ross,Credit Card - Ramp,41.13,55929732.39
10/28/2023,Expense,Github,Balapavan Tirumani,Credit Card - Ramp,10,55929742.39
10/28/2023,Expense,Github,Balapavan Tirumani,Tools & Subscription - G&A,10,55929752.39
10/28/2023,Expense,Github,Balapavan Tirumani,Credit Card - Ramp,44,55929796.39
10/28/2023,Expense,Github,Balapavan Tirumani,Tools & Subscription - G&A,44,55929840.39
10/28/2023,Expense,Uber,Mike ross,Travelling Expenses,41.13,55929881.52
10/28/2023,Expense,Github,Balapavan Tirumani,Tools & Subscription - G&A,10,55929891.52
10/28/2023,Expense,Github,Balapavan Tirumani,Tools & Subscription - G&A,10,55929901.52
10/28/2023,Expense,Uber,Mike ross,Travelling Expenses,41.13,55929942.65
10/28/2023,Expense,Github,Balapavan Tirumani,Tools & Subscription - G&A,44,55929986.65
10/28/2023,Expense,Github,Balapavan Tirumani,Credit Card - Ramp,10,55929996.65
10/28/2023,Expense,Github,Balapavan Tirumani,Credit Card - Ramp,44,55930040.65
10/28/2023,Expense,Github,Balapavan Tirumani,Credit Card - Ramp,44,55930084.65
10/29/2023,Expense,Netlify,Balapavan Tirumani,Tools & Subscription - G&A,19,55930103.65
10/29/2023,Expense,Airport Service,Harvey Spector,Travelling Expenses,68.24,55930171.89
10/29/2023,Expense,Netlify,Balapavan Tirumani,Credit Card - Ramp,19,55930190.89
10/29/2023,Expense,The New York Times,Mike ross,General business expenses:Memberships & subscriptions,7.88,55930198.77
10/29/2023,Expense,Netlify,Balapavan Tirumani,Tools & Subscription - G&A,19,55930217.77
10/29/2023,Expense,Uber,Mike ross,Travelling Expenses,40.28,55930258.05
10/29/2023,Expense,Airport Service,Harvey Spector,Credit Card - Ramp,68.24,55930326.29
10/29/2023,Expense,Uber,Mike ross,Credit Card - Ramp,40.28,55930366.57
10/29/2023,Expense,Airport Service,Harvey Spector,Travelling Expenses,68.24,55930434.81
10/29/2023,Expense,Airport Service,Harvey Spector,Credit Card - Ramp,68.24,55930503.05
10/29/2023,Expense,Netlify,Balapavan Tirumani,Credit Card - Ramp,19,55930522.05
10/29/2023,Expense,Uber,Mike ross,Travelling Expenses,40.28,55930562.33
10/29/2023,Expense,The New York Times,Mike ross,General business expenses:Memberships & subscriptions,7.88,55930570.21
10/29/2023,Expense,Uber,Mike ross,Credit Card - Ramp,40.28,55930610.49
10/29/2023,Expense,Uber,Mike ross,Credit Card - Ramp,40.28,55930650.77
10/29/2023,Expense,The New York Times,Mike ross,Credit Card - Ramp,7.88,55930658.65
10/29/2023,Expense,The New York Times,Mike ross,Credit Card - Ramp,7.88,55930666.53
10/29/2023,Expense,The New York Times,Mike ross,Credit Card - Ramp,7.88,55930674.41
10/29/2023,Expense,Netlify,Balapavan Tirumani,Credit Card - Ramp,19,55930693.41
10/29/2023,Expense,The New York Times,Mike ross,Credit Card - Ramp,7.88,55930701.29
10/29/2023,Expense,The New York Times,Mike ross,General business expenses:Memberships & subscriptions,7.88,55930709.17
10/29/2023,Expense,Airport Service,Harvey Spector,Travelling Expenses,68.24,55930777.41
10/29/2023,Expense,Netlify,Balapavan Tirumani,Tools & Subscription - G&A,19,55930796.41
10/29/2023,Expense,Netlify,Balapavan Tirumani,Tools & Subscription - G&A,19,55930815.41
10/29/2023,Expense,Airport Service,Harvey Spector,Travelling Expenses,68.24,55930883.65
10/29/2023,Expense,Uber,Mike ross,Travelling Expenses,40.28,55930923.93
10/29/2023,Expense,The New York Times,Mike ross,General business expenses:Memberships & subscriptions,7.88,55930931.81
10/29/2023,Expense,Uber,Mike ross,Travelling Expenses,40.28,55930972.09
10/29/2023,Expense,Airport Service,Harvey Spector,Credit Card - Ramp,68.24,55931040.33
10/30/2023,Expense,Uber,Mike ross,Travelling Expenses,15.63,55931055.96
10/30/2023,Expense,Uber,Mike ross,Credit Card - Ramp,15.63,55931071.59
10/30/2023,Expense,Uber,Mike ross,Travelling Expenses,15.63,55931087.22
10/30/2023,Expense,Uber,Mike ross,Credit Card - Ramp,15.63,55931102.85
10/30/2023,Expense,Uber,Mike ross,Credit Card - Ramp,15.63,55931118.48
10/30/2023,Expense,Uber,Mike ross,Travelling Expenses,15.63,55931134.11
10/30/2023,Expense,Uber,Mike ross,Travelling Expenses,15.63,55931149.74
10/31/2023,Expense,inkle,Harvey Spector,Tools & Subscription - G&A,30,55931179.74
10/31/2023,Expense,Raycast,Harvey Spector,Tools & Subscription - G&A,20,55931199.74
10/31/2023,Expense,inkle,Harvey Spector,Tools & Subscription - G&A,30,55931229.74
10/31/2023,Expense,inkle,Harvey Spector,Tools & Subscription - G&A,30,55931259.74
10/31/2023,Bill,Big Company ,,Outsources Services - India,29424,55960683.74
10/31/2023,Expense,inkle,Harvey Spector,Credit Card - Ramp,30,55960713.74
10/31/2023,Expense,Raycast,Harvey Spector,Credit Card - Ramp,20,55960733.74
10/31/2023,Expense,Adobe,Mike ross,Tools & Subscription - S&M,19.08,55960752.82
10/31/2023,Expense,Raycast,Harvey Spector,Tools & Subscription - G&A,20,55960772.82
10/31/2023,Expense,Adobe,Mike ross,Credit Card - Ramp,19.08,55960791.9
10/31/2023,Expense,Adobe,Mike ross,Tools & Subscription - S&M,19.08,55960810.98
10/31/2023,Expense,inkle,Harvey Spector,Tools & Subscription - G&A,30,55960840.98
10/31/2023,Expense,Raycast,Harvey Spector,Tools & Subscription - G&A,20,55960860.98
10/31/2023,Expense,Raycast,Harvey Spector,Tools & Subscription - G&A,20,55960880.98
10/31/2023,Bill,Big Company ,,Outsources Services - India,29424,55990304.98
10/31/2023,Expense,Adobe,Mike ross,Tools & Subscription - S&M,19.08,55990324.06
10/31/2023,Expense,inkle,Harvey Spector,Credit Card - Ramp,30,55990354.06
10/31/2023,Expense,Raycast,Harvey Spector,Credit Card - Ramp,20,55990374.06
10/31/2023,Bill,Big Company ,"Service Expenses for the month of October 2023 
INR   24,49,867   @ 83.2621",Accounts Payable (A/P),29424,56019798.06
10/31/2023,Expense,Adobe,Mike ross,Credit Card - Ramp,19.08,56019817.14
10/31/2023,Expense,inkle,Harvey Spector,Credit Card - Ramp,30,56019847.14
10/31/2023,Bill,Big Company ,"Service Expenses for the month of October 2023 
INR   24,49,867   @ 83.2621",Accounts Payable (A/P),29424,56049271.14
10/31/2023,Expense,Adobe,Mike ross,Tools & Subscription - S&M,19.08,56049290.22
10/31/2023,Bill,Big Company ,"Service Expenses for the month of October 2023 
INR   24,49,867   @ 83.2621",Accounts Payable (A/P),29424,56078714.22
10/31/2023,Bill,Big Company ,,Outsources Services - India,29424,56108138.22
10/31/2023,Expense,Raycast,Harvey Spector,Credit Card - Ramp,20,56108158.22
10/31/2023,Bill,Big Company ,,Outsources Services - India,29424,56137582.22
10/31/2023,Expense,Adobe,Mike ross,Credit Card - Ramp,19.08,56137601.3
10/31/2023,Bill,Big Company ,"Service Expenses for the month of October 2023 
INR   24,49,867   @ 83.2621",Accounts Payable (A/P),29424,56167025.3
11/01/2023,Expense,Render,Balapavan Tirumani,Credit Card - Ramp,287.05,56167312.35
11/01/2023,Expense,KAWA,Max Kausman,Credit Card - Ramp,5.72,56167318.07
11/01/2023,Expense,Google G Suite,Mike ross,Tools & Subscription - G&A,111.87,56167429.94
11/01/2023,Expense,101domain,Harvey Spector,Office expenses:Office supplies,316.04,56167745.98
11/01/2023,Expense,Ubigi,Mike ross,Credit Card - Ramp,17.97,56167763.95
11/01/2023,Expense,Ubigi,Mike ross,Office expenses:Office supplies,17.97,56167781.92
11/01/2023,Expense,Google G Suite,Mike ross,Credit Card - Ramp,111.87,56167893.79
11/01/2023,Expense,Render,Balapavan Tirumani,Credit Card - Ramp,287.05,56168180.84
11/01/2023,Expense,Google G Suite,Mike ross,Tools & Subscription - G&A,111.87,56168292.71
11/01/2023,Expense,Ubigi,Mike ross,Office expenses:Office supplies,17.97,56168310.68
11/01/2023,Expense,KAWA,Max Kausman,Meals & Entertainment,5.72,56168316.4
11/01/2023,Expense,101domain,Harvey Spector,Credit Card - Ramp,316.04,56168632.44
11/01/2023,Expense,101domain,Harvey Spector,Credit Card - Ramp,316.04,56168948.48
11/01/2023,Expense,KAWA,Max Kausman,Credit Card - Ramp,5.72,56168954.2
11/01/2023,Expense,Google G Suite,Mike ross,Credit Card - Ramp,111.87,56169066.07
11/01/2023,Expense,101domain,Harvey Spector,Credit Card - Ramp,316.04,56169382.11
11/01/2023,Expense,Ubigi,Mike ross,Credit Card - Ramp,17.97,56169400.08
11/01/2023,Expense,101domain,Harvey Spector,Office expenses:Office supplies,316.04,56169716.12
11/01/2023,Expense,Render,Balapavan Tirumani,Tools & Subscription - G&A,287.05,56170003.17
11/01/2023,Expense,Render,Balapavan Tirumani,Credit Card - Ramp,287.05,56170290.22
11/01/2023,Expense,Render,Balapavan Tirumani,Tools & Subscription - G&A,287.05,56170577.27
11/01/2023,Expense,Google G Suite,Mike ross,Tools & Subscription - G&A,111.87,56170689.14
11/01/2023,Expense,Google G Suite,Mike ross,Credit Card - Ramp,111.87,56170801.01
11/01/2023,Expense,101domain,Harvey Spector,Office expenses:Office supplies,316.04,56171117.05
11/01/2023,Expense,Render,Balapavan Tirumani,Tools & Subscription - G&A,287.05,56171404.1
11/01/2023,Expense,Ubigi,Mike ross,Credit Card - Ramp,17.97,56171422.07
11/01/2023,Expense,Render,Balapavan Tirumani,Tools & Subscription - G&A,287.05,56171709.12
11/01/2023,Expense,Ubigi,Mike ross,Office expenses:Office supplies,17.97,56171727.09
11/01/2023,Expense,KAWA,Max Kausman,Credit Card - Ramp,5.72,56171732.81
11/01/2023,Expense,KAWA,Max Kausman,Credit Card - Ramp,5.72,56171738.53
11/01/2023,Expense,KAWA,Max Kausman,Meals & Entertainment,5.72,56171744.25
11/01/2023,Expense,Google G Suite,Mike ross,Tools & Subscription - G&A,111.87,56171856.12
11/01/2023,Expense,101domain,Harvey Spector,Credit Card - Ramp,316.04,56172172.16
11/01/2023,Expense,KAWA,Max Kausman,Meals & Entertainment,5.72,56172177.88
11/01/2023,Expense,Ubigi,Mike ross,Credit Card - Ramp,17.97,56172195.85
11/01/2023,Expense,101domain,Harvey Spector,Office expenses:Office supplies,316.04,56172511.89
11/01/2023,Expense,KAWA,Max Kausman,Meals & Entertainment,5.72,56172517.61
11/01/2023,Expense,Ubigi,Mike ross,Office expenses:Office supplies,17.97,56172535.58
11/02/2023,Deposit,,Interest Accrual INTEREST,Savings (6977),0.49,56172536.07
11/02/2023,Deposit,,Savings Interest,Interest Received,1.08,56172537.15
11/02/2023,Deposit,,Interest Accrual INTEREST,Interest Received,0.49,56172537.64
11/02/2023,Deposit,,Savings Interest,Savings (6977),1.08,56172538.72
11/02/2023,Deposit,,Interest Accrual INTEREST,Savings (6977),0.49,56172539.21
11/02/2023,Expense,Careem,Harvey Spector,Credit Card - Ramp,17.08,56172556.29
11/02/2023,Expense,Careem,Harvey Spector,Travelling Expenses,17.08,56172573.37
11/02/2023,Expense,June,Balapavan Tirumani,Tools & Subscription - G&A,149,56172722.37
11/02/2023,Expense,Careem,Harvey Spector,Travelling Expenses,17.08,56172739.45
11/02/2023,Deposit,,Savings Interest,Savings (6977),1.08,56172740.53
11/02/2023,Deposit,,Savings Interest,Interest Received,1.08,56172741.61
11/02/2023,Deposit,,Savings Interest,Interest Received,1.08,56172742.69
11/02/2023,Expense,June,Balapavan Tirumani,Credit Card - Ramp,149,56172891.69
11/02/2023,Expense,June,Balapavan Tirumani,Tools & Subscription - G&A,149,56173040.69
11/02/2023,Expense,June,Balapavan Tirumani,Tools & Subscription - G&A,149,56173189.69
11/02/2023,Expense,Careem,Harvey Spector,Credit Card - Ramp,17.08,56173206.77
11/02/2023,Deposit,,Interest Accrual INTEREST,Savings (6977),0.49,56173207.26
11/02/2023,Deposit,,Interest Accrual INTEREST,Interest Received,0.49,56173207.75
11/02/2023,Deposit,,Interest Accrual INTEREST,Interest Received,0.49,56173208.24
11/02/2023,Deposit,,Savings Interest,Savings (6977),1.08,56173209.32
11/02/2023,Deposit,,Interest Accrual INTEREST,Interest Received,0.49,56173209.81
11/02/2023,Expense,June,Balapavan Tirumani,Tools & Subscription - G&A,149,56173358.81
11/02/2023,Expense,Careem,Harvey Spector,Credit Card - Ramp,17.08,56173375.89
11/02/2023,Expense,Careem,Harvey Spector,Travelling Expenses,17.08,56173392.97
11/02/2023,Expense,June,Balapavan Tirumani,Credit Card - Ramp,149,56173541.97
11/02/2023,Expense,Careem,Harvey Spector,Travelling Expenses,17.08,56173559.05
11/02/2023,Expense,June,Balapavan Tirumani,Credit Card - Ramp,149,56173708.05
11/02/2023,Deposit,,Savings Interest,Interest Received,1.08,56173709.13
11/03/2023,Expense,Coda,Harvey Spector,Tools & Subscription - G&A,12,56173721.13
11/03/2023,Expense,Coda,Harvey Spector,Credit Card - Ramp,12,56173733.13
11/03/2023,Expense,Amazon Web Services,Balapavan Tirumani,Tools & Subscription - G&A,45.12,56173778.25
11/03/2023,Expense,Amazon Web Services,Balapavan Tirumani,Credit Card - Ramp,45.12,56173823.37
11/03/2023,Expense,Coda,Harvey Spector,Credit Card - Ramp,12,56173835.37
11/03/2023,Expense,Amazon Web Services,Balapavan Tirumani,Tools & Subscription - G&A,45.12,56173880.49
11/03/2023,Expense,Amazon Web Services,Balapavan Tirumani,Tools & Subscription - G&A,45.12,56173925.61
11/03/2023,Expense,Coda,Harvey Spector,Tools & Subscription - G&A,12,56173937.61
11/03/2023,Expense,Coda,Harvey Spector,Tools & Subscription - G&A,12,56173949.61
11/03/2023,Expense,Amazon Web Services,Balapavan Tirumani,Tools & Subscription - G&A,45.12,56173994.73
11/03/2023,Expense,Coda,Harvey Spector,Tools & Subscription - G&A,12,56174006.73
11/03/2023,Expense,Amazon Web Services,Balapavan Tirumani,Credit Card - Ramp,45.12,56174051.85
11/03/2023,Expense,Coda,Harvey Spector,Credit Card - Ramp,12,56174063.85
11/03/2023,Expense,Amazon Web Services,Balapavan Tirumani,Credit Card - Ramp,45.12,56174108.97
11/04/2023,Expense,Noahpinion,Max Kausman,Credit Card - Ramp,5.38,56174114.35
11/04/2023,Expense,OpenAI,Mike ross,Credit Card - Ramp,20,56174134.35
11/04/2023,Expense,OpenAI,Mike ross,Tools & Subscription - G&A,20,56174154.35
11/04/2023,Expense,Noahpinion,Max Kausman,Tools & Subscription - S&M,5.38,56174159.73
11/04/2023,Expense,Noahpinion,Max Kausman,Tools & Subscription - S&M,5.38,56174165.11
11/04/2023,Expense,OpenAI,Mike ross,Credit Card - Ramp,20,56174185.11
11/04/2023,Expense,OpenAI,Mike ross,Tools & Subscription - G&A,20,56174205.11
11/04/2023,Expense,OpenAI,Mike ross,Tools & Subscription - G&A,20,56174225.11
11/04/2023,Expense,Noahpinion,Max Kausman,Tools & Subscription - S&M,5.38,56174230.49
11/04/2023,Expense,Noahpinion,Max Kausman,Credit Card - Ramp,5.38,56174235.87
11/04/2023,Expense,Noahpinion,Max Kausman,Credit Card - Ramp,5.38,56174241.25
11/04/2023,Expense,OpenAI,Mike ross,Credit Card - Ramp,20,56174261.25
11/04/2023,Expense,Noahpinion,Max Kausman,Tools & Subscription - S&M,5.38,56174266.63
11/04/2023,Expense,OpenAI,Mike ross,Tools & Subscription - G&A,20,56174286.63
11/05/2023,Expense,OpenAI,Harvey Spector,Credit Card - Ramp,20,56174306.63
11/05/2023,Expense,OpenAI,Harvey Spector,Tools & Subscription - G&A,20,56174326.63
11/05/2023,Expense,OpenAI,Harvey Spector,Tools & Subscription - G&A,20,56174346.63
11/05/2023,Expense,OpenAI,Harvey Spector,Tools & Subscription - G&A,20,56174366.63
11/05/2023,Expense,OpenAI,Harvey Spector,Credit Card - Ramp,20,56174386.63
11/05/2023,Expense,OpenAI,Harvey Spector,Tools & Subscription - G&A,20,56174406.63
11/05/2023,Expense,OpenAI,Harvey Spector,Credit Card - Ramp,20,56174426.63
11/06/2023,Bill Payment (Check),EntityA,,Bank account - Airwallex,-506176.07,55668250.56
11/06/2023,Bill Payment (Check),EntityA,Exchange Gain Or Loss,Bank account - Airwallex,-6176.07,55662074.49
11/06/2023,Expense,Adobe,Mike ross,Tools & Subscription - S&M,81.95,55662156.44
11/06/2023,Bill Payment (Check),EntityA,,Account2,-500000,55162156.44
11/06/2023,Expense,Careem,Harvey Spector,Travelling Expenses,4.2,55162160.64
11/06/2023,Transfer,,ServiceB,Bank account - Airwallex,-500000,54662160.64
11/06/2023,Transfer,,PaymentServiceB Savings **6977,Savings (6977),500000,55162160.64
11/06/2023,Bill Payment (Check),EntityA,Exchange Gain Or Loss,Bank account - Airwallex,-6176.07,55155984.57
11/06/2023,Transfer,,PaymentServiceB Savings **6977,Account1,-500000,54655984.57
11/06/2023,Bill Payment (Check),EntityA,,Bank account - Airwallex,-506176.07,54149808.5
11/06/2023,Expense,Careem,Harvey Spector,Credit Card - Ramp,4.2,54149812.7
11/06/2023,Expense,Careem,Harvey Spector,Travelling Expenses,4.2,54149816.9
11/06/2023,Expense,OpenAI,Harvey Spector,Credit Card - Ramp,20,54149836.9
11/06/2023,Expense,VirtualPostMail,Harvey Spector,General business expenses:Memberships & subscriptions,50,54149886.9
11/06/2023,Transfer,,ServiceB,Account1,500000,54649886.9
11/06/2023,Transfer,,PaymentServiceB Savings **6977,Account1,-500000,54149886.9
11/06/2023,Expense,Adobe,Mike ross,Credit Card - Ramp,81.95,54149968.85
11/06/2023,Expense,VirtualPostMail,Harvey Spector,Credit Card - Ramp,50,54150018.85
11/06/2023,Expense,VirtualPostMail,Harvey Spector,Credit Card - Ramp,50,54150068.85
11/06/2023,Expense,VirtualPostMail,Harvey Spector,Credit Card - Ramp,50,54150118.85
11/06/2023,Expense,Adobe,Mike ross,Credit Card - Ramp,81.95,54150200.8
11/06/2023,Expense,OpenAI,Harvey Spector,Credit Card - Ramp,20,54150220.8
11/06/2023,Expense,Careem,Harvey Spector,Credit Card - Ramp,4.2,54150225
11/06/2023,Bill Payment (Check),EntityA,,Bank account - Airwallex,-506176.07,53644048.93
11/06/2023,Transfer,,PaymentServiceB Savings **6977,Savings (6977),500000,54144048.93
11/06/2023,Expense,Adobe,Mike ross,Tools & Subscription - S&M,81.95,54144130.88
11/06/2023,Transfer,,ServiceB,Bank account - Airwallex,-500000,53644130.88
11/06/2023,Expense,VirtualPostMail,Harvey Spector,General business expenses:Memberships & subscriptions,50,53644180.88
11/06/2023,Transfer,,PaymentServiceB Savings **6977,Savings (6977),500000,54144180.88
11/06/2023,Bill Payment (Check),EntityA,,Bank account - Airwallex,-506176.07,53638004.81
11/06/2023,Transfer,,PaymentServiceB Savings **6977,Account1,-500000,53138004.81
11/06/2023,Expense,Adobe,Mike ross,Credit Card - Ramp,81.95,53138086.76
11/06/2023,Expense,OpenAI,Harvey Spector,Tools & Subscription - G&A,20,53138106.76
11/06/2023,Expense,VirtualPostMail,Harvey Spector,General business expenses:Memberships & subscriptions,50,53138156.76
11/06/2023,Expense,OpenAI,Harvey Spector,Tools & Subscription - G&A,20,53138176.76
11/06/2023,Expense,Adobe,Mike ross,Tools & Subscription - S&M,81.95,53138258.71
11/06/2023,Expense,Careem,Harvey Spector,Travelling Expenses,4.2,53138262.91
11/06/2023,Expense,VirtualPostMail,Harvey Spector,General business expenses:Memberships & subscriptions,50,53138312.91
11/06/2023,Expense,Adobe,Mike ross,Tools & Subscription - S&M,81.95,53138394.86
11/06/2023,Expense,Careem,Harvey Spector,Travelling Expenses,4.2,53138399.06
11/06/2023,Transfer,,ServiceB,Bank account - Airwallex,-500000,52638399.06
11/06/2023,Transfer,,ServiceB,Account1,500000,53138399.06
11/06/2023,Bill Payment (Check),EntityA,,Account2,-500000,52638399.06
11/06/2023,Bill Payment (Check),EntityA,,Account2,-500000,52138399.06
11/06/2023,Transfer,,ServiceB,Account1,500000,52638399.06
11/06/2023,Bill Payment (Check),EntityA,,Account2,-500000,52138399.06
11/06/2023,Bill Payment (Check),EntityA,Exchange Gain Or Loss,Bank account - Airwallex,-6176.07,52132222.99
11/06/2023,Transfer,,PaymentServiceB Savings **6977,Account1,-500000,51632222.99
11/06/2023,Expense,Careem,Harvey Spector,Credit Card - Ramp,4.2,51632227.19
11/06/2023,Expense,VirtualPostMail,Harvey Spector,Credit Card - Ramp,50,51632277.19
11/06/2023,Expense,OpenAI,Harvey Spector,Tools & Subscription - G&A,20,51632297.19
11/06/2023,Expense,OpenAI,Harvey Spector,Credit Card - Ramp,20,51632317.19
11/06/2023,Transfer,,ServiceB,Account1,500000,52132317.19
11/06/2023,Transfer,,PaymentServiceB Savings **6977,Savings (6977),500000,52632317.19
11/06/2023,Transfer,,ServiceB,Bank account - Airwallex,-500000,52132317.19
11/06/2023,Expense,OpenAI,Harvey Spector,Tools & Subscription - G&A,20,52132337.19
11/07/2023,Expense,ByteSIM,Mike ross,Tools & Subscription - G&A,24.6,52132361.79
11/07/2023,Expense,Supabase,Harris Jose,Tools & Subscription - G&A,25,52132386.79
11/07/2023,Expense,Careem,Harvey Spector,Travelling Expenses,18.43,52132405.22
11/07/2023,Expense,ByteSIM,Mike ross,Tools & Subscription - G&A,24.6,52132429.82
11/07/2023,Expense,Supabase,Harris Jose,Tools & Subscription - G&A,25,52132454.82
11/07/2023,Expense,Careem,Harvey Spector,Credit Card - Ramp,18.43,52132473.25
11/07/2023,Expense,Careem,Harvey Spector,Credit Card - Ramp,18.43,52132491.68
11/07/2023,Expense,ByteSIM,Mike ross,Tools & Subscription - G&A,24.6,52132516.28
11/07/2023,Expense,Careem,Harvey Spector,Travelling Expenses,18.43,52132534.71
11/07/2023,Expense,Supabase,Harris Jose,Credit Card - Ramp,25,52132559.71
11/07/2023,Expense,Supabase,Harris Jose,Credit Card - Ramp,25,52132584.71
11/07/2023,Expense,Supabase,Harris Jose,Tools & Subscription - G&A,25,52132609.71
11/07/2023,Expense,Careem,Harvey Spector,Travelling Expenses,18.43,52132628.14
11/07/2023,Expense,ByteSIM,Mike ross,Tools & Subscription - G&A,24.6,52132652.74
11/07/2023,Expense,Supabase,Harris Jose,Tools & Subscription - G&A,25,52132677.74
11/07/2023,Expense,Careem,Harvey Spector,Travelling Expenses,18.43,52132696.17
11/07/2023,Expense,Careem,Harvey Spector,Credit Card - Ramp,18.43,52132714.6
11/07/2023,Expense,Supabase,Harris Jose,Credit Card - Ramp,25,52132739.6
11/07/2023,Expense,ByteSIM,Mike ross,Credit Card - Ramp,24.6,52132764.2
11/07/2023,Expense,ByteSIM,Mike ross,Credit Card - Ramp,24.6,52132788.8
11/07/2023,Expense,ByteSIM,Mike ross,Credit Card - Ramp,24.6,52132813.4
11/08/2023,Expense,Mecca Coffee Roasters Restaurant,Max Kausman,Credit Card - Ramp,8.09,52132821.49
11/08/2023,Expense,Computer Bookshop India,Anik Das,Credit Card - Ramp,21.93,52132843.42
11/08/2023,Expense,Computer Bookshop India,Anik Das,General business expenses:Memberships & subscriptions,21.93,52132865.35
11/08/2023,Expense,Mecca Coffee Roasters Restaurant,Max Kausman,Credit Card - Ramp,8.09,52132873.44
11/08/2023,Expense,Computer Bookshop India,Anik Das,Credit Card - Ramp,21.93,52132895.37
11/08/2023,Expense,Heroku,Balapavan Tirumani,Tools & Subscription - S&M,85,52132980.37
11/08/2023,Expense,Computer Bookshop India,Anik Das,Credit Card - Ramp,21.93,52133002.3
11/08/2023,Expense,Computer Bookshop India,Anik Das,General business expenses:Memberships & subscriptions,21.93,52133024.23
11/08/2023,Expense,Heroku,Balapavan Tirumani,Credit Card - Ramp,85,52133109.23
11/08/2023,Expense,Heroku,Balapavan Tirumani,Credit Card - Ramp,85,52133194.23
11/08/2023,Expense,Heroku,Balapavan Tirumani,Tools & Subscription - S&M,85,52133279.23
11/08/2023,Expense,Mecca Coffee Roasters Restaurant,Max Kausman,Credit Card - Ramp,8.09,52133287.32
11/08/2023,Expense,Heroku,Balapavan Tirumani,Credit Card - Ramp,85,52133372.32
11/08/2023,Expense,Mecca Coffee Roasters Restaurant,Max Kausman,Meals & Entertainment,8.09,52133380.41
11/08/2023,Expense,Mecca Coffee Roasters Restaurant,Max Kausman,Credit Card - Ramp,8.09,52133388.5
11/08/2023,Expense,Mecca Coffee Roasters Restaurant,Max Kausman,Meals & Entertainment,8.09,52133396.59
11/08/2023,Expense,Computer Bookshop India,Anik Das,Credit Card - Ramp,21.93,52133418.52
11/08/2023,Expense,Mecca Coffee Roasters Restaurant,Max Kausman,Meals & Entertainment,8.09,52133426.61
11/08/2023,Expense,Heroku,Balapavan Tirumani,Tools & Subscription - S&M,85,52133511.61
11/08/2023,Expense,Computer Bookshop India,Anik Das,General business expenses:Memberships & subscriptions,21.93,52133533.54
11/08/2023,Expense,Heroku,Balapavan Tirumani,Tools & Subscription - S&M,85,52133618.54
11/08/2023,Expense,Mecca Coffee Roasters Restaurant,Max Kausman,Meals & Entertainment,8.09,52133626.63
11/08/2023,Expense,Computer Bookshop India,Anik Das,General business expenses:Memberships & subscriptions,21.93,52133648.56
11/09/2023,Expense,Usersnap,Harris Jose,Tools & Subscription - G&A,99,52133747.56
11/09/2023,Expense,OpenAI,Balapavan Tirumani,Tools & Subscription - G&A,20,52133767.56
11/09/2023,Expense,Usersnap,Harris Jose,Tools & Subscription - G&A,99,52133866.56
11/09/2023,Expense,OpenAI,Balapavan Tirumani,Credit Card - Ramp,20,52133886.56
11/09/2023,Expense,OpenAI,Balapavan Tirumani,Tools & Subscription - G&A,20,52133906.56
11/09/2023,Expense,Usersnap,Harris Jose,Tools & Subscription - G&A,99,52134005.56
11/09/2023,Expense,OpenAI,Balapavan Tirumani,Tools & Subscription - G&A,20,52134025.56
11/09/2023,Expense,Usersnap,Harris Jose,Credit Card - Ramp,99,52134124.56
11/09/2023,Expense,Usersnap,Harris Jose,Tools & Subscription - G&A,99,52134223.56
11/09/2023,Expense,OpenAI,Balapavan Tirumani,Credit Card - Ramp,20,52134243.56
11/09/2023,Expense,OpenAI,Balapavan Tirumani,Tools & Subscription - G&A,20,52134263.56
11/09/2023,Expense,OpenAI,Balapavan Tirumani,Credit Card - Ramp,20,52134283.56
11/09/2023,Expense,Usersnap,Harris Jose,Credit Card - Ramp,99,52134382.56
11/09/2023,Expense,Usersnap,Harris Jose,Credit Card - Ramp,99,52134481.56
11/10/2023,Expense,Zoom,Max Kausman,Tools & Subscription - G&A,15.99,52134497.55
11/10/2023,Expense,Zoom,Max Kausman,Tools & Subscription - G&A,15.99,52134513.54
11/10/2023,Expense,Zoom,Max Kausman,Tools & Subscription - G&A,15.99,52134529.53
11/10/2023,Expense,Zoom,Max Kausman,Credit Card - Ramp,15.99,52134545.52
11/10/2023,Expense,Zoom,Max Kausman,Credit Card - Ramp,15.99,52134561.51
11/10/2023,Expense,Zoom,Max Kausman,Tools & Subscription - G&A,15.99,52134577.5
11/10/2023,Expense,Zoom,Max Kausman,Credit Card - Ramp,15.99,52134593.49
11/12/2023,Expense,WordPress,Harris Jose,Tools & Subscription - G&A,15.59,52134609.08
11/12/2023,Expense,WordPress,Harris Jose,Tools & Subscription - G&A,15.59,52134624.67
11/12/2023,Expense,Adobe,Chris George,Tools & Subscription - S&M,20.99,52134645.66
11/12/2023,Expense,WordPress,Harris Jose,Credit Card - Ramp,15.59,52134661.25
11/12/2023,Expense,WordPress,Harris Jose,Tools & Subscription - G&A,15.59,52134676.84
11/12/2023,Expense,WordPress,Harris Jose,Tools & Subscription - G&A,15.59,52134692.43
11/12/2023,Expense,Adobe,Chris George,Tools & Subscription - S&M,20.99,52134713.42
11/12/2023,Expense,Adobe,Chris George,Credit Card - Ramp,20.99,52134734.41
11/12/2023,Expense,Adobe,Chris George,Credit Card - Ramp,20.99,52134755.4
11/12/2023,Expense,Adobe,Chris George,Tools & Subscription - S&M,20.99,52134776.39
11/12/2023,Expense,Adobe,Chris George,Tools & Subscription - S&M,20.99,52134797.38
11/12/2023,Expense,WordPress,Harris Jose,Credit Card - Ramp,15.59,52134812.97
11/12/2023,Expense,WordPress,Harris Jose,Credit Card - Ramp,15.59,52134828.56
11/12/2023,Expense,Adobe,Chris George,Credit Card - Ramp,20.99,52134849.55
11/13/2023,Expense,Lenny Rachitsky,Max Kausman,Credit Card - Ramp,15,52134864.55
11/13/2023,Expense,Figma,Mike ross,Tools & Subscription - G&A,75,52134939.55
11/13/2023,Expense,Figma,Mike ross,Tools & Subscription - G&A,75,52135014.55
11/13/2023,Expense,Lenny Rachitsky,Max Kausman,General business expenses:Memberships & subscriptions,15,52135029.55
11/13/2023,Expense,Uber,Mike ross,Credit Card - Ramp,14.65,52135044.2
11/13/2023,Expense,Uber,Mike ross,Travelling Expenses,14.65,52135058.85
11/13/2023,Expense,Lenny Rachitsky,Max Kausman,General business expenses:Memberships & subscriptions,15,52135073.85
11/13/2023,Expense,Vercel,Harris Jose,Tools & Subscription - G&A,240,52135313.85
11/13/2023,Expense,Uber,Mike ross,Travelling Expenses,14.65,52135328.5
11/13/2023,Expense,Vercel,Harris Jose,Credit Card - Ramp,240,52135568.5
11/13/2023,Expense,Figma,Mike ross,Credit Card - Ramp,75,52135643.5
11/13/2023,Expense,Vercel,Harris Jose,Tools & Subscription - G&A,240,52135883.5
11/13/2023,Expense,Uber,Mike ross,Travelling Expenses,14.65,52135898.15
11/13/2023,Expense,Vercel,Harris Jose,Tools & Subscription - G&A,240,52136138.15
11/13/2023,Expense,Vercel,Harris Jose,Credit Card - Ramp,240,52136378.15
11/13/2023,Expense,Figma,Mike ross,Tools & Subscription - G&A,75,52136453.15
11/13/2023,Expense,Lenny Rachitsky,Max Kausman,General business expenses:Memberships & subscriptions,15,52136468.15
11/13/2023,Expense,Figma,Mike ross,Tools & Subscription - G&A,75,52136543.15
11/13/2023,Expense,Lenny Rachitsky,Max Kausman,General business expenses:Memberships & subscriptions,15,52136558.15
11/13/2023,Expense,Uber,Mike ross,Travelling Expenses,14.65,52136572.8
11/13/2023,Expense,Uber,Mike ross,Credit Card - Ramp,14.65,52136587.45
11/13/2023,Expense,Uber,Mike ross,Credit Card - Ramp,14.65,52136602.1
11/13/2023,Expense,Vercel,Harris Jose,Tools & Subscription - G&A,240,52136842.1
11/13/2023,Expense,Lenny Rachitsky,Max Kausman,Credit Card - Ramp,15,52136857.1
11/13/2023,Expense,Lenny Rachitsky,Max Kausman,Credit Card - Ramp,15,52136872.1
11/13/2023,Expense,Figma,Mike ross,Credit Card - Ramp,75,52136947.1
11/13/2023,Expense,Figma,Mike ross,Credit Card - Ramp,75,52137022.1
11/13/2023,Expense,Vercel,Harris Jose,Credit Card - Ramp,240,52137262.1
11/13/2023,Expense,Lenny Rachitsky,Max Kausman,Credit Card - Ramp,15,52137277.1
11/14/2023,Expense,Liveblocks,Balapavan Tirumani,Credit Card - Ramp,56.57,52137333.67
11/14/2023,Expense,Notion Labs,Harvey Spector,Credit Card - Ramp,10,52137343.67
11/14/2023,Expense,Notion Labs,Harvey Spector,Tools & Subscription - G&A,10,52137353.67
11/14/2023,Expense,Liveblocks,Balapavan Tirumani,Tools & Subscription - G&A,56.57,52137410.24
11/14/2023,Expense,Liveblocks,Balapavan Tirumani,Tools & Subscription - G&A,56.57,52137466.81
11/14/2023,Expense,Notion Labs,Harvey Spector,Credit Card - Ramp,10,52137476.81
11/14/2023,Expense,Notion Labs,Harvey Spector,Tools & Subscription - G&A,10,52137486.81
11/14/2023,Expense,Notion Labs,Harvey Spector,Tools & Subscription - G&A,10,52137496.81
11/14/2023,Expense,Liveblocks,Balapavan Tirumani,Credit Card - Ramp,56.57,52137553.38
11/14/2023,Expense,Notion Labs,Harvey Spector,Tools & Subscription - G&A,10,52137563.38
11/14/2023,Expense,Notion Labs,Harvey Spector,Credit Card - Ramp,10,52137573.38
11/14/2023,Expense,Liveblocks,Balapavan Tirumani,Tools & Subscription - G&A,56.57,52137629.95
11/14/2023,Expense,Liveblocks,Balapavan Tirumani,Credit Card - Ramp,56.57,52137686.52
11/14/2023,Expense,Liveblocks,Balapavan Tirumani,Tools & Subscription - G&A,56.57,52137743.09
11/15/2023,Bill,ANSR Dubai,,Professional Service Charges,10874,52148617.09
11/15/2023,Bill,ANSR Dubai,,Professional Service Charges,10874,52159491.09
11/15/2023,Bill,ANSR Dubai,Service Fees for October 2023,Accounts Payable (A/P),10874,52170365.09
11/15/2023,Expense,Msw Mumbai Airport Loun Restaurant,Harvey Spector,Meals & Entertainment,47.19,52170412.28
11/15/2023,Expense,Msw Mumbai Airport Loun Restaurant,Harvey Spector,Credit Card - Ramp,47.19,52170459.47
11/15/2023,Bill,ANSR Dubai,Service Fees for October 2023,Accounts Payable (A/P),10874,52181333.47
11/15/2023,Expense,Msw Mumbai Airport Loun Restaurant,Harvey Spector,Meals & Entertainment,47.19,52181380.66
11/15/2023,Expense,Msw Mumbai Airport Loun Restaurant,Harvey Spector,Credit Card - Ramp,47.19,52181427.85
11/15/2023,Expense,Msw Mumbai Airport Loun Restaurant,Harvey Spector,Meals & Entertainment,47.19,52181475.04
11/15/2023,Bill,ANSR Dubai,Service Fees for October 2023,Accounts Payable (A/P),10874,52192349.04
11/15/2023,Bill,ANSR Dubai,,Professional Service Charges,10874,52203223.04
11/15/2023,Bill,ANSR Dubai,Service Fees for October 2023,Accounts Payable (A/P),10874,52214097.04
11/15/2023,Bill,ANSR Dubai,,Professional Service Charges,10874,52224971.04
11/15/2023,Expense,Msw Mumbai Airport Loun Restaurant,Harvey Spector,Credit Card - Ramp,47.19,52225018.23
11/15/2023,Expense,Msw Mumbai Airport Loun Restaurant,Harvey Spector,Meals & Entertainment,47.19,52225065.42
11/15/2023,Expense,Msw Mumbai Airport Loun Restaurant,Harvey Spector,Credit Card - Ramp,47.19,52225112.61
11/16/2023,Expense,Careem,Harvey Spector,Credit Card - Ramp,13.04,52225125.65
11/16/2023,Expense,Telstra,Mike ross,Utilities:Internet & TV services,312.23,52225437.88
11/16/2023,Expense,Careem,Harvey Spector,Credit Card - Ramp,13.04,52225450.92
11/16/2023,Expense,Telstra,Mike ross,Credit Card - Ramp,312.23,52225763.15
11/16/2023,Expense,Careem,Harvey Spector,Credit Card - Ramp,13.04,52225776.19
11/16/2023,Expense,Telstra,Mike ross,Credit Card - Ramp,312.23,52226088.42
11/16/2023,Expense,Telstra,Mike ross,Credit Card - Ramp,312.23,52226400.65
11/16/2023,Expense,Telstra,Mike ross,Utilities:Internet & TV services,312.23,52226712.88
11/16/2023,Expense,Careem,Harvey Spector,Travelling Expenses,13.04,52226725.92
11/16/2023,Expense,Telstra,Mike ross,Utilities:Internet & TV services,312.23,52227038.15
11/16/2023,Expense,Careem,Harvey Spector,Travelling Expenses,13.04,52227051.19
11/16/2023,Expense,Telstra,Mike ross,Utilities:Internet & TV services,312.23,52227363.42
11/16/2023,Expense,Careem,Harvey Spector,Travelling Expenses,13.04,52227376.46
11/16/2023,Expense,Careem,Harvey Spector,Travelling Expenses,13.04,52227389.5
11/17/2023,Expense,Inka Arthouse,Mike ross,Tools & Subscription - G&A,107.43,52227496.93
11/17/2023,Expense,Inka Arthouse,Mike ross,Credit Card - Ramp,107.43,52227604.36
11/17/2023,Expense,,MONTHLY CHARGE Bank Charges for the per 01OCT2023 TO 31OCT2023 Invoice No 1727446,General business expenses:Bank fees & service charges,-33.19,52227571.17
11/17/2023,Expense,,MONTHLY CHARGE Bank Charges for the per 01OCT2023 TO 31OCT2023 Invoice No 1727446,General business expenses:Bank fees & service charges,-33.19,52227537.98
11/17/2023,Expense,Inka Arthouse,Mike ross,Tools & Subscription - G&A,107.43,52227645.41
11/17/2023,Expense,,Fees,HSBC A/c,33.19,52227678.6
11/17/2023,Expense,Inka Arthouse,Mike ross,Tools & Subscription - G&A,107.43,52227786.03
11/17/2023,Expense,,MONTHLY CHARGE Bank Charges for the per 01OCT2023 TO 31OCT2023 Invoice No 1727446,General business expenses:Bank fees & service charges,-33.19,52227752.84
11/17/2023,Expense,Inka Arthouse,Mike ross,Credit Card - Ramp,107.43,52227860.27
11/17/2023,Expense,,Fees,HSBC A/c,33.19,52227893.46
11/17/2023,Expense,,Fees,HSBC A/c,33.19,52227926.65
11/17/2023,Expense,Inka Arthouse,Mike ross,Credit Card - Ramp,107.43,52228034.08
11/17/2023,Expense,,Fees,HSBC A/c,33.19,52228067.27
11/17/2023,Expense,,MONTHLY CHARGE Bank Charges for the per 01OCT2023 TO 31OCT2023 Invoice No 1727446,General business expenses:Bank fees & service charges,-33.19,52228034.08
11/17/2023,Expense,Inka Arthouse,Mike ross,Tools & Subscription - G&A,107.43,52228141.51
11/18/2023,Expense,GitKraken,Harris Jose,Tools & Subscription - G&A,48,52228189.51
11/18/2023,Expense,Segment,Balapavan Tirumani,Tools & Subscription - G&A,120,52228309.51
11/18/2023,Expense,Reclaim.ai,Max Kausman,Tools & Subscription - G&A,8,52228317.51
11/18/2023,Expense,Reclaim.ai,Max Kausman,Tools & Subscription - G&A,8,52228325.51
11/18/2023,Expense,Segment,Balapavan Tirumani,Tools & Subscription - G&A,120,52228445.51
11/18/2023,Expense,Reclaim.ai,Max Kausman,Tools & Subscription - G&A,8,52228453.51
11/18/2023,Expense,Loom,Mike ross,Tools & Subscription - G&A,38.55,52228492.06
11/18/2023,Expense,GitKraken,Harris Jose,Tools & Subscription - G&A,48,52228540.06
11/18/2023,Expense,Reclaim.ai,Max Kausman,Credit Card - Ramp,8,52228548.06
11/18/2023,Expense,Reclaim.ai,Max Kausman,Credit Card - Ramp,8,52228556.06
11/18/2023,Expense,Loom,Mike ross,Credit Card - Ramp,38.55,52228594.61
11/18/2023,Expense,Loom,Mike ross,Tools & Subscription - G&A,38.55,52228633.16
11/18/2023,Expense,Loom,Mike ross,Tools & Subscription - G&A,38.55,52228671.71
11/18/2023,Expense,Reclaim.ai,Max Kausman,Credit Card - Ramp,8,52228679.71
11/18/2023,Expense,GitKraken,Harris Jose,Credit Card - Ramp,48,52228727.71
11/18/2023,Expense,Segment,Balapavan Tirumani,Credit Card - Ramp,120,52228847.71
11/18/2023,Expense,GitKraken,Harris Jose,Credit Card - Ramp,48,52228895.71
11/18/2023,Expense,Segment,Balapavan Tirumani,Tools & Subscription - G&A,120,52229015.71
11/18/2023,Expense,Loom,Mike ross,Tools & Subscription - G&A,38.55,52229054.26
11/18/2023,Expense,GitKraken,Harris Jose,Tools & Subscription - G&A,48,52229102.26
11/18/2023,Expense,GitKraken,Harris Jose,Tools & Subscription - G&A,48,52229150.26
11/18/2023,Expense,Segment,Balapavan Tirumani,Tools & Subscription - G&A,120,52229270.26
11/18/2023,Expense,Loom,Mike ross,Credit Card - Ramp,38.55,52229308.81
11/18/2023,Expense,Segment,Balapavan Tirumani,Credit Card - Ramp,120,52229428.81
11/18/2023,Expense,Reclaim.ai,Max Kausman,Tools & Subscription - G&A,8,52229436.81
11/18/2023,Expense,Segment,Balapavan Tirumani,Credit Card - Ramp,120,52229556.81
11/18/2023,Expense,GitKraken,Harris Jose,Credit Card - Ramp,48,52229604.81
11/18/2023,Expense,Loom,Mike ross,Credit Card - Ramp,38.55,52229643.36
11/19/2023,Expense,Careem,Harvey Spector,Travelling Expenses,10.79,52229654.15
11/19/2023,Expense,Careem,Harvey Spector,Credit Card - Ramp,10.79,52229664.94
11/19/2023,Expense,Careem,Harvey Spector,Travelling Expenses,10.79,52229675.73
11/19/2023,Expense,Careem,Harvey Spector,Credit Card - Ramp,10.79,52229686.52
11/19/2023,Expense,Careem,Harvey Spector,Travelling Expenses,10.79,52229697.31
11/19/2023,Expense,Careem,Harvey Spector,Travelling Expenses,10.79,52229708.1
11/19/2023,Expense,Careem,Harvey Spector,Credit Card - Ramp,10.79,52229718.89
11/20/2023,Expense,BuildBetter,Max Kausman,Credit Card - Ramp,100,52229818.89
11/20/2023,Expense,Lemon Squeezy,Max Kausman,Tools & Subscription - G&A,89,52229907.89
11/20/2023,Expense,Supplement Mart,Mike ross,Credit Card - Ramp,318.88,52230226.77
11/20/2023,Expense,Lemon Squeezy,Max Kausman,Tools & Subscription - G&A,89,52230315.77
11/20/2023,Expense,BuildBetter,Max Kausman,Tools & Subscription - G&A,100,52230415.77
11/20/2023,Expense,BuildBetter,Max Kausman,Tools & Subscription - G&A,100,52230515.77
11/20/2023,Expense,Supplement Mart,Mike ross,Meals & Entertainment,318.88,52230834.65
11/20/2023,Expense,BuildBetter,Max Kausman,Tools & Subscription - G&A,100,52230934.65
11/20/2023,Expense,Supplement Mart,Mike ross,Meals & Entertainment,318.88,52231253.53
11/20/2023,Expense,Lemon Squeezy,Max Kausman,Credit Card - Ramp,89,52231342.53
11/20/2023,Expense,Supplement Mart,Mike ross,Meals & Entertainment,318.88,52231661.41
11/20/2023,Expense,Lemon Squeezy,Max Kausman,Tools & Subscription - G&A,89,52231750.41
11/20/2023,Expense,Supplement Mart,Mike ross,Credit Card - Ramp,318.88,52232069.29
11/20/2023,Expense,Supplement Mart,Mike ross,Credit Card - Ramp,318.88,52232388.17
11/20/2023,Expense,BuildBetter,Max Kausman,Credit Card - Ramp,100,52232488.17
11/20/2023,Expense,Lemon Squeezy,Max Kausman,Credit Card - Ramp,89,52232577.17
11/20/2023,Expense,Supplement Mart,Mike ross,Credit Card - Ramp,318.88,52232896.05
11/20/2023,Expense,BuildBetter,Max Kausman,Credit Card - Ramp,100,52232996.05
11/20/2023,Expense,Supplement Mart,Mike ross,Meals & Entertainment,318.88,52233314.93
11/20/2023,Expense,Lemon Squeezy,Max Kausman,Credit Card - Ramp,89,52233403.93
11/20/2023,Expense,BuildBetter,Max Kausman,Tools & Subscription - G&A,100,52233503.93
11/20/2023,Expense,Lemon Squeezy,Max Kausman,Tools & Subscription - G&A,89,52233592.93
11/21/2023,Bill Payment (Check),ANSR Dubai,BOOK TRANSFER DEBIT 45BOOK DEBIT CHRONICLEHQ INC.*BNF:ANSR (EMEA) GLOBAL SERVICES LIM ITED*BBI:/DAS/REF:49286QR00JRX*STBOOK*TIME:0632*YOUR REF:NOV BILL *OUR REF:325482885,Accounts Payable (A/P),-10874,52222718.93
11/21/2023,Expense,Pause Cafe,Harvey Spector,Meals & Entertainment,11.3,52222730.23
11/21/2023,Bill Payment (Check),ANSR Dubai,,HSBC A/c,-10874,52211856.23
11/21/2023,Expense,Pause Cafe,Harvey Spector,Meals & Entertainment,11.3,52211867.53
11/21/2023,Expense,Pause Cafe,Harvey Spector,Credit Card - Ramp,11.3,52211878.83
11/21/2023,Bill Payment (Check),ANSR Dubai,,HSBC A/c,-10874,52201004.83
11/21/2023,Credit Card Payment,RAMP BUSINESS CO,RAMP STATEMENT,Account1,-3476.21,52197528.62
11/21/2023,Credit Card Payment,RAMP BUSINESS CO,RAMP STATEMENT,Credit Card - Ramp,-3476.21,52194052.41
11/21/2023,Credit Card Payment,RAMP BUSINESS CO,RAMP STATEMENT,Credit Card - Ramp,-3476.21,52190576.2
11/21/2023,Bill Payment (Check),ANSR Dubai,BOOK TRANSFER DEBIT 45BOOK DEBIT CHRONICLEHQ INC.*BNF:ANSR (EMEA) GLOBAL SERVICES LIM ITED*BBI:/DAS/REF:49286QR00JRX*STBOOK*TIME:0632*YOUR REF:NOV BILL *OUR REF:325482885,Accounts Payable (A/P),-10874,52179702.2
11/21/2023,Credit Card Payment,RAMP BUSINESS CO,RAMP STATEMENT,Account1,-3476.21,52176225.99
11/21/2023,Credit Card Payment,RAMP BUSINESS CO,RAMP STATEMENT,Credit Card - Ramp,-3476.21,52172749.78
11/21/2023,Bill Payment (Check),ANSR Dubai,,HSBC A/c,-10874,52161875.78
11/21/2023,Credit Card Payment,RAMP BUSINESS CO,RAMP STATEMENT,Account1,-3476.21,52158399.57
11/21/2023,Expense,Pause Cafe,Harvey Spector,Meals & Entertainment,11.3,52158410.87
11/21/2023,Bill Payment (Check),ANSR Dubai,BOOK TRANSFER DEBIT 45BOOK DEBIT CHRONICLEHQ INC.*BNF:ANSR (EMEA) GLOBAL SERVICES LIM ITED*BBI:/DAS/REF:49286QR00JRX*STBOOK*TIME:0632*YOUR REF:NOV BILL *OUR REF:325482885,Accounts Payable (A/P),-10874,52147536.87
11/21/2023,Bill Payment (Check),ANSR Dubai,BOOK TRANSFER DEBIT 45BOOK DEBIT CHRONICLEHQ INC.*BNF:ANSR (EMEA) GLOBAL SERVICES LIM ITED*BBI:/DAS/REF:49286QR00JRX*STBOOK*TIME:0632*YOUR REF:NOV BILL *OUR REF:325482885,Accounts Payable (A/P),-10874,52136662.87
11/21/2023,Expense,Pause Cafe,Harvey Spector,Credit Card - Ramp,11.3,52136674.17
11/21/2023,Expense,Pause Cafe,Harvey Spector,Credit Card - Ramp,11.3,52136685.47
11/21/2023,Expense,Pause Cafe,Harvey Spector,Credit Card - Ramp,11.3,52136696.77
11/21/2023,Bill Payment (Check),ANSR Dubai,,HSBC A/c,-10874,52125822.77
11/21/2023,Expense,Pause Cafe,Harvey Spector,Meals & Entertainment,11.3,52125834.07
11/21/2023,Credit Card Payment,RAMP BUSINESS CO,RAMP STATEMENT,Account1,-3476.21,52122357.86
11/21/2023,Credit Card Payment,RAMP BUSINESS CO,RAMP STATEMENT,Credit Card - Ramp,-3476.21,52118881.65
11/22/2023,Expense,BRONZE SNAKE,Mike ross,Credit Card - Ramp,40.74,52118922.39
11/22/2023,Expense,BRONZE SNAKE,Mike ross,Meals & Entertainment,40.74,52118963.13
11/22/2023,Expense,BRONZE SNAKE,Mike ross,Meals & Entertainment,40.74,52119003.87
11/22/2023,Expense,BRONZE SNAKE,Mike ross,Credit Card - Ramp,40.74,52119044.61
11/22/2023,Expense,BRONZE SNAKE,Mike ross,Meals & Entertainment,40.74,52119085.35
11/22/2023,Expense,BRONZE SNAKE,Mike ross,Credit Card - Ramp,40.74,52119126.09
11/22/2023,Expense,BRONZE SNAKE,Mike ross,Meals & Entertainment,40.74,52119166.83
11/22/2023,Expense,BRONZE SNAKE,Mike ross,Credit Card - Ramp,40.74,52119207.57
11/23/2023,Expense,Prezibase,Harvey Spector,General business expenses:Memberships & subscriptions,19,52119226.57
11/23/2023,Expense,Heptabase,Mike ross,Tools & Subscription - G&A,9.99,52119236.56
11/23/2023,Expense,Prezibase,Harvey Spector,General business expenses:Memberships & subscriptions,19,52119255.56
11/23/2023,Expense,Superhuman,Mike ross,Professional Service Charges,90,52119345.56
11/23/2023,Expense,Prezibase,Harvey Spector,Credit Card - Ramp,19,52119364.56
11/23/2023,Expense,Prezibase,Harvey Spector,Credit Card - Ramp,19,52119383.56
11/23/2023,Expense,Heptabase,Mike ross,Tools & Subscription - G&A,9.99,52119393.55
11/23/2023,Expense,Superhuman,Mike ross,Credit Card - Ramp,90,52119483.55
11/23/2023,Expense,Heptabase,Mike ross,Credit Card - Ramp,9.99,52119493.54
11/23/2023,Expense,Heptabase,Mike ross,Credit Card - Ramp,9.99,52119503.53
11/23/2023,Expense,Superhuman,Mike ross,Professional Service Charges,90,52119593.53
11/23/2023,Expense,Superhuman,Mike ross,Professional Service Charges,90,52119683.53
11/23/2023,Expense,Prezibase,Harvey Spector,Credit Card - Ramp,19,52119702.53
11/23/2023,Expense,Heptabase,Mike ross,Credit Card - Ramp,9.99,52119712.52
11/23/2023,Expense,Prezibase,Harvey Spector,General business expenses:Memberships & subscriptions,19,52119731.52
11/23/2023,Expense,Superhuman,Mike ross,Credit Card - Ramp,90,52119821.52
11/23/2023,Expense,Heptabase,Mike ross,Tools & Subscription - G&A,9.99,52119831.51
11/23/2023,Expense,Prezibase,Harvey Spector,Credit Card - Ramp,19,52119850.51
11/23/2023,Expense,Superhuman,Mike ross,Credit Card - Ramp,90,52119940.51
11/23/2023,Expense,Superhuman,Mike ross,Credit Card - Ramp,90,52120030.51
11/23/2023,Expense,Heptabase,Mike ross,Tools & Subscription - G&A,9.99,52120040.5
11/23/2023,Expense,Superhuman,Mike ross,Professional Service Charges,90,52120130.5
11/23/2023,Expense,Prezibase,Harvey Spector,General business expenses:Memberships & subscriptions,19,52120149.5
11/24/2023,Expense,Yolo Journal,Harvey Spector,Credit Card - Ramp,80,52120229.5
11/24/2023,Expense,Yolo Journal,Harvey Spector,Credit Card - Ramp,80,52120309.5
11/24/2023,Expense,Yolo Journal,Harvey Spector,Credit Card - Ramp,80,52120389.5
11/24/2023,Expense,KPAX,Harvey Spector,Credit Card - Ramp,42,52120431.5
11/24/2023,Expense,KPAX,Harvey Spector,Credit Card - Ramp,42,52120473.5
11/24/2023,Expense,KPAX,Harvey Spector,Credit Card - Ramp,42,52120515.5
11/24/2023,Expense,KPAX,Harvey Spector,General business expenses:Memberships & subscriptions,42,52120557.5
11/24/2023,Expense,KPAX,Harvey Spector,General business expenses:Memberships & subscriptions,42,52120599.5
11/24/2023,Expense,Uber,Mike ross,Travelling Expenses,47.29,52120646.79
11/24/2023,Expense,Yolo Journal,Harvey Spector,General business expenses:Memberships & subscriptions,80,52120726.79
11/24/2023,Expense,Uber,Mike ross,Travelling Expenses,47.29,52120774.08
11/24/2023,Expense,KPAX,Harvey Spector,General business expenses:Memberships & subscriptions,42,52120816.08
11/24/2023,Expense,Yolo Journal,Harvey Spector,General business expenses:Memberships & subscriptions,80,52120896.08
11/24/2023,Expense,Uber,Mike ross,Credit Card - Ramp,47.29,52120943.37
11/24/2023,Expense,Uber,Mike ross,Credit Card - Ramp,47.29,52120990.66
11/24/2023,Expense,Uber,Mike ross,Travelling Expenses,47.29,52121037.95
11/24/2023,Expense,Yolo Journal,Harvey Spector,General business expenses:Memberships & subscriptions,80,52121117.95
11/24/2023,Expense,KPAX,Harvey Spector,Credit Card - Ramp,42,52121159.95
11/24/2023,Expense,Uber,Mike ross,Credit Card - Ramp,47.29,52121207.24
11/24/2023,Expense,Yolo Journal,Harvey Spector,General business expenses:Memberships & subscriptions,80,52121287.24
11/24/2023,Expense,KPAX,Harvey Spector,General business expenses:Memberships & subscriptions,42,52121329.24
11/24/2023,Expense,Uber,Mike ross,Travelling Expenses,47.29,52121376.53
11/24/2023,Expense,Yolo Journal,Harvey Spector,Credit Card - Ramp,80,52121456.53
11/25/2023,Expense,Careem,Harvey Spector,Travelling Expenses,5.33,52121461.86
11/25/2023,Expense,Careem,Harvey Spector,Credit Card - Ramp,5.33,52121467.19
11/25/2023,Expense,Careem,Harvey Spector,Credit Card - Ramp,9.26,52121476.45
11/25/2023,Expense,Careem,Harvey Spector,Credit Card - Ramp,5.33,52121481.78
11/25/2023,Expense,Careem,Harvey Spector,Credit Card - Ramp,9.26,52121491.04
11/25/2023,Expense,Careem,Harvey Spector,Travelling Expenses,9.26,52121500.3
11/25/2023,Expense,Careem,Harvey Spector,Credit Card - Ramp,5.33,52121505.63
11/25/2023,Expense,Careem,Harvey Spector,Travelling Expenses,9.26,52121514.89
11/25/2023,Expense,Careem,Harvey Spector,Travelling Expenses,9.26,52121524.15
11/25/2023,Expense,Careem,Harvey Spector,Travelling Expenses,5.33,52121529.48
11/25/2023,Expense,Careem,Harvey Spector,Credit Card - Ramp,9.26,52121538.74
11/25/2023,Expense,Careem,Harvey Spector,Travelling Expenses,9.26,52121548
11/25/2023,Expense,Careem,Harvey Spector,Travelling Expenses,5.33,52121553.33
11/25/2023,Expense,Careem,Harvey Spector,Travelling Expenses,5.33,52121558.66
11/26/2023,Expense,The New York Times,Mike ross,General business expenses:Memberships & subscriptions,8.15,52121566.81
11/26/2023,Expense,The Pragmatic Studio,Anik Das,Credit Card - Ramp,125.1,52121691.91
11/26/2023,Expense,The Pragmatic Studio,Anik Das,Credit Card - Ramp,125.1,52121817.01
11/26/2023,Expense,The New York Times,Mike ross,General business expenses:Memberships & subscriptions,8.15,52121825.16
11/26/2023,Expense,The New York Times,Mike ross,Credit Card - Ramp,8.15,52121833.31
11/26/2023,Expense,The Pragmatic Studio,Anik Das,General business expenses:Continuing education,125.1,52121958.41
11/26/2023,Expense,The Pragmatic Studio,Anik Das,General business expenses:Continuing education,125.1,52122083.51
11/26/2023,Expense,The Pragmatic Studio,Anik Das,Credit Card - Ramp,125.1,52122208.61
11/26/2023,Expense,The New York Times,Mike ross,Credit Card - Ramp,8.15,52122216.76
11/26/2023,Expense,The Pragmatic Studio,Anik Das,Credit Card - Ramp,125.1,52122341.86
11/26/2023,Expense,The New York Times,Mike ross,Credit Card - Ramp,8.15,52122350.01
11/26/2023,Expense,The Pragmatic Studio,Anik Das,General business expenses:Continuing education,125.1,52122475.11
11/26/2023,Expense,The New York Times,Mike ross,General business expenses:Memberships & subscriptions,8.15,52122483.26
11/26/2023,Expense,The Pragmatic Studio,Anik Das,General business expenses:Continuing education,125.1,52122608.36
11/26/2023,Expense,The New York Times,Mike ross,General business expenses:Memberships & subscriptions,8.15,52122616.51
11/26/2023,Expense,The New York Times,Mike ross,Credit Card - Ramp,8.15,52122624.66
11/27/2023,Expense,Sendinblue,Balapavan Tirumani,Credit Card - Ramp,78.19,52122702.85
11/27/2023,Expense,Sentry,Balapavan Tirumani,Credit Card - Ramp,29,52122731.85
11/27/2023,Expense,Sentry,Balapavan Tirumani,Tools & Subscription - G&A,29,52122760.85
11/27/2023,Expense,Sendinblue,Balapavan Tirumani,Credit Card - Ramp,78.19,52122839.04
11/27/2023,Expense,Splitbee,Harris Jose,Tools & Subscription - G&A,16.52,52122855.56
11/27/2023,Expense,Visco Selected Fine Foods pty,Mike ross,Meals & Entertainment,22.41,52122877.97
11/27/2023,Expense,Sentry,Balapavan Tirumani,Tools & Subscription - G&A,29,52122906.97
11/27/2023,Expense,Splitbee,Harris Jose,Tools & Subscription - G&A,16.52,52122923.49
11/27/2023,Expense,Splitbee,Harris Jose,Credit Card - Ramp,16.52,52122940.01
11/27/2023,Expense,Visco Selected Fine Foods pty,Mike ross,Credit Card - Ramp,22.41,52122962.42
11/27/2023,Expense,Sendinblue,Balapavan Tirumani,Tools & Subscription - G&A,78.19,52123040.61
11/27/2023,Expense,Splitbee,Harris Jose,Credit Card - Ramp,16.52,52123057.13
11/27/2023,Expense,Sentry,Balapavan Tirumani,Credit Card - Ramp,29,52123086.13
11/27/2023,Expense,Visco Selected Fine Foods pty,Mike ross,Meals & Entertainment,22.41,52123108.54
11/27/2023,Expense,Visco Selected Fine Foods pty,Mike ross,Credit Card - Ramp,22.41,52123130.95
11/27/2023,Expense,Sendinblue,Balapavan Tirumani,Credit Card - Ramp,78.19,52123209.14
11/27/2023,Expense,Sentry,Balapavan Tirumani,Credit Card - Ramp,29,52123238.14
11/27/2023,Expense,Splitbee,Harris Jose,Tools & Subscription - G&A,16.52,52123254.66
11/27/2023,Expense,Sentry,Balapavan Tirumani,Tools & Subscription - G&A,29,52123283.66
11/27/2023,Expense,Sendinblue,Balapavan Tirumani,Tools & Subscription - G&A,78.19,52123361.85
11/27/2023,Expense,Visco Selected Fine Foods pty,Mike ross,Credit Card - Ramp,22.41,52123384.26
11/27/2023,Expense,Sendinblue,Balapavan Tirumani,Tools & Subscription - G&A,78.19,52123462.45
11/27/2023,Expense,Sendinblue,Balapavan Tirumani,Tools & Subscription - G&A,78.19,52123540.64
11/27/2023,Expense,Visco Selected Fine Foods pty,Mike ross,Meals & Entertainment,22.41,52123563.05
11/27/2023,Expense,Splitbee,Harris Jose,Tools & Subscription - G&A,16.52,52123579.57
11/27/2023,Expense,Visco Selected Fine Foods pty,Mike ross,Credit Card - Ramp,22.41,52123601.98
11/27/2023,Expense,Visco Selected Fine Foods pty,Mike ross,Meals & Entertainment,22.41,52123624.39
11/27/2023,Expense,Splitbee,Harris Jose,Credit Card - Ramp,16.52,52123640.91
11/27/2023,Expense,Sentry,Balapavan Tirumani,Tools & Subscription - G&A,29,52123669.91
11/28/2023,Expense,Github,Balapavan Tirumani,Credit Card - Ramp,44,52123713.91
11/28/2023,Expense,Github,Balapavan Tirumani,Tools & Subscription - G&A,10,52123723.91
11/28/2023,Expense,Maloneys Grocer,Mike ross,Credit Card - Ramp,22.67,52123746.58
11/28/2023,Expense,Maloneys Grocer,Mike ross,Credit Card - Ramp,22.67,52123769.25
11/28/2023,Expense,Maloneys Grocer,Mike ross,Meals & Entertainment,22.67,52123791.92
11/28/2023,Expense,Airbnb,Mike ross,Credit Card - Ramp,3212.55,52127004.47
11/28/2023,Expense,Airbnb,Mike ross,Travel:Hotels,1727.73,52128732.2
11/28/2023,Expense,Uber Eats,Mike ross,Credit Card - Ramp,24.76,52128756.96
11/28/2023,Expense,Uber Eats,Mike ross,Credit Card - Ramp,24.76,52128781.72
11/28/2023,Expense,Uber Eats,Mike ross,Credit Card - Ramp,24.76,52128806.48
11/28/2023,Expense,Github,Balapavan Tirumani,Tools & Subscription - G&A,44,52128850.48
11/28/2023,Expense,Maloneys Grocer,Mike ross,Credit Card - Ramp,22.67,52128873.15
11/28/2023,Expense,Airbnb,Mike ross,Travel:Hotels,3212.55,52132085.7
11/28/2023,Expense,Github,Balapavan Tirumani,Credit Card - Ramp,10,52132095.7
11/28/2023,Expense,Github,Balapavan Tirumani,Credit Card - Ramp,44,52132139.7
11/28/2023,Expense,Github,Balapavan Tirumani,Credit Card - Ramp,10,52132149.7
11/28/2023,Expense,Airbnb,Mike ross,Credit Card - Ramp,3212.55,52135362.25
11/28/2023,Expense,Airbnb,Mike ross,Credit Card - Ramp,1727.73,52137089.98
11/28/2023,Expense,Airbnb,Mike ross,Credit Card - Ramp,1727.73,52138817.71
11/28/2023,Expense,Airbnb,Mike ross,Travel:Hotels,3212.55,52142030.26
11/28/2023,Expense,Maloneys Grocer,Mike ross,Credit Card - Ramp,22.67,52142052.93
11/28/2023,Expense,Airbnb,Mike ross,Credit Card - Ramp,3212.55,52145265.48
11/28/2023,Expense,Maloneys Grocer,Mike ross,Meals & Entertainment,22.67,52145288.15
11/28/2023,Expense,Uber Eats,Mike ross,Meals & Entertainment,24.76,52145312.91
11/28/2023,Expense,Airbnb,Mike ross,Credit Card - Ramp,1727.73,52147040.64
11/28/2023,Expense,Github,Balapavan Tirumani,Tools & Subscription - G&A,44,52147084.64
11/28/2023,Expense,Airbnb,Mike ross,Travel:Hotels,3212.55,52150297.19
11/28/2023,Expense,Github,Balapavan Tirumani,Tools & Subscription - G&A,10,52150307.19
11/28/2023,Expense,Airbnb,Mike ross,Travel:Hotels,1727.73,52152034.92
11/28/2023,Expense,Uber Eats,Mike ross,Meals & Entertainment,24.76,52152059.68
11/28/2023,Expense,Uber Eats,Mike ross,Credit Card - Ramp,24.76,52152084.44
11/28/2023,Expense,Airbnb,Mike ross,Travel:Hotels,1727.73,52153812.17
11/28/2023,Expense,Uber Eats,Mike ross,Meals & Entertainment,24.76,52153836.93
11/28/2023,Expense,Maloneys Grocer,Mike ross,Meals & Entertainment,22.67,52153859.6
11/28/2023,Expense,Uber Eats,Mike ross,Meals & Entertainment,24.76,52153884.36
11/28/2023,Expense,Maloneys Grocer,Mike ross,Meals & Entertainment,22.67,52153907.03
11/28/2023,Expense,Airbnb,Mike ross,Travel:Hotels,1727.73,52155634.76
11/28/2023,Expense,Airbnb,Mike ross,Travel:Hotels,3212.55,52158847.31
11/28/2023,Expense,Github,Balapavan Tirumani,Tools & Subscription - G&A,44,52158891.31
11/28/2023,Expense,Github,Balapavan Tirumani,Tools & Subscription - G&A,10,52158901.31
11/28/2023,Expense,Github,Balapavan Tirumani,Tools & Subscription - G&A,10,52158911.31
11/28/2023,Expense,Github,Balapavan Tirumani,Credit Card - Ramp,44,52158955.31
11/28/2023,Expense,Github,Balapavan Tirumani,Credit Card - Ramp,10,52158965.31
11/28/2023,Expense,Github,Balapavan Tirumani,Tools & Subscription - G&A,44,52159009.31
11/29/2023,Expense,Netlify,Balapavan Tirumani,Tools & Subscription - G&A,19,52159028.31
11/29/2023,Credit Card Credit,Airbnb,Mike ross,Travel:Hotels,-1713.9,52157314.41
11/29/2023,Credit Card Credit,Airbnb,Mike ross,Credit Card - Ramp,-1713.9,52155600.51
11/29/2023,Expense,Wings And Tins,Mike ross,Credit Card - Ramp,37.44,52155637.95
11/29/2023,Expense,Netlify,Balapavan Tirumani,Credit Card - Ramp,19,52155656.95
11/29/2023,Expense,Netlify,Balapavan Tirumani,Tools & Subscription - G&A,19,52155675.95
11/29/2023,Expense,Wings And Tins,Mike ross,Meals & Entertainment,37.44,52155713.39
11/29/2023,Expense,Readwise,Harvey Spector,Credit Card - Ramp,47.94,52155761.33
11/29/2023,Credit Card Credit,Airbnb,Mike ross,Travel:Hotels,-1713.9,52154047.43
11/29/2023,Expense,Readwise,Harvey Spector,Credit Card - Ramp,47.94,52154095.37
11/29/2023,Expense,Readwise,Harvey Spector,Tools & Subscription - G&A,47.94,52154143.31
11/29/2023,Credit Card Credit,Airbnb,Mike ross,Travel:Hotels,-1713.9,52152429.41
11/29/2023,Expense,Netlify,Balapavan Tirumani,Credit Card - Ramp,19,52152448.41
11/29/2023,Expense,Wings And Tins,Mike ross,Meals & Entertainment,37.44,52152485.85
11/29/2023,Expense,Wings And Tins,Mike ross,Credit Card - Ramp,37.44,52152523.29
11/29/2023,Expense,Wings And Tins,Mike ross,Credit Card - Ramp,37.44,52152560.73
11/29/2023,Expense,Readwise,Harvey Spector,Tools & Subscription - G&A,47.94,52152608.67
11/29/2023,Expense,Netlify,Balapavan Tirumani,Credit Card - Ramp,19,52152627.67
11/29/2023,Credit Card Credit,Airbnb,Mike ross,Credit Card - Ramp,-1713.9,52150913.77
11/29/2023,Expense,Netlify,Balapavan Tirumani,Tools & Subscription - G&A,19,52150932.77
11/29/2023,Expense,Wings And Tins,Mike ross,Meals & Entertainment,37.44,52150970.21
11/29/2023,Expense,Readwise,Harvey Spector,Tools & Subscription - G&A,47.94,52151018.15
11/29/2023,Credit Card Credit,Airbnb,Mike ross,Travel:Hotels,-1713.9,52149304.25
11/29/2023,Credit Card Credit,Airbnb,Mike ross,Credit Card - Ramp,-1713.9,52147590.35
11/29/2023,Expense,Netlify,Balapavan Tirumani,Tools & Subscription - G&A,19,52147609.35
11/29/2023,Expense,Wings And Tins,Mike ross,Meals & Entertainment,37.44,52147646.79
11/29/2023,Expense,Readwise,Harvey Spector,Credit Card - Ramp,47.94,52147694.73
11/29/2023,Expense,Readwise,Harvey Spector,Tools & Subscription - G&A,47.94,52147742.67
11/29/2023,Expense,Wings And Tins,Mike ross,Credit Card - Ramp,37.44,52147780.11
11/30/2023,Expense,Uber,Mike ross,Travelling Expenses,9.53,52147789.64
11/30/2023,Expense,Adobe,Mike ross,Tools & Subscription - S&M,19.94,52147809.58
11/30/2023,Expense,Raycast,Harvey Spector,Tools & Subscription - G&A,20,52147829.58
11/30/2023,Expense,Raycast,Harvey Spector,Tools & Subscription - G&A,20,52147849.58
11/30/2023,Expense,inkle,Harvey Spector,Credit Card - Ramp,30,52147879.58
11/30/2023,Bill,Big Company ,,Outsources Services - India,29284,52177163.58
11/30/2023,Expense,Raycast,Harvey Spector,Tools & Subscription - G&A,20,52177183.58
11/30/2023,Expense,Raycast,Harvey Spector,Credit Card - Ramp,20,52177203.58
11/30/2023,Bill,Big Company ,"Service Expenses for the month of November 2023 
INR   24,39,996   @ 83.3229",Accounts Payable (A/P),29284,52206487.58
11/30/2023,Expense,inkle,Harvey Spector,Credit Card - Ramp,30,52206517.58
11/30/2023,Expense,Raycast,Harvey Spector,Credit Card - Ramp,20,52206537.58
11/30/2023,Expense,inkle,Harvey Spector,Tools & Subscription - G&A,30,52206567.58
11/30/2023,Expense,inkle,Harvey Spector,Tools & Subscription - G&A,30,52206597.58
11/30/2023,Bill,Big Company ,,Outsources Services - India,29284,52235881.58
11/30/2023,Expense,Adobe,Mike ross,Credit Card - Ramp,19.94,52235901.52
11/30/2023,Expense,Adobe,Mike ross,Tools & Subscription - S&M,19.94,52235921.46
11/30/2023,Bill,Big Company ,,Outsources Services - India,29284,52265205.46
11/30/2023,Expense,Uber,Mike ross,Travelling Expenses,9.53,52265214.99
11/30/2023,Expense,Adobe,Mike ross,Tools & Subscription - S&M,19.94,52265234.93
11/30/2023,Bill,Big Company ,,Outsources Services - India,29284,52294518.93
11/30/2023,Expense,Uber,Mike ross,Credit Card - Ramp,9.53,52294528.46
11/30/2023,Expense,Adobe,Mike ross,Tools & Subscription - S&M,19.94,52294548.4
11/30/2023,Expense,Uber,Mike ross,Credit Card - Ramp,9.53,52294557.93
11/30/2023,Bill,Big Company ,"Service Expenses for the month of November 2023 
INR   24,39,996   @ 83.3229",Accounts Payable (A/P),29284,52323841.93
11/30/2023,Bill,Big Company ,"Service Expenses for the month of November 2023 
INR   24,39,996   @ 83.3229",Accounts Payable (A/P),29284,52353125.93
11/30/2023,Expense,inkle,Harvey Spector,Credit Card - Ramp,30,52353155.93
11/30/2023,Expense,Raycast,Harvey Spector,Credit Card - Ramp,20,52353175.93
11/30/2023,Expense,Uber,Mike ross,Travelling Expenses,9.53,52353185.46
11/30/2023,Expense,Uber,Mike ross,Travelling Expenses,9.53,52353194.99
11/30/2023,Bill,Big Company ,"Service Expenses for the month of November 2023 
INR   24,39,996   @ 83.3229",Accounts Payable (A/P),29284,52382478.99
11/30/2023,Expense,Adobe,Mike ross,Credit Card - Ramp,19.94,52382498.93
11/30/2023,Expense,inkle,Harvey Spector,Tools & Subscription - G&A,30,52382528.93
11/30/2023,Expense,Adobe,Mike ross,Credit Card - Ramp,19.94,52382548.87
11/30/2023,Expense,inkle,Harvey Spector,Tools & Subscription - G&A,30,52382578.87
11/30/2023,Expense,Uber,Mike ross,Credit Card - Ramp,9.53,52382588.4
11/30/2023,Expense,Raycast,Harvey Spector,Tools & Subscription - G&A,20,52382608.4
12/01/2023,Expense,Uber,Mike ross,Credit Card - Ramp,12.09,52382620.49
12/01/2023,Deposit,,November Savings Interest,Interest Received,0.92,52382621.41
12/01/2023,Expense,Google G Suite,Mike ross,Credit Card - Ramp,113.99,52382735.4
12/01/2023,Expense,Liveblocks,Balapavan Tirumani,Credit Card - Ramp,99,52382834.4
12/01/2023,Expense,Render,Balapavan Tirumani,Credit Card - Ramp,289.04,52383123.44
12/01/2023,Deposit,,November Savings Interest,Interest Received,0.92,52383124.36
12/01/2023,Expense,Careem,Harvey Spector,Credit Card - Ramp,12.2,52383136.56
12/01/2023,Expense,SafetyWing,Harvey Spector,Credit Card - Ramp,26.1,52383162.66
12/01/2023,Expense,Careem,Harvey Spector,Credit Card - Ramp,12.2,52383174.86
12/01/2023,Expense,Uber,Mike ross,Credit Card - Ramp,12.09,52383186.95
12/01/2023,Expense,SafetyWing,Harvey Spector,Credit Card - Ramp,26.1,52383213.05
12/01/2023,Expense,Uber,Mike ross,Credit Card - Ramp,12.09,52383225.14
12/01/2023,Expense,Careem,Harvey Spector,Travelling Expenses,12.2,52383237.34
12/01/2023,Expense,SafetyWing,Harvey Spector,Insurance,26.1,52383263.44
12/01/2023,Expense,SafetyWing,Harvey Spector,Insurance,26.1,52383289.54
12/01/2023,Expense,Google G Suite,Mike ross,Tools & Subscription - G&A,113.99,52383403.53
12/01/2023,Expense,Liveblocks,Balapavan Tirumani,Tools & Subscription - G&A,99,52383502.53
12/01/2023,Expense,Uber,Mike ross,Travelling Expenses,12.09,52383514.62
12/01/2023,Expense,Render,Balapavan Tirumani,Tools & Subscription - G&A,289.04,52383803.66
12/01/2023,Expense,Careem,Harvey Spector,Credit Card - Ramp,12.2,52383815.86
12/01/2023,Expense,Airalo,Harvey Spector,Credit Card - Ramp,16.5,52383832.36
12/01/2023,Expense,Google G Suite,Mike ross,Tools & Subscription - G&A,113.99,52383946.35
12/01/2023,Expense,Liveblocks,Balapavan Tirumani,Tools & Subscription - G&A,99,52384045.35
12/01/2023,Expense,Uber,Mike ross,Travelling Expenses,12.09,52384057.44
12/01/2023,Expense,Render,Balapavan Tirumani,Tools & Subscription - G&A,289.04,52384346.48
12/01/2023,Expense,Careem,Harvey Spector,Travelling Expenses,12.2,52384358.68
12/01/2023,Expense,Airalo,Harvey Spector,Utilities:Internet & TV services,16.5,52384375.18
12/01/2023,Expense,Google G Suite,Mike ross,Credit Card - Ramp,113.99,52384489.17
12/01/2023,Expense,SafetyWing,Harvey Spector,Credit Card - Ramp,26.1,52384515.27
12/01/2023,Expense,Render,Balapavan Tirumani,Credit Card - Ramp,289.04,52384804.31
12/01/2023,Expense,Google G Suite,Mike ross,Credit Card - Ramp,113.99,52384918.3
12/01/2023,Expense,Careem,Harvey Spector,Travelling Expenses,12.2,52384930.5
12/01/2023,Expense,Render,Balapavan Tirumani,Tools & Subscription - G&A,289.04,52385219.54
12/01/2023,Expense,Render,Balapavan Tirumani,Tools & Subscription - G&A,289.04,52385508.58
12/01/2023,Expense,Uber,Mike ross,Travelling Expenses,12.09,52385520.67
12/01/2023,Expense,Careem,Harvey Spector,Travelling Expenses,12.2,52385532.87
12/01/2023,Expense,Liveblocks,Balapavan Tirumani,Credit Card - Ramp,99,52385631.87
12/01/2023,Expense,Liveblocks,Balapavan Tirumani,Credit Card - Ramp,99,52385730.87
12/01/2023,Deposit,,November Savings Interest,Interest Received,0.92,52385731.79
12/01/2023,Deposit,,November Savings Interest,Savings (6977),0.92,52385732.71
12/01/2023,Expense,Liveblocks,Balapavan Tirumani,Tools & Subscription - G&A,99,52385831.71
12/01/2023,Expense,Liveblocks,Balapavan Tirumani,Tools & Subscription - G&A,99,52385930.71
12/01/2023,Expense,Google G Suite,Mike ross,Tools & Subscription - G&A,113.99,52386044.7
12/01/2023,Expense,Uber,Mike ross,Travelling Expenses,12.09,52386056.79
12/01/2023,Expense,Airalo,Harvey Spector,Utilities:Internet & TV services,16.5,52386073.29
12/01/2023,Expense,Google G Suite,Mike ross,Tools & Subscription - G&A,113.99,52386187.28
12/01/2023,Deposit,,November Savings Interest,Savings (6977),0.92,52386188.2
12/01/2023,Expense,Airalo,Harvey Spector,Credit Card - Ramp,16.5,52386204.7
12/01/2023,Deposit,,November Savings Interest,Interest Received,0.92,52386205.62
12/01/2023,Expense,Airalo,Harvey Spector,Credit Card - Ramp,16.5,52386222.12
12/01/2023,Deposit,,November Savings Interest,Savings (6977),0.92,52386223.04
12/01/2023,Expense,SafetyWing,Harvey Spector,Insurance,26.1,52386249.14
12/01/2023,Expense,Render,Balapavan Tirumani,Credit Card - Ramp,289.04,52386538.18
12/01/2023,Expense,SafetyWing,Harvey Spector,Credit Card - Ramp,26.1,52386564.28
12/01/2023,Expense,Airalo,Harvey Spector,Utilities:Internet & TV services,16.5,52386580.78
12/01/2023,Expense,SafetyWing,Harvey Spector,Insurance,26.1,52386606.88
12/01/2023,Expense,Airalo,Harvey Spector,Utilities:Internet & TV services,16.5,52386623.38
12/02/2023,Credit Card Credit,101domain,Harvey Spector,Credit Card - Ramp,-296.05,52386327.33
12/02/2023,Credit Card Credit,101domain,Harvey Spector,Credit Card - Ramp,-296.05,52386031.28
12/02/2023,Expense,June,Balapavan Tirumani,Credit Card - Ramp,149,52386180.28
12/02/2023,Credit Card Credit,101domain,Harvey Spector,Office expenses:Office supplies,-296.05,52385884.23
12/02/2023,Expense,June,Balapavan Tirumani,Credit Card - Ramp,149,52386033.23
12/02/2023,Credit Card Credit,101domain,Harvey Spector,Credit Card - Ramp,-296.05,52385737.18
12/02/2023,Credit Card Credit,101domain,Harvey Spector,Office expenses:Office supplies,-296.05,52385441.13
12/02/2023,Expense,June,Balapavan Tirumani,Tools & Subscription - G&A,149,52385590.13
12/02/2023,Expense,Uber,Mike ross,Travelling Expenses,36.21,52385626.34
12/02/2023,Expense,Uber,Mike ross,Travelling Expenses,21.08,52385647.42
12/02/2023,Expense,Uber,Mike ross,Travelling Expenses,21.08,52385668.5
12/02/2023,Expense,June,Balapavan Tirumani,Tools & Subscription - G&A,149,52385817.5
12/02/2023,Credit Card Credit,101domain,Harvey Spector,Office expenses:Office supplies,-296.05,52385521.45
12/02/2023,Expense,Uber,Mike ross,Travelling Expenses,36.21,52385557.66
12/02/2023,Expense,Uber,Mike ross,Travelling Expenses,36.21,52385593.87
12/02/2023,Expense,Uber,Mike ross,Travelling Expenses,36.21,52385630.08
12/02/2023,Expense,Uber,Mike ross,Travelling Expenses,21.08,52385651.16
12/02/2023,Expense,June,Balapavan Tirumani,Tools & Subscription - G&A,149,52385800.16
12/02/2023,Expense,Uber,Mike ross,Travelling Expenses,21.08,52385821.24
12/02/2023,Expense,Uber,Mike ross,Credit Card - Ramp,21.08,52385842.32
12/02/2023,Expense,Uber,Mike ross,Credit Card - Ramp,21.08,52385863.4
12/02/2023,Expense,Uber,Mike ross,Credit Card - Ramp,36.21,52385899.61
12/02/2023,Expense,Uber,Mike ross,Credit Card - Ramp,36.21,52385935.82
12/02/2023,Credit Card Credit,101domain,Harvey Spector,Office expenses:Office supplies,-296.05,52385639.77
12/02/2023,Credit Card Credit,101domain,Harvey Spector,Credit Card - Ramp,-296.05,52385343.72
12/02/2023,Expense,Uber,Mike ross,Credit Card - Ramp,21.08,52385364.8
12/02/2023,Expense,June,Balapavan Tirumani,Credit Card - Ramp,149,52385513.8
12/02/2023,Expense,June,Balapavan Tirumani,Tools & Subscription - G&A,149,52385662.8
12/02/2023,Expense,Uber,Mike ross,Credit Card - Ramp,36.21,52385699.01
12/03/2023,Expense,VirtualPostMail,Harvey Spector,Credit Card - Ramp,20,52385719.01
12/03/2023,Expense,VirtualPostMail,Harvey Spector,General business expenses:Memberships & subscriptions,20,52385739.01
12/03/2023,Expense,Amazon Web Services,Balapavan Tirumani,Credit Card - Ramp,43.82,52385782.83
12/03/2023,Expense,Amazon Web Services,Balapavan Tirumani,Tools & Subscription - G&A,43.82,52385826.65
12/03/2023,Expense,Amazon Web Services,Balapavan Tirumani,Tools & Subscription - G&A,43.82,52385870.47
12/03/2023,Expense,VirtualPostMail,Harvey Spector,General business expenses:Memberships & subscriptions,20,52385890.47
12/03/2023,Expense,VirtualPostMail,Harvey Spector,Credit Card - Ramp,20,52385910.47
12/03/2023,Expense,VirtualPostMail,Harvey Spector,General business expenses:Memberships & subscriptions,20,52385930.47
12/03/2023,Expense,VirtualPostMail,Harvey Spector,Credit Card - Ramp,20,52385950.47
12/03/2023,Expense,Amazon Web Services,Balapavan Tirumani,Credit Card - Ramp,43.82,52385994.29
12/03/2023,Expense,VirtualPostMail,Harvey Spector,Credit Card - Ramp,20,52386014.29
12/03/2023,Expense,Amazon Web Services,Balapavan Tirumani,Credit Card - Ramp,43.82,52386058.11
12/03/2023,Expense,Amazon Web Services,Balapavan Tirumani,Tools & Subscription - G&A,43.82,52386101.93
12/03/2023,Expense,Amazon Web Services,Balapavan Tirumani,Tools & Subscription - G&A,43.82,52386145.75
12/03/2023,Expense,VirtualPostMail,Harvey Spector,General business expenses:Memberships & subscriptions,20,52386165.75
12/04/2023,Expense,The Carrington,Mike ross,Credit Card - Ramp,37.52,52386203.27
12/04/2023,Expense,The Carrington,Mike ross,Credit Card - Ramp,37.52,52386240.79
12/04/2023,Expense,OpenAI,Mike ross,Tools & Subscription - G&A,20,52386260.79
12/04/2023,Expense,Noahpinion,Max Kausman,Credit Card - Ramp,5.5,52386266.29
12/04/2023,Expense,OpenAI,Mike ross,Credit Card - Ramp,20,52386286.29
12/04/2023,Expense,Noahpinion,Max Kausman,Tools & Subscription - S&M,5.5,52386291.79
12/04/2023,Expense,Virgin,Chris George,Travelling Expenses,190.08,52386481.87
12/04/2023,Expense,Virgin,Chris George,Credit Card - Ramp,190.08,52386671.95
12/04/2023,Expense,Virgin,Chris George,Travelling Expenses,190.08,52386862.03
12/04/2023,Expense,The Carrington,Mike ross,Credit Card - Ramp,37.52,52386899.55
12/04/2023,Expense,Noahpinion,Max Kausman,Credit Card - Ramp,5.5,52386905.05
12/04/2023,Expense,OpenAI,Mike ross,Credit Card - Ramp,20,52386925.05
12/04/2023,Expense,The Carrington,Mike ross,Credit Card - Ramp,37.52,52386962.57
12/04/2023,Expense,OpenAI,Mike ross,Tools & Subscription - G&A,20,52386982.57
12/04/2023,Expense,Noahpinion,Max Kausman,Tools & Subscription - S&M,5.5,52386988.07
12/04/2023,Expense,The Carrington,Mike ross,Meals & Entertainment,37.52,52387025.59
12/04/2023,Expense,Noahpinion,Max Kausman,Tools & Subscription - S&M,5.5,52387031.09
12/04/2023,Expense,Virgin,Chris George,Travelling Expenses,190.08,52387221.17
12/04/2023,Expense,Virgin,Chris George,Credit Card - Ramp,190.08,52387411.25
12/04/2023,Expense,Virgin,Chris George,Travelling Expenses,190.08,52387601.33
12/04/2023,Expense,Noahpinion,Max Kausman,Tools & Subscription - S&M,5.5,52387606.83
12/04/2023,Expense,Noahpinion,Max Kausman,Credit Card - Ramp,5.5,52387612.33
12/04/2023,Expense,OpenAI,Mike ross,Tools & Subscription - G&A,20,52387632.33
12/04/2023,Expense,The Carrington,Mike ross,Meals & Entertainment,37.52,52387669.85
12/04/2023,Expense,OpenAI,Mike ross,Credit Card - Ramp,20,52387689.85
12/04/2023,Expense,Virgin,Chris George,Credit Card - Ramp,190.08,52387879.93
12/04/2023,Expense,The Carrington,Mike ross,Meals & Entertainment,37.52,52387917.45
12/04/2023,Expense,The Carrington,Mike ross,Meals & Entertainment,37.52,52387954.97
12/04/2023,Expense,OpenAI,Mike ross,Tools & Subscription - G&A,20,52387974.97
12/05/2023,Expense,OpenAI,Harvey Spector,Tools & Subscription - G&A,20,52387994.97
12/05/2023,Expense,OpenAI,Harvey Spector,Credit Card - Ramp,20,52388014.97
12/05/2023,Expense,Uber,Mike ross,Travelling Expenses,14.71,52388029.68
12/05/2023,Expense,OpenAI,Harvey Spector,Credit Card - Ramp,20,52388049.68
12/05/2023,Expense,Uber,Mike ross,Credit Card - Ramp,14.71,52388064.39
12/05/2023,Expense,OpenAI,Harvey Spector,Tools & Subscription - G&A,20,52388084.39
12/05/2023,Expense,Uber,Mike ross,Travelling Expenses,14.71,52388099.1
12/05/2023,Expense,OpenAI,Harvey Spector,Credit Card - Ramp,20,52388119.1
12/05/2023,Expense,Uber,Mike ross,Travelling Expenses,14.71,52388133.81
12/05/2023,Expense,OpenAI,Harvey Spector,Tools & Subscription - G&A,20,52388153.81
12/05/2023,Expense,Uber,Mike ross,Travelling Expenses,14.71,52388168.52
12/05/2023,Expense,Uber,Mike ross,Credit Card - Ramp,14.71,52388183.23
12/05/2023,Expense,Uber,Mike ross,Credit Card - Ramp,14.71,52388197.94
12/05/2023,Expense,OpenAI,Harvey Spector,Tools & Subscription - G&A,20,52388217.94
12/06/2023,Expense,Uber Eats,Mike ross,Credit Card - Ramp,22.46,52388240.4
12/06/2023,Expense,Singapore Air,Harvey Spector,Travel:Airfare,14.03,52388254.43
12/06/2023,Expense,Adobe,Mike ross,Credit Card - Ramp,83.31,52388337.74
12/06/2023,Expense,Uber,Mike ross,Travelling Expenses,23.54,52388361.28
12/06/2023,Expense,Singapore Air,Harvey Spector,Credit Card - Ramp,14.03,52388375.31
12/06/2023,Expense,Singapore Air,Harvey Spector,Credit Card - Ramp,14.03,52388389.34
12/06/2023,Expense,Singapore Air,Harvey Spector,Travel:Airfare,14.03,52388403.37
12/06/2023,Expense,Uber Eats,Mike ross,Credit Card - Ramp,22.46,52388425.83
12/06/2023,Expense,Adobe,Mike ross,Tools & Subscription - S&M,83.31,52388509.14
12/06/2023,Expense,Uber,Mike ross,Travelling Expenses,23.54,52388532.68
12/06/2023,Expense,Adobe,Mike ross,Tools & Subscription - S&M,83.31,52388615.99
12/06/2023,Expense,Uber,Mike ross,Travelling Expenses,19.3,52388635.29
12/06/2023,Expense,Uber,Mike ross,Credit Card - Ramp,23.54,52388658.83
12/06/2023,Expense,Uber,Mike ross,Credit Card - Ramp,19.3,52388678.13
12/06/2023,Expense,Uber,Mike ross,Travelling Expenses,19.3,52388697.43
12/06/2023,Expense,Adobe,Mike ross,Tools & Subscription - S&M,83.31,52388780.74
12/06/2023,Expense,Uber Eats,Mike ross,Meals & Entertainment,22.46,52388803.2
12/06/2023,Expense,Uber Eats,Mike ross,Meals & Entertainment,22.46,52388825.66
12/06/2023,Expense,Uber Eats,Mike ross,Credit Card - Ramp,22.46,52388848.12
12/06/2023,Expense,Uber,Mike ross,Travelling Expenses,19.3,52388867.42
12/06/2023,Expense,Uber,Mike ross,Travelling Expenses,23.54,52388890.96
12/06/2023,Expense,Uber Eats,Mike ross,Credit Card - Ramp,22.46,52388913.42
12/06/2023,Expense,Uber Eats,Mike ross,Meals & Entertainment,22.46,52388935.88
12/06/2023,Expense,Adobe,Mike ross,Tools & Subscription - S&M,83.31,52389019.19
12/06/2023,Expense,Uber,Mike ross,Travelling Expenses,23.54,52389042.73
12/06/2023,Expense,Singapore Air,Harvey Spector,Travel:Airfare,14.03,52389056.76
12/06/2023,Expense,Uber,Mike ross,Travelling Expenses,19.3,52389076.06
12/06/2023,Expense,Adobe,Mike ross,Credit Card - Ramp,83.31,52389159.37
12/06/2023,Expense,Uber,Mike ross,Credit Card - Ramp,23.54,52389182.91
12/06/2023,Expense,Adobe,Mike ross,Credit Card - Ramp,83.31,52389266.22
12/06/2023,Expense,Singapore Air,Harvey Spector,Credit Card - Ramp,14.03,52389280.25
12/06/2023,Expense,Singapore Air,Harvey Spector,Travel:Airfare,14.03,52389294.28
12/06/2023,Expense,Uber Eats,Mike ross,Meals & Entertainment,22.46,52389316.74
12/06/2023,Expense,Uber,Mike ross,Credit Card - Ramp,19.3,52389336.04
12/06/2023,Expense,Uber,Mike ross,Credit Card - Ramp,23.54,52389359.58
12/06/2023,Expense,Uber,Mike ross,Credit Card - Ramp,19.3,52389378.88
12/07/2023,Expense,Heroku,Balapavan Tirumani,Credit Card - Ramp,85,52389463.88
12/07/2023,Expense,Supabase,Harris Jose,Credit Card - Ramp,34.35,52389498.23
12/07/2023,Expense,Supabase,Harris Jose,Credit Card - Ramp,34.35,52389532.58
12/07/2023,Expense,Supabase,Harris Jose,Tools & Subscription - G&A,34.35,52389566.93
12/07/2023,Expense,Heroku,Balapavan Tirumani,Credit Card - Ramp,85,52389651.93
12/07/2023,Expense,Heroku,Balapavan Tirumani,Tools & Subscription - S&M,85,52389736.93
12/07/2023,Expense,Heroku,Balapavan Tirumani,Tools & Subscription - S&M,85,52389821.93
12/07/2023,Expense,Heroku,Balapavan Tirumani,Credit Card - Ramp,85,52389906.93
12/07/2023,Expense,Heroku,Balapavan Tirumani,Tools & Subscription - S&M,85,52389991.93
12/07/2023,Expense,Supabase,Harris Jose,Tools & Subscription - G&A,34.35,52390026.28
12/07/2023,Expense,Supabase,Harris Jose,Tools & Subscription - G&A,34.35,52390060.63
12/07/2023,Expense,Heroku,Balapavan Tirumani,Tools & Subscription - S&M,85,52390145.63
12/07/2023,Expense,Supabase,Harris Jose,Credit Card - Ramp,34.35,52390179.98
12/07/2023,Expense,Supabase,Harris Jose,Tools & Subscription - G&A,34.35,52390214.33
12/08/2023,Expense,Leonardo.ai,Mike ross,Tools & Subscription - G&A,132,52390346.33
12/08/2023,Expense,Leonardo.ai,Mike ross,Tools & Subscription - G&A,132,52390478.33
12/08/2023,Expense,Flight Darkfield Sydney,Mike ross,Credit Card - Ramp,36.08,52390514.41
12/08/2023,Expense,Flight Darkfield Sydney,Mike ross,Meals & Entertainment,36.08,52390550.49
12/08/2023,Expense,Flight Darkfield Sydney,Mike ross,Credit Card - Ramp,36.08,52390586.57
12/08/2023,Expense,Flight Darkfield Sydney,Mike ross,Credit Card - Ramp,36.08,52390622.65
12/08/2023,Expense,Flight Darkfield Sydney,Mike ross,Meals & Entertainment,36.08,52390658.73
12/08/2023,Expense,Leonardo.ai,Mike ross,Credit Card - Ramp,132,52390790.73
12/08/2023,Expense,Leonardo.ai,Mike ross,Tools & Subscription - G&A,132,52390922.73
12/08/2023,Expense,Flight Darkfield Sydney,Mike ross,Meals & Entertainment,36.08,52390958.81
12/08/2023,Expense,Leonardo.ai,Mike ross,Credit Card - Ramp,132,52391090.81
12/08/2023,Expense,Flight Darkfield Sydney,Mike ross,Meals & Entertainment,36.08,52391126.89
12/08/2023,Expense,Leonardo.ai,Mike ross,Tools & Subscription - G&A,132,52391258.89
12/08/2023,Expense,Flight Darkfield Sydney,Mike ross,Credit Card - Ramp,36.08,52391294.97
12/08/2023,Expense,Leonardo.ai,Mike ross,Credit Card - Ramp,132,52391426.97
12/09/2023,Expense,Usersnap,Harris Jose,Tools & Subscription - G&A,99,52391525.97
12/09/2023,Expense,OpenAI,Balapavan Tirumani,Tools & Subscription - G&A,20,52391545.97
12/09/2023,Expense,Uber,Mike ross,Travelling Expenses,21.61,52391567.58
12/09/2023,Expense,Uber,Mike ross,Travelling Expenses,20.48,52391588.06
12/09/2023,Expense,OpenAI,Balapavan Tirumani,Tools & Subscription - G&A,20,52391608.06
12/09/2023,Expense,OpenAI,Balapavan Tirumani,Credit Card - Ramp,20,52391628.06
12/09/2023,Expense,Uber,Mike ross,Travelling Expenses,21.61,52391649.67
12/09/2023,Expense,Usersnap,Harris Jose,Credit Card - Ramp,99,52391748.67
12/09/2023,Expense,Usersnap,Harris Jose,Tools & Subscription - G&A,99,52391847.67
12/09/2023,Expense,Uber,Mike ross,Credit Card - Ramp,20.48,52391868.15
12/09/2023,Expense,Uber,Mike ross,Travelling Expenses,20.48,52391888.63
12/09/2023,Expense,Usersnap,Harris Jose,Tools & Subscription - G&A,99,52391987.63
12/09/2023,Expense,Uber,Mike ross,Credit Card - Ramp,21.61,52392009.24
12/09/2023,Expense,OpenAI,Balapavan Tirumani,Tools & Subscription - G&A,20,52392029.24
12/09/2023,Expense,Uber,Mike ross,Credit Card - Ramp,21.61,52392050.85
12/09/2023,Expense,Uber,Mike ross,Travelling Expenses,20.48,52392071.33
12/09/2023,Expense,Uber,Mike ross,Travelling Expenses,21.61,52392092.94
12/09/2023,Expense,Usersnap,Harris Jose,Credit Card - Ramp,99,52392191.94
12/09/2023,Expense,Uber,Mike ross,Credit Card - Ramp,20.48,52392212.42
12/09/2023,Expense,OpenAI,Balapavan Tirumani,Tools & Subscription - G&A,20,52392232.42
12/09/2023,Expense,Uber,Mike ross,Travelling Expenses,21.61,52392254.03
12/09/2023,Expense,OpenAI,Balapavan Tirumani,Credit Card - Ramp,20,52392274.03
12/09/2023,Expense,Usersnap,Harris Jose,Tools & Subscription - G&A,99,52392373.03
12/09/2023,Expense,Usersnap,Harris Jose,Credit Card - Ramp,99,52392472.03
12/09/2023,Expense,Uber,Mike ross,Credit Card - Ramp,20.48,52392492.51
12/09/2023,Expense,Uber,Mike ross,Credit Card - Ramp,21.61,52392514.12
12/09/2023,Expense,Uber,Mike ross,Travelling Expenses,20.48,52392534.6
12/09/2023,Expense,OpenAI,Balapavan Tirumani,Credit Card - Ramp,20,52392554.6
12/10/2023,Expense,Zoom,Max Kausman,Tools & Subscription - G&A,15.99,52392570.59
12/10/2023,Expense,Pause Cafe,Harvey Spector,Meals & Entertainment,12,52392582.59
12/10/2023,Expense,Pause Cafe,Harvey Spector,Credit Card - Ramp,12,52392594.59
12/10/2023,Expense,Holly Cafe,Max Kausman,Meals & Entertainment,6.61,52392601.2
12/10/2023,Expense,Holly Cafe,Max Kausman,Credit Card - Ramp,6.61,52392607.81
12/10/2023,Expense,Amazon,Chris George,Credit Card - Ramp,24.56,52392632.37
12/10/2023,Expense,Zoom,Max Kausman,Credit Card - Ramp,15.99,52392648.36
12/10/2023,Expense,Pause Cafe,Harvey Spector,Meals & Entertainment,12,52392660.36
12/10/2023,Expense,Amazon,Chris George,Tools & Subscription - G&A,24.56,52392684.92
12/10/2023,Expense,Amazon,Chris George,Tools & Subscription - G&A,24.56,52392709.48
12/10/2023,Expense,Headout,Harvey Spector,Travelling Expenses,27.77,52392737.25
12/10/2023,Expense,Holly Cafe,Max Kausman,Meals & Entertainment,6.61,52392743.86
12/10/2023,Expense,Headout,Harvey Spector,Credit Card - Ramp,27.77,52392771.63
12/10/2023,Expense,Headout,Harvey Spector,Credit Card - Ramp,27.77,52392799.4
12/10/2023,Expense,Amazon Au,Chris George,Credit Card - Ramp,24.56,52392823.96
12/10/2023,Expense,Headout,Harvey Spector,Travelling Expenses,27.77,52392851.73
12/10/2023,Expense,Amazon Au,Chris George,Tools & Subscription,24.56,52392876.29
12/10/2023,Expense,Headout,Harvey Spector,Travelling Expenses,27.77,52392904.06
12/10/2023,Expense,Holly Cafe,Max Kausman,Meals & Entertainment,6.61,52392910.67
12/10/2023,Expense,Amazon Au,Chris George,Tools & Subscription,24.56,52392935.23
12/10/2023,Expense,Amazon,Chris George,Tools & Subscription - G&A,24.56,52392959.79
12/10/2023,Expense,Amazon Au,Chris George,Tools & Subscription,24.56,52392984.35
12/10/2023,Expense,Pause Cafe,Harvey Spector,Meals & Entertainment,12,52392996.35
12/10/2023,Expense,Amazon Au,Chris George,Tools & Subscription,24.56,52393020.91
12/10/2023,Expense,Amazon,Chris George,Tools & Subscription - G&A,24.56,52393045.47
12/10/2023,Expense,Zoom,Max Kausman,Tools & Subscription - G&A,15.99,52393061.46
12/10/2023,Expense,Holly Cafe,Max Kausman,Meals & Entertainment,6.61,52393068.07
12/10/2023,Expense,Pause Cafe,Harvey Spector,Meals & Entertainment,12,52393080.07
12/10/2023,Expense,Amazon Au,Chris George,Credit Card - Ramp,24.56,52393104.63
12/10/2023,Expense,Holly Cafe,Max Kausman,Credit Card - Ramp,6.61,52393111.24
12/10/2023,Expense,Pause Cafe,Harvey Spector,Credit Card - Ramp,12,52393123.24
12/10/2023,Expense,Amazon,Chris George,Credit Card - Ramp,24.56,52393147.8
12/10/2023,Expense,Zoom,Max Kausman,Credit Card - Ramp,15.99,52393163.79
12/10/2023,Expense,Headout,Harvey Spector,Credit Card - Ramp,27.77,52393191.56
12/10/2023,Expense,Zoom,Max Kausman,Tools & Subscription - G&A,15.99,52393207.55
12/10/2023,Expense,Headout,Harvey Spector,Travelling Expenses,27.77,52393235.32
12/10/2023,Expense,Pause Cafe,Harvey Spector,Credit Card - Ramp,12,52393247.32
12/10/2023,Expense,Amazon,Chris George,Credit Card - Ramp,24.56,52393271.88
12/10/2023,Expense,Zoom,Max Kausman,Credit Card - Ramp,15.99,52393287.87
12/10/2023,Expense,Holly Cafe,Max Kausman,Credit Card - Ramp,6.61,52393294.48
12/10/2023,Expense,Pause Cafe,Harvey Spector,Credit Card - Ramp,12,52393306.48
12/10/2023,Expense,Zoom,Max Kausman,Tools & Subscription - G&A,15.99,52393322.47
12/10/2023,Expense,Amazon Au,Chris George,Credit Card - Ramp,24.56,52393347.03
12/10/2023,Expense,Holly Cafe,Max Kausman,Credit Card - Ramp,6.61,52393353.64
12/11/2023,Expense,Uber Eats,Mike ross,Credit Card - Ramp,29.27,52393382.91
12/11/2023,Expense,Transport,Harvey Spector,Credit Card - Ramp,5.33,52393388.24
12/11/2023,Expense,Uber,Mike ross,Credit Card - Ramp,15.04,52393403.28
12/11/2023,Expense,Transport,Harvey Spector,Travelling Expenses,7.16,52393410.44
12/11/2023,Expense,Uber Eats,Mike ross,Meals & Entertainment,29.27,52393439.71
12/11/2023,Expense,Amazon,Chris George,Tools & Subscription - G&A,31.19,52393470.9
12/11/2023,Expense,Transport,Harvey Spector,Credit Card - Ramp,5.33,52393476.23
12/11/2023,Expense,Amazon,Chris George,Credit Card - Ramp,31.19,52393507.42
12/11/2023,Expense,Uber,Mike ross,Travelling Expenses,15.04,52393522.46
12/11/2023,Expense,Amazon,Chris George,Tools & Subscription - G&A,31.19,52393553.65
12/11/2023,Expense,Uber,Mike ross,Travelling Expenses,15.04,52393568.69
12/11/2023,Expense,Transport,Harvey Spector,Credit Card - Ramp,7.16,52393575.85
12/11/2023,Expense,Amazon,Chris George,Credit Card - Ramp,31.19,52393607.04
12/11/2023,Expense,Transport,Harvey Spector,Travelling Expenses,5.33,52393612.37
12/11/2023,Expense,Uber,Mike ross,Credit Card - Ramp,15.04,52393627.41
12/11/2023,Expense,Transport,Harvey Spector,Travelling Expenses,5.33,52393632.74
12/11/2023,Expense,Transport,Harvey Spector,Travelling Expenses,7.16,52393639.9
12/11/2023,Expense,Uber Eats,Mike ross,Meals & Entertainment,29.27,52393669.17
12/11/2023,Expense,Uber,Mike ross,Travelling Expenses,15.04,52393684.21
12/11/2023,Expense,Uber,Mike ross,Credit Card - Ramp,15.04,52393699.25
12/11/2023,Expense,Amazon,Chris George,Tools & Subscription - G&A,31.19,52393730.44
12/11/2023,Expense,Uber Eats,Mike ross,Credit Card - Ramp,29.27,52393759.71
12/11/2023,Expense,Uber Eats,Mike ross,Credit Card - Ramp,29.27,52393788.98
12/11/2023,Expense,Uber Eats,Mike ross,Meals & Entertainment,29.27,52393818.25
12/11/2023,Expense,Amazon,Chris George,Credit Card - Ramp,31.19,52393849.44
12/11/2023,Expense,Transport,Harvey Spector,Travelling Expenses,7.16,52393856.6
12/11/2023,Expense,Amazon,Chris George,Tools & Subscription - G&A,31.19,52393887.79
12/11/2023,Expense,Transport,Harvey Spector,Credit Card - Ramp,7.16,52393894.95
12/11/2023,Expense,Transport,Harvey Spector,Credit Card - Ramp,5.33,52393900.28
12/11/2023,Expense,Uber Eats,Mike ross,Credit Card - Ramp,29.27,52393929.55
12/11/2023,Expense,Transport,Harvey Spector,Credit Card - Ramp,7.16,52393936.71
12/11/2023,Expense,Transport,Harvey Spector,Travelling Expenses,5.33,52393942.04
12/11/2023,Expense,Uber Eats,Mike ross,Meals & Entertainment,29.27,52393971.31
12/11/2023,Expense,Uber,Mike ross,Travelling Expenses,15.04,52393986.35
12/11/2023,Expense,Transport,Harvey Spector,Travelling Expenses,7.16,52393993.51
12/11/2023,Expense,Transport,Harvey Spector,Travelling Expenses,5.33,52393998.84
12/12/2023,Expense,Transport,Harvey Spector,Credit Card - Ramp,7.16,52394006
12/12/2023,Expense,Amazon Pay,Harris Jose,Professional Service Charges,10.43,52394016.43
12/12/2023,Expense,Bat + Bun,Mike ross,Meals & Entertainment,21.12,52394037.55
12/12/2023,Expense,Adobe,Chris George,Tools & Subscription - S&M,20.99,52394058.54
12/12/2023,Expense,Careem,Harvey Spector,Credit Card - Ramp,11.96,52394070.5
12/12/2023,Expense,WordPress,Harris Jose,Credit Card - Ramp,15.57,52394086.07
12/12/2023,Expense,Careem,Harvey Spector,Travelling Expenses,11.96,52394098.03
12/12/2023,Expense,Transport,Harvey Spector,Travelling Expenses,7.16,52394105.19
12/12/2023,Expense,Amazon Pay,Harris Jose,Credit Card - Ramp,10.43,52394115.62
12/12/2023,Expense,Bat + Bun,Mike ross,Credit Card - Ramp,21.12,52394136.74
12/12/2023,Expense,Shroff Publishers and Distributors,Harris Jose,Credit Card - Ramp,18.64,52394155.38
12/12/2023,Expense,Careem,Harvey Spector,Travelling Expenses,11.96,52394167.34
12/12/2023,Expense,Adobe,Chris George,Tools & Subscription - S&M,20.99,52394188.33
12/12/2023,Expense,Shroff Publishers and Distributors,Harris Jose,General business expenses:Memberships & subscriptions,18.64,52394206.97
12/12/2023,Expense,Uber,Mike ross,Travelling Expenses,8.67,52394215.64
12/12/2023,Expense,Amazon Pay,Harris Jose,Credit Card - Ramp,10.43,52394226.07
12/12/2023,Expense,Careem,Harvey Spector,Travelling Expenses,11.96,52394238.03
12/12/2023,Expense,Transport,Harvey Spector,Travelling Expenses,7.16,52394245.19
12/12/2023,Expense,Bat + Bun,Mike ross,Credit Card - Ramp,21.12,52394266.31
12/12/2023,Expense,Bat + Bun,Mike ross,Meals & Entertainment,21.12,52394287.43
12/12/2023,Expense,Adobe,Chris George,Tools & Subscription - S&M,20.99,52394308.42
12/12/2023,Expense,Amazon Pay,Harris Jose,Professional Service Charges,10.43,52394318.85
12/12/2023,Expense,Adobe,Chris George,Tools & Subscription - S&M,20.99,52394339.84
12/12/2023,Expense,Uber,Mike ross,Travelling Expenses,8.67,52394348.51
12/12/2023,Expense,WordPress,Harris Jose,Tools & Subscription - G&A,15.57,52394364.08
12/12/2023,Expense,Shroff Publishers and Distributors,Harris Jose,General business expenses:Memberships & subscriptions,18.64,52394382.72
12/12/2023,Expense,Shroff Publishers and Distributors,Harris Jose,Credit Card - Ramp,18.64,52394401.36
12/12/2023,Expense,Adobe,Chris George,Credit Card - Ramp,20.99,52394422.35
12/12/2023,Expense,Bat + Bun,Mike ross,Meals & Entertainment,21.12,52394443.47
12/12/2023,Expense,Transport,Harvey Spector,Credit Card - Ramp,7.16,52394450.63
12/12/2023,Expense,Uber,Mike ross,Travelling Expenses,8.67,52394459.3
12/12/2023,Expense,Amazon Pay,Harris Jose,Professional Service Charges,10.43,52394469.73
12/12/2023,Expense,WordPress,Harris Jose,Tools & Subscription - G&A,15.57,52394485.3
12/12/2023,Expense,Amazon Pay,Harris Jose,Credit Card - Ramp,10.43,52394495.73
12/12/2023,Expense,Shroff Publishers and Distributors,Harris Jose,General business expenses:Memberships & subscriptions,18.64,52394514.37
12/12/2023,Expense,Shroff Publishers and Distributors,Harris Jose,General business expenses:Memberships & subscriptions,18.64,52394533.01
12/12/2023,Expense,Uber,Mike ross,Credit Card - Ramp,8.67,52394541.68
12/12/2023,Expense,Bat + Bun,Mike ross,Meals & Entertainment,21.12,52394562.8
12/12/2023,Expense,WordPress,Harris Jose,Credit Card - Ramp,15.57,52394578.37
12/12/2023,Expense,WordPress,Harris Jose,Tools & Subscription - G&A,15.57,52394593.94
12/12/2023,Expense,Uber,Mike ross,Travelling Expenses,8.67,52394602.61
12/12/2023,Expense,Adobe,Chris George,Credit Card - Ramp,20.99,52394623.6
12/12/2023,Expense,Shroff Publishers and Distributors,Harris Jose,Credit Card - Ramp,18.64,52394642.24
12/12/2023,Expense,Bat + Bun,Mike ross,Credit Card - Ramp,21.12,52394663.36
12/12/2023,Expense,Amazon Pay,Harris Jose,Professional Service Charges,10.43,52394673.79
12/12/2023,Expense,Careem,Harvey Spector,Credit Card - Ramp,11.96,52394685.75
12/12/2023,Expense,WordPress,Harris Jose,Credit Card - Ramp,15.57,52394701.32
12/12/2023,Expense,Uber,Mike ross,Credit Card - Ramp,8.67,52394709.99
12/12/2023,Expense,WordPress,Harris Jose,Tools & Subscription - G&A,15.57,52394725.56
12/12/2023,Expense,Careem,Harvey Spector,Travelling Expenses,11.96,52394737.52
12/12/2023,Expense,Transport,Harvey Spector,Travelling Expenses,7.16,52394744.68
12/12/2023,Expense,Uber,Mike ross,Credit Card - Ramp,8.67,52394753.35
12/12/2023,Expense,Careem,Harvey Spector,Credit Card - Ramp,11.96,52394765.31
12/12/2023,Expense,Transport,Harvey Spector,Travelling Expenses,7.16,52394772.47
12/12/2023,Expense,Adobe,Chris George,Credit Card - Ramp,20.99,52394793.46
12/12/2023,Expense,Transport,Harvey Spector,Credit Card - Ramp,7.16,52394800.62
12/12/2023,Expense,Bat + Bun,Mike ross,Credit Card - Ramp,21.12,52394821.74
12/12/2023,Expense,Shroff Publishers and Distributors,Harris Jose,Credit Card - Ramp,18.64,52394840.38
12/12/2023,Expense,Amazon Pay,Harris Jose,Credit Card - Ramp,10.43,52394850.81
12/13/2023,Expense,Figma,Mike ross,Tools & Subscription - G&A,70,52394920.81
12/13/2023,Expense,Telstra,Mike ross,Credit Card - Ramp,42.24,52394963.05
12/13/2023,Expense,Lenny Rachitsky,Max Kausman,Credit Card - Ramp,15,52394978.05
12/13/2023,Expense,Figma,Mike ross,Credit Card - Ramp,70,52395048.05
12/13/2023,Expense,Telstra,Mike ross,Utilities:Internet & TV services,42.24,52395090.29
12/13/2023,Expense,Lenny Rachitsky,Max Kausman,General business expenses:Memberships & subscriptions,15,52395105.29
12/13/2023,Expense,Vercel,Harris Jose,Credit Card - Ramp,240,52395345.29
12/13/2023,Expense,Telstra,Mike ross,Utilities:Internet & TV services,42.24,52395387.53
12/13/2023,Expense,Figma,Mike ross,Credit Card - Ramp,70,52395457.53
12/13/2023,Expense,Figma,Mike ross,Tools & Subscription - G&A,70,52395527.53
12/13/2023,Expense,Lenny Rachitsky,Max Kausman,Credit Card - Ramp,15,52395542.53
12/13/2023,Expense,Vercel,Harris Jose,Credit Card - Ramp,240,52395782.53
12/13/2023,Expense,Lenny Rachitsky,Max Kausman,General business expenses:Memberships & subscriptions,15,52395797.53
12/13/2023,Expense,Lenny Rachitsky,Max Kausman,Credit Card - Ramp,15,52395812.53
12/13/2023,Expense,Vercel,Harris Jose,Credit Card - Ramp,240,52396052.53
12/13/2023,Expense,Lenny Rachitsky,Max Kausman,General business expenses:Memberships & subscriptions,15,52396067.53
12/13/2023,Expense,Telstra,Mike ross,Utilities:Internet & TV services,42.24,52396109.77
12/13/2023,Expense,Lenny Rachitsky,Max Kausman,Credit Card - Ramp,15,52396124.77
12/13/2023,Expense,Vercel,Harris Jose,Tools & Subscription - G&A,240,52396364.77
12/13/2023,Expense,Vercel,Harris Jose,Tools & Subscription - G&A,240,52396604.77
12/13/2023,Expense,Figma,Mike ross,Tools & Subscription - G&A,70,52396674.77
12/13/2023,Expense,Lenny Rachitsky,Max Kausman,General business expenses:Memberships & subscriptions,15,52396689.77
12/13/2023,Expense,Vercel,Harris Jose,Tools & Subscription - G&A,240,52396929.77
12/13/2023,Expense,Figma,Mike ross,Credit Card - Ramp,70,52396999.77
12/13/2023,Expense,Telstra,Mike ross,Credit Card - Ramp,42.24,52397042.01
12/13/2023,Expense,Vercel,Harris Jose,Tools & Subscription - G&A,240,52397282.01
12/13/2023,Expense,Telstra,Mike ross,Utilities:Internet & TV services,42.24,52397324.25
12/13/2023,Expense,Figma,Mike ross,Tools & Subscription - G&A,70,52397394.25
12/13/2023,Expense,Telstra,Mike ross,Credit Card - Ramp,42.24,52397436.49
12/14/2023,Expense,Cars Taxi,Harvey Spector,Credit Card - Ramp,7.79,52397444.28
12/14/2023,Expense,Notion Labs,Harvey Spector,Credit Card - Ramp,10,52397454.28
12/14/2023,Expense,Cars Taxi,Harvey Spector,Credit Card - Ramp,7.79,52397462.07
12/14/2023,Expense,BPCO,Mike ross,Meals & Entertainment,89.38,52397551.45
12/14/2023,Expense,Notion Labs,Harvey Spector,Tools & Subscription - G&A,10,52397561.45
12/14/2023,Expense,Sparrows Leura,Mike ross,Meals & Entertainment,30.6,52397592.05
12/14/2023,Expense,Mountain Culture Beer Co,Mike ross,Meals & Entertainment,28.88,52397620.93
12/14/2023,Expense,Serenity Kids,Mike ross,Meals & Entertainment,67.42,52397688.35
12/14/2023,Expense,Sparrows Leura,Mike ross,Meals & Entertainment,30.6,52397718.95
12/14/2023,Expense,Sparrows Leura,Mike ross,Credit Card - Ramp,30.6,52397749.55
12/14/2023,Expense,Cars Taxi,Harvey Spector,Travelling Expenses,7.79,52397757.34
12/14/2023,Expense,Sparrows Leura,Mike ross,Credit Card - Ramp,30.6,52397787.94
12/14/2023,Expense,Mountain Culture Beer Co,Mike ross,Credit Card - Ramp,28.88,52397816.82
12/14/2023,Expense,Serenity Kids,Mike ross,Credit Card - Ramp,67.42,52397884.24
12/14/2023,Expense,Mountain Culture Beer Co,Mike ross,Credit Card - Ramp,28.88,52397913.12
12/14/2023,Expense,Sparrows Leura,Mike ross,Credit Card - Ramp,30.6,52397943.72
12/14/2023,Expense,BPCO,Mike ross,Credit Card - Ramp,89.38,52398033.1
12/14/2023,Expense,Notion Labs,Harvey Spector,Tools & Subscription - G&A,10,52398043.1
12/14/2023,Expense,Cars Taxi,Harvey Spector,Travelling Expenses,9.82,52398052.92
12/14/2023,Expense,Serenity Kids,Mike ross,Credit Card - Ramp,67.42,52398120.34
12/14/2023,Expense,Notion Labs,Harvey Spector,Credit Card - Ramp,10,52398130.34
12/14/2023,Expense,Mountain Culture Beer Co,Mike ross,Credit Card - Ramp,28.88,52398159.22
12/14/2023,Expense,Mountain Culture Beer Co,Mike ross,Meals & Entertainment,28.88,52398188.1
12/14/2023,Expense,Serenity Kids,Mike ross,Credit Card - Ramp,67.42,52398255.52
12/14/2023,Expense,BPCO,Mike ross,Credit Card - Ramp,89.38,52398344.9
12/14/2023,Expense,BPCO,Mike ross,Meals & Entertainment,89.38,52398434.28
12/14/2023,Expense,Mountain Culture Beer Co,Mike ross,Credit Card - Ramp,28.88,52398463.16
12/14/2023,Expense,Notion Labs,Harvey Spector,Tools & Subscription - G&A,10,52398473.16
12/14/2023,Expense,Cars Taxi,Harvey Spector,Travelling Expenses,9.82,52398482.98
12/14/2023,Expense,Serenity Kids,Mike ross,Meals & Entertainment,67.42,52398550.4
12/14/2023,Expense,Sparrows Leura,Mike ross,Meals & Entertainment,30.6,52398581
12/14/2023,Expense,BPCO,Mike ross,Meals & Entertainment,89.38,52398670.38
12/14/2023,Expense,Cars Taxi,Harvey Spector,Credit Card - Ramp,9.82,52398680.2
12/14/2023,Expense,Cars Taxi,Harvey Spector,Travelling Expenses,7.79,52398687.99
12/14/2023,Expense,Notion Labs,Harvey Spector,Tools & Subscription - G&A,10,52398697.99
12/14/2023,Expense,Cars Taxi,Harvey Spector,Credit Card - Ramp,7.79,52398705.78
12/14/2023,Expense,Cars Taxi,Harvey Spector,Credit Card - Ramp,9.82,52398715.6
12/14/2023,Expense,Serenity Kids,Mike ross,Meals & Entertainment,67.42,52398783.02
12/14/2023,Expense,Notion Labs,Harvey Spector,Credit Card - Ramp,10,52398793.02
12/14/2023,Expense,Sparrows Leura,Mike ross,Meals & Entertainment,30.6,52398823.62
12/14/2023,Expense,Cars Taxi,Harvey Spector,Travelling Expenses,9.82,52398833.44
12/14/2023,Expense,Mountain Culture Beer Co,Mike ross,Meals & Entertainment,28.88,52398862.32
12/14/2023,Expense,Serenity Kids,Mike ross,Credit Card - Ramp,67.42,52398929.74
12/14/2023,Expense,BPCO,Mike ross,Credit Card - Ramp,89.38,52399019.12
12/14/2023,Expense,BPCO,Mike ross,Meals & Entertainment,89.38,52399108.5
12/14/2023,Expense,Serenity Kids,Mike ross,Meals & Entertainment,67.42,52399175.92
12/14/2023,Expense,Cars Taxi,Harvey Spector,Travelling Expenses,9.82,52399185.74
12/14/2023,Expense,Sparrows Leura,Mike ross,Credit Card - Ramp,30.6,52399216.34
12/14/2023,Expense,BPCO,Mike ross,Credit Card - Ramp,89.38,52399305.72
12/14/2023,Expense,Cars Taxi,Harvey Spector,Travelling Expenses,7.79,52399313.51
12/14/2023,Expense,Mountain Culture Beer Co,Mike ross,Meals & Entertainment,28.88,52399342.39
12/14/2023,Expense,Cars Taxi,Harvey Spector,Travelling Expenses,7.79,52399350.18
12/14/2023,Expense,Cars Taxi,Harvey Spector,Credit Card - Ramp,9.82,52399360
12/15/2023,Expense,GM Cabs,Max Kausman,Travelling Expenses,49.36,52399409.36
12/15/2023,Expense,Woolworths,Mike ross,Credit Card - Ramp,12.86,52399422.22
12/15/2023,Expense,GM Cabs,Max Kausman,Credit Card - Ramp,49.36,52399471.58
12/15/2023,Expense,Black Cockatoo Bakery,Mike ross,Credit Card - Ramp,15.25,52399486.83
12/15/2023,Expense,Woolworths,Mike ross,Meals & Entertainment,12.86,52399499.69
12/15/2023,Bill,ANSR Dubai,Reimbursement of Mobile Cost ANSREMEA/055,Accounts Payable (A/P),2026,52401525.69
12/15/2023,Expense,Black Cockatoo Bakery,Mike ross,Credit Card - Ramp,15.25,52401540.94
12/15/2023,Expense,Woolworths,Mike ross,Credit Card - Ramp,12.86,52401553.8
12/15/2023,Bill,ANSR Dubai,Service Fees for December 2023,Accounts Payable (A/P),10874,52412427.8
12/15/2023,Expense,GM Cabs,Max Kausman,Credit Card - Ramp,49.36,52412477.16
12/15/2023,Expense,Black Cockatoo Bakery,Mike ross,Credit Card - Ramp,15.25,52412492.41
12/15/2023,Expense,Black Cockatoo Bakery,Mike ross,Meals & Entertainment,15.25,52412507.66
12/15/2023,Expense,GM Cabs,Max Kausman,Travelling Expenses,49.36,52412557.02
12/15/2023,Expense,Black Cockatoo Bakery,Mike ross,Meals & Entertainment,15.25,52412572.27
12/15/2023,Bill,ANSR Dubai,Service Fees for December 2023,Accounts Payable (A/P),10874,52423446.27
12/15/2023,Expense,Woolworths,Mike ross,Credit Card - Ramp,12.86,52423459.13
12/15/2023,Expense,Black Cockatoo Bakery,Mike ross,Credit Card - Ramp,15.25,52423474.38
12/15/2023,Bill,ANSR Dubai,,-Split-,12900,52436374.38
12/15/2023,Expense,Woolworths,Mike ross,Meals & Entertainment,12.86,52436387.24
12/15/2023,Expense,Woolworths,Mike ross,Meals & Entertainment,12.86,52436400.1
12/15/2023,Bill,ANSR Dubai,Reimbursement of Mobile Cost ANSREMEA/055,Accounts Payable (A/P),2026,52438426.1
12/15/2023,Bill,ANSR Dubai,,-Split-,12900,52451326.1
12/15/2023,Bill,ANSR Dubai,,-Split-,12900,52464226.1
12/15/2023,Bill,ANSR Dubai,Reimbursement of Mobile Cost ANSREMEA/055,Accounts Payable (A/P),2026,52466252.1
12/15/2023,Expense,GM Cabs,Max Kausman,Credit Card - Ramp,49.36,52466301.46
12/15/2023,Bill,ANSR Dubai,Reimbursement of Mobile Cost ANSREMEA/055,Accounts Payable (A/P),2026,52468327.46
12/15/2023,Bill,ANSR Dubai,,-Split-,12900,52481227.46
12/15/2023,Expense,Black Cockatoo Bakery,Mike ross,Meals & Entertainment,15.25,52481242.71
12/15/2023,Expense,Black Cockatoo Bakery,Mike ross,Meals & Entertainment,15.25,52481257.96
12/15/2023,Expense,Woolworths,Mike ross,Meals & Entertainment,12.86,52481270.82
12/15/2023,Bill,ANSR Dubai,Service Fees for December 2023,Accounts Payable (A/P),10874,52492144.82
12/15/2023,Bill,ANSR Dubai,Service Fees for December 2023,Accounts Payable (A/P),10874,52503018.82
12/15/2023,Expense,GM Cabs,Max Kausman,Travelling Expenses,49.36,52503068.18
12/15/2023,Expense,Woolworths,Mike ross,Credit Card - Ramp,12.86,52503081.04
12/15/2023,Expense,GM Cabs,Max Kausman,Travelling Expenses,49.36,52503130.4
12/16/2023,Expense,Megalong Valley Tea R,Mike ross,Credit Card - Ramp,61.39,52503191.79
12/16/2023,Expense,Mountain Culture Beer Co,Mike ross,Meals & Entertainment,26.35,52503218.14
12/16/2023,Expense,Mountain Culture Beer Co,Mike ross,Credit Card - Ramp,23.58,52503241.72
12/16/2023,Expense,Megalong Valley Tea R,Mike ross,Travelling Expenses,61.39,52503303.11
12/16/2023,Expense,Ates Blackheath,Mike ross,Meals & Entertainment,325.29,52503628.4
12/16/2023,Expense,Mountain Culture Beer Co,Mike ross,Meals & Entertainment,23.58,52503651.98
12/16/2023,Expense,Megalong Valley Tea R,Mike ross,Travelling Expenses,61.39,52503713.37
12/16/2023,Expense,Ates Blackheath,Mike ross,Meals & Entertainment,325.29,52504038.66
12/16/2023,Expense,Megalong Valley Tea R,Mike ross,Travelling Expenses,61.39,52504100.05
12/16/2023,Expense,Ates Blackheath,Mike ross,Meals & Entertainment,325.29,52504425.34
12/16/2023,Expense,Mountain Culture Beer Co,Mike ross,Meals & Entertainment,23.58,52504448.92
12/16/2023,Expense,Megalong Valley Tea R,Mike ross,Credit Card - Ramp,61.39,52504510.31
12/16/2023,Expense,Mountain Culture Beer Co,Mike ross,Credit Card - Ramp,26.35,52504536.66
12/16/2023,Expense,Mountain Culture Beer Co,Mike ross,Meals & Entertainment,26.35,52504563.01
12/16/2023,Expense,Ates Blackheath,Mike ross,Credit Card - Ramp,325.29,52504888.3
12/16/2023,Expense,Mountain Culture Beer Co,Mike ross,Meals & Entertainment,26.35,52504914.65
12/16/2023,Expense,Mountain Culture Beer Co,Mike ross,Credit Card - Ramp,23.58,52504938.23
12/16/2023,Expense,Mountain Culture Beer Co,Mike ross,Credit Card - Ramp,26.35,52504964.58
12/16/2023,Expense,Mountain Culture Beer Co,Mike ross,Credit Card - Ramp,23.58,52504988.16
12/16/2023,Expense,Mountain Culture Beer Co,Mike ross,Credit Card - Ramp,26.35,52505014.51
12/16/2023,Expense,Mountain Culture Beer Co,Mike ross,Credit Card - Ramp,23.58,52505038.09
12/16/2023,Expense,Ates Blackheath,Mike ross,Credit Card - Ramp,325.29,52505363.38
12/16/2023,Expense,Ates Blackheath,Mike ross,Credit Card - Ramp,325.29,52505688.67
12/16/2023,Expense,Mountain Culture Beer Co,Mike ross,Credit Card - Ramp,26.35,52505715.02
12/16/2023,Expense,Mountain Culture Beer Co,Mike ross,Meals & Entertainment,23.58,52505738.6
12/16/2023,Expense,Mountain Culture Beer Co,Mike ross,Meals & Entertainment,23.58,52505762.18
12/16/2023,Expense,Ates Blackheath,Mike ross,Meals & Entertainment,325.29,52506087.47
12/16/2023,Expense,Megalong Valley Tea R,Mike ross,Travelling Expenses,61.39,52506148.86
12/16/2023,Expense,Mountain Culture Beer Co,Mike ross,Meals & Entertainment,26.35,52506175.21
12/16/2023,Expense,Megalong Valley Tea R,Mike ross,Credit Card - Ramp,61.39,52506236.6
12/16/2023,Expense,Ates Blackheath,Mike ross,Credit Card - Ramp,325.29,52506561.89
12/17/2023,Expense,Uber,Mike ross,Travelling Expenses,20.36,52506582.25
12/17/2023,Expense,Uber,Mike ross,Travelling Expenses,20.36,52506602.61
12/17/2023,Expense,Uber,Mike ross,Credit Card - Ramp,20.36,52506622.97
12/17/2023,Expense,Uber,Mike ross,Travelling Expenses,20.36,52506643.33
12/17/2023,Expense,Uber,Mike ross,Travelling Expenses,20.36,52506663.69
12/17/2023,Expense,Uber,Mike ross,Credit Card - Ramp,20.36,52506684.05
12/17/2023,Expense,Uber,Mike ross,Credit Card - Ramp,20.36,52506704.41
12/18/2023,Expense,Taj Indian Sweets & Restaurant,Mike ross,Credit Card - Ramp,20.59,52506725
12/18/2023,Expense,Reclaim.ai,Max Kausman,Credit Card - Ramp,8,52506733
12/18/2023,Expense,Loom,Mike ross,Credit Card - Ramp,59.27,52506792.27
12/18/2023,Expense,Josh Comeau,Ahielan Ravichandran,Credit Card - Ramp,176.71,52506968.98
12/18/2023,Expense,Github,Mike ross,Credit Card - Ramp,100,52507068.98
12/18/2023,Expense,Intuit,Harvey Spector,Tools & Subscription - G&A,60,52507128.98
12/18/2023,Expense,Taj Indian Sweets & Restaurant,Mike ross,Meals & Entertainment,20.59,52507149.57
12/18/2023,Expense,Loom,Mike ross,Tools & Subscription - G&A,59.27,52507208.84
12/18/2023,Expense,Intuit,Harvey Spector,Credit Card - Ramp,60,52507268.84
12/18/2023,Expense,Loom,Mike ross,Tools & Subscription - G&A,59.27,52507328.11
12/18/2023,Expense,Uber,Mike ross,Credit Card - Ramp,12.7,52507340.81
12/18/2023,Expense,Github,Mike ross,Credit Card - Ramp,100,52507440.81
12/18/2023,Expense,,MONTHLY CHARGE Bank Charges for the per 01NOV2023 TO 30NOV2023 Invoice No 1747064,General business expenses:Bank fees & service charges,-35.93,52507404.88
12/18/2023,Expense,Reclaim.ai,Max Kausman,Tools & Subscription - G&A,8,52507412.88
12/18/2023,Expense,Uber,Mike ross,Credit Card - Ramp,12.7,52507425.58
12/18/2023,Expense,Loom,Mike ross,Credit Card - Ramp,59.27,52507484.85
12/18/2023,Expense,Josh Comeau,Ahielan Ravichandran,Credit Card - Ramp,176.71,52507661.56
12/18/2023,Expense,Intuit,Harvey Spector,Credit Card - Ramp,60,52507721.56
12/18/2023,Expense,Reclaim.ai,Max Kausman,Credit Card - Ramp,8,52507729.56
12/18/2023,Expense,Josh Comeau,Ahielan Ravichandran,Tools & Subscription - G&A,176.71,52507906.27
12/18/2023,Expense,,MONTHLY CHARGE Bank Charges for the per 01NOV2023 TO 30NOV2023 Invoice No 1747064,General business expenses:Bank fees & service charges,-35.93,52507870.34
12/18/2023,Expense,Uber,Mike ross,Travelling Expenses,12.7,52507883.04
12/18/2023,Expense,Loom,Mike ross,Tools & Subscription - G&A,59.27,52507942.31
12/18/2023,Expense,Taj Indian Sweets & Restaurant,Mike ross,Meals & Entertainment,20.59,52507962.9
12/18/2023,Expense,Intuit,Harvey Spector,Tools & Subscription - G&A,60,52508022.9
12/18/2023,Expense,Github,Mike ross,Tools & Subscription - G&A,100,52508122.9
12/18/2023,Expense,Taj Indian Sweets & Restaurant,Mike ross,Credit Card - Ramp,20.59,52508143.49
12/18/2023,Expense,,Fees,HSBC A/c,35.93,52508179.42
12/18/2023,Expense,Taj Indian Sweets & Restaurant,Mike ross,Credit Card - Ramp,20.59,52508200.01
12/18/2023,Expense,,Fees,HSBC A/c,35.93,52508235.94
12/18/2023,Expense,Github,Mike ross,Tools & Subscription - G&A,100,52508335.94
12/18/2023,Expense,Josh Comeau,Ahielan Ravichandran,Tools & Subscription - G&A,176.71,52508512.65
12/18/2023,Expense,Taj Indian Sweets & Restaurant,Mike ross,Credit Card - Ramp,20.59,52508533.24
12/18/2023,Expense,,MONTHLY CHARGE Bank Charges for the per 01NOV2023 TO 30NOV2023 Invoice No 1747064,General business expenses:Bank fees & service charges,-35.93,52508497.31
12/18/2023,Expense,Uber,Mike ross,Credit Card - Ramp,12.7,52508510.01
12/18/2023,Expense,,MONTHLY CHARGE Bank Charges for the per 01NOV2023 TO 30NOV2023 Invoice No 1747064,General business expenses:Bank fees & service charges,-35.93,52508474.08
12/18/2023,Expense,Github,Mike ross,Credit Card - Ramp,100,52508574.08
12/18/2023,Expense,Loom,Mike ross,Credit Card - Ramp,59.27,52508633.35
12/18/2023,Expense,Josh Comeau,Ahielan Ravichandran,Credit Card - Ramp,176.71,52508810.06
12/18/2023,Expense,Intuit,Harvey Spector,Credit Card - Ramp,60,52508870.06
12/18/2023,Expense,Josh Comeau,Ahielan Ravichandran,Tools & Subscription - G&A,176.71,52509046.77
12/18/2023,Expense,Github,Mike ross,Tools & Subscription - G&A,100,52509146.77
12/18/2023,Expense,Reclaim.ai,Max Kausman,Tools & Subscription - G&A,8,52509154.77
12/18/2023,Expense,Josh Comeau,Ahielan Ravichandran,Tools & Subscription - G&A,176.71,52509331.48
12/18/2023,Expense,Reclaim.ai,Max Kausman,Credit Card - Ramp,8,52509339.48
12/18/2023,Expense,Uber,Mike ross,Travelling Expenses,12.7,52509352.18
12/18/2023,Expense,Github,Mike ross,Tools & Subscription - G&A,100,52509452.18
12/18/2023,Expense,Uber,Mike ross,Travelling Expenses,12.7,52509464.88
12/18/2023,Expense,Reclaim.ai,Max Kausman,Tools & Subscription - G&A,8,52509472.88
12/18/2023,Expense,Uber,Mike ross,Travelling Expenses,12.7,52509485.58
12/18/2023,Expense,Intuit,Harvey Spector,Tools & Subscription - G&A,60,52509545.58
12/18/2023,Expense,,Fees,HSBC A/c,35.93,52509581.51
12/18/2023,Expense,Taj Indian Sweets & Restaurant,Mike ross,Meals & Entertainment,20.59,52509602.1
12/18/2023,Expense,,Fees,HSBC A/c,35.93,52509638.03
12/18/2023,Expense,Intuit,Harvey Spector,Tools & Subscription - G&A,60,52509698.03
12/18/2023,Expense,Taj Indian Sweets & Restaurant,Mike ross,Meals & Entertainment,20.59,52509718.62
12/18/2023,Expense,Reclaim.ai,Max Kausman,Tools & Subscription - G&A,8,52509726.62
12/18/2023,Expense,Loom,Mike ross,Tools & Subscription - G&A,59.27,52509785.89
12/19/2023,Expense,Lemsqzy Nan-Courses,Harris Jose,Credit Card - Ramp,119,52509904.89
12/19/2023,Expense,Island Style Clothing,Mike ross,Meals & Entertainment,40.94,52509945.83
12/19/2023,Expense,Bailey Nelson,Mike ross,Credit Card - Ramp,426.12,52510371.95
12/19/2023,Expense,Island Style Clothing,Mike ross,Credit Card - Ramp,40.94,52510412.89
12/19/2023,Expense,ima,Mike ross,Credit Card - Ramp,10.42,52510423.31
12/19/2023,Expense,ima,Mike ross,Meals & Entertainment,10.42,52510433.73
12/19/2023,Expense,Lemsqzy Nan-Courses,Harris Jose,Credit Card - Ramp,119,52510552.73
12/19/2023,Expense,ima,Mike ross,Meals & Entertainment,10.42,52510563.15
12/19/2023,Expense,Island Style Clothing,Mike ross,Meals & Entertainment,40.94,52510604.09
12/19/2023,Expense,Bailey Nelson,Mike ross,Meals & Entertainment,426.12,52511030.21
12/19/2023,Expense,Lemsqzy Nan-Courses,Harris Jose,Tools & Subscription - G&A,119,52511149.21
12/19/2023,Expense,Bailey Nelson,Mike ross,Meals & Entertainment,426.12,52511575.33
12/19/2023,Expense,Island Style Clothing,Mike ross,Credit Card - Ramp,40.94,52511616.27
12/19/2023,Expense,Lemsqzy Nan-Courses,Harris Jose,Tools & Subscription - G&A,119,52511735.27
12/19/2023,Expense,ima,Mike ross,Meals & Entertainment,10.42,52511745.69
12/19/2023,Expense,Bailey Nelson,Mike ross,Credit Card - Ramp,426.12,52512171.81
12/19/2023,Expense,ima,Mike ross,Credit Card - Ramp,10.42,52512182.23
12/19/2023,Expense,Island Style Clothing,Mike ross,Credit Card - Ramp,40.94,52512223.17
12/19/2023,Expense,ima,Mike ross,Meals & Entertainment,10.42,52512233.59
12/19/2023,Expense,ima,Mike ross,Credit Card - Ramp,10.42,52512244.01
12/19/2023,Expense,Bailey Nelson,Mike ross,Meals & Entertainment,426.12,52512670.13
12/19/2023,Expense,Bailey Nelson,Mike ross,Credit Card - Ramp,426.12,52513096.25
12/19/2023,Expense,Lemsqzy Nan-Courses,Harris Jose,Tools & Subscription - G&A,119,52513215.25
12/19/2023,Expense,Island Style Clothing,Mike ross,Meals & Entertainment,40.94,52513256.19
12/19/2023,Expense,Lemsqzy Nan-Courses,Harris Jose,Credit Card - Ramp,119,52513375.19
12/19/2023,Expense,ima,Mike ross,Credit Card - Ramp,10.42,52513385.61
12/19/2023,Expense,Bailey Nelson,Mike ross,Credit Card - Ramp,426.12,52513811.73
12/19/2023,Expense,Island Style Clothing,Mike ross,Credit Card - Ramp,40.94,52513852.67
12/19/2023,Expense,Bailey Nelson,Mike ross,Meals & Entertainment,426.12,52514278.79
12/19/2023,Expense,Lemsqzy Nan-Courses,Harris Jose,Tools & Subscription - G&A,119,52514397.79
12/19/2023,Expense,Island Style Clothing,Mike ross,Meals & Entertainment,40.94,52514438.73
12/20/2023,Expense,BuildBetter,Max Kausman,Tools & Subscription - G&A,100,52514538.73
12/20/2023,Expense,Ariel Booksellers,Mike ross,Credit Card - Ramp,150.74,52514689.47
12/20/2023,Credit Card Payment,RAMP BUSINESS CO,RAMP STATEMENT,Credit Card - Ramp,-7704.29,52506985.18
12/20/2023,Expense,BuildBetter,Max Kausman,Credit Card - Ramp,100,52507085.18
12/20/2023,Expense,BuildBetter,Max Kausman,Tools & Subscription - G&A,100,52507185.18
12/20/2023,Expense,The Carrington,Mike ross,Meals & Entertainment,43,52507228.18
12/20/2023,Credit Card Payment,RAMP BUSINESS CO,RAMP STATEMENT,Credit Card - Ramp,-7704.29,52499523.89
12/20/2023,Expense,BuildBetter,Max Kausman,Credit Card - Ramp,100,52499623.89
12/20/2023,Credit Card Payment,RAMP BUSINESS CO,RAMP STATEMENT,Account1,-7704.29,52491919.6
12/20/2023,Expense,The Carrington,Mike ross,Credit Card - Ramp,43,52491962.6
12/20/2023,Expense,The Carrington,Mike ross,Meals & Entertainment,43,52492005.6
12/20/2023,Expense,The Carrington,Mike ross,Credit Card - Ramp,43,52492048.6
12/20/2023,Credit Card Payment,RAMP BUSINESS CO,RAMP STATEMENT,Account1,-7704.29,52484344.31
12/20/2023,Expense,Ariel Booksellers,Mike ross,General business expenses:Memberships & subscriptions,150.74,52484495.05
12/20/2023,Expense,Ariel Booksellers,Mike ross,General business expenses:Memberships & subscriptions,150.74,52484645.79
12/20/2023,Expense,The Carrington,Mike ross,Credit Card - Ramp,43,52484688.79
12/20/2023,Expense,BuildBetter,Max Kausman,Credit Card - Ramp,100,52484788.79
12/20/2023,Expense,BuildBetter,Max Kausman,Tools & Subscription - G&A,100,52484888.79
12/20/2023,Expense,The Carrington,Mike ross,Meals & Entertainment,43,52484931.79
12/20/2023,Expense,Ariel Booksellers,Mike ross,General business expenses:Memberships & subscriptions,150.74,52485082.53
12/20/2023,Credit Card Payment,RAMP BUSINESS CO,RAMP STATEMENT,Credit Card - Ramp,-7704.29,52477378.24
12/20/2023,Credit Card Payment,RAMP BUSINESS CO,RAMP STATEMENT,Credit Card - Ramp,-7704.29,52469673.95
12/20/2023,Expense,The Carrington,Mike ross,Credit Card - Ramp,43,52469716.95
12/20/2023,Expense,BuildBetter,Max Kausman,Tools & Subscription - G&A,100,52469816.95
12/20/2023,Expense,Ariel Booksellers,Mike ross,General business expenses:Memberships & subscriptions,150.74,52469967.69
12/20/2023,Expense,Ariel Booksellers,Mike ross,Credit Card - Ramp,150.74,52470118.43
12/20/2023,Expense,Ariel Booksellers,Mike ross,Credit Card - Ramp,150.74,52470269.17
12/20/2023,Credit Card Payment,RAMP BUSINESS CO,RAMP STATEMENT,Account1,-7704.29,52462564.88
12/20/2023,Credit Card Payment,RAMP BUSINESS CO,RAMP STATEMENT,Account1,-7704.29,52454860.59
12/20/2023,Expense,Ariel Booksellers,Mike ross,Credit Card - Ramp,150.74,52455011.33
12/20/2023,Expense,The Carrington,Mike ross,Meals & Entertainment,43,52455054.33
12/21/2023,Expense,Uber Eats,Mike ross,Credit Card - Ramp,27.71,52455082.04
12/21/2023,Expense,Uber,Mike ross,Credit Card - Ramp,11.03,52455093.07
12/21/2023,Expense,Uber,Mike ross,Travelling Expenses,11.03,52455104.1
12/21/2023,Expense,Uber Eats,Mike ross,Credit Card - Ramp,27.71,52455131.81
12/21/2023,Expense,Uber,Mike ross,Travelling Expenses,11.03,52455142.84
12/21/2023,Expense,Uber Eats,Mike ross,Meals & Entertainment,27.71,52455170.55
12/21/2023,Expense,Uber,Mike ross,Travelling Expenses,11.03,52455181.58
12/21/2023,Expense,Uber,Mike ross,Credit Card - Ramp,11.03,52455192.61
12/21/2023,Expense,Uber,Mike ross,Travelling Expenses,11.03,52455203.64
12/21/2023,Expense,Uber Eats,Mike ross,Meals & Entertainment,27.71,52455231.35
12/21/2023,Expense,Uber,Mike ross,Credit Card - Ramp,11.03,52455242.38
12/21/2023,Expense,Uber Eats,Mike ross,Credit Card - Ramp,27.71,52455270.09
12/21/2023,Expense,Uber Eats,Mike ross,Meals & Entertainment,27.71,52455297.8
12/21/2023,Expense,Uber Eats,Mike ross,Credit Card - Ramp,27.71,52455325.51
12/21/2023,Expense,Uber Eats,Mike ross,Meals & Entertainment,27.71,52455353.22
12/22/2023,Expense,Uber Eats,Mike ross,Meals & Entertainment,22.29,52455375.51
12/22/2023,Expense,Careem,Harvey Spector,Travelling Expenses,11.22,52455386.73
12/22/2023,Expense,MakeMyTrip,Balapavan Tirumani,Travelling Expenses,1425.45,52456812.18
12/22/2023,Expense,Sendinblue,Max Kausman,Tools & Subscription - G&A,30.83,52456843.01
12/22/2023,Expense,Yesim,Harvey Spector,Office expenses,28.37,52456871.38
12/22/2023,Expense,MakeMyTrip,Balapavan Tirumani,Credit Card - Ramp,1425.45,52458296.83
12/22/2023,Expense,SafetyWing,Harvey Spector,Credit Card - Ramp,14.49,52458311.32
12/22/2023,Expense,National Taxi,Harvey Spector,Travelling Expenses,4.77,52458316.09
12/22/2023,Expense,Uber Eats,Mike ross,Credit Card - Ramp,22.29,52458338.38
12/22/2023,Expense,Yesim,Harvey Spector,Credit Card - Ramp,28.37,52458366.75
12/22/2023,Expense,SafetyWing,Harvey Spector,Credit Card - Ramp,14.49,52458381.24
12/22/2023,Expense,Careem,Harvey Spector,Travelling Expenses,6.59,52458387.83
12/22/2023,Expense,Careem,Harvey Spector,Travelling Expenses,11.22,52458399.05
12/22/2023,Expense,National Taxi,Harvey Spector,Credit Card - Ramp,4.77,52458403.82
12/22/2023,Expense,Yesim,Harvey Spector,Credit Card - Ramp,28.37,52458432.19
12/22/2023,Expense,Careem,Harvey Spector,Credit Card - Ramp,6.59,52458438.78
12/22/2023,Expense,SafetyWing,Harvey Spector,Insurance,14.49,52458453.27
12/22/2023,Expense,National Taxi,Harvey Spector,Travelling Expenses,4.77,52458458.04
12/22/2023,Expense,Sendinblue,Max Kausman,Credit Card - Ramp,30.83,52458488.87
12/22/2023,Expense,SafetyWing,Harvey Spector,Insurance,14.49,52458503.36
12/22/2023,Expense,Uber Eats,Mike ross,Meals & Entertainment,22.29,52458525.65
12/22/2023,Expense,MakeMyTrip,Balapavan Tirumani,Travelling Expenses,1425.45,52459951.1
12/22/2023,Expense,Sendinblue,Max Kausman,Tools & Subscription - G&A,30.83,52459981.93
12/22/2023,Expense,Yesim,Harvey Spector,Office expenses,28.37,52460010.3
12/22/2023,Expense,Careem,Harvey Spector,Travelling Expenses,6.59,52460016.89
12/22/2023,Expense,SafetyWing,Harvey Spector,Credit Card - Ramp,14.49,52460031.38
12/22/2023,Expense,Uber Eats,Mike ross,Meals & Entertainment,22.29,52460053.67
12/22/2023,Expense,Careem,Harvey Spector,Credit Card - Ramp,11.22,52460064.89
12/22/2023,Expense,MakeMyTrip,Balapavan Tirumani,Travelling Expenses,1425.45,52461490.34
12/22/2023,Expense,Sendinblue,Max Kausman,Credit Card - Ramp,30.83,52461521.17
12/22/2023,Expense,National Taxi,Harvey Spector,Credit Card - Ramp,4.77,52461525.94
12/22/2023,Expense,MakeMyTrip,Balapavan Tirumani,Credit Card - Ramp,1425.45,52462951.39
12/22/2023,Expense,National Taxi,Harvey Spector,Travelling Expenses,4.77,52462956.16
12/22/2023,Expense,SafetyWing,Harvey Spector,Insurance,14.49,52462970.65
12/22/2023,Expense,Uber Eats,Mike ross,Meals & Entertainment,22.29,52462992.94
12/22/2023,Expense,MakeMyTrip,Balapavan Tirumani,Travelling Expenses,1425.45,52464418.39
12/22/2023,Expense,Sendinblue,Max Kausman,Tools & Subscription - G&A,30.83,52464449.22
12/22/2023,Expense,Yesim,Harvey Spector,Office expenses,28.37,52464477.59
12/22/2023,Expense,Careem,Harvey Spector,Travelling Expenses,6.59,52464484.18
12/22/2023,Expense,National Taxi,Harvey Spector,Credit Card - Ramp,4.77,52464488.95
12/22/2023,Expense,Careem,Harvey Spector,Credit Card - Ramp,11.22,52464500.17
12/22/2023,Expense,Careem,Harvey Spector,Travelling Expenses,11.22,52464511.39
12/22/2023,Expense,National Taxi,Harvey Spector,Travelling Expenses,4.77,52464516.16
12/22/2023,Expense,SafetyWing,Harvey Spector,Insurance,14.49,52464530.65
12/22/2023,Expense,Careem,Harvey Spector,Credit Card - Ramp,6.59,52464537.24
12/22/2023,Expense,Uber Eats,Mike ross,Credit Card - Ramp,22.29,52464559.53
12/22/2023,Expense,Careem,Harvey Spector,Credit Card - Ramp,6.59,52464566.12
12/22/2023,Expense,Careem,Harvey Spector,Credit Card - Ramp,11.22,52464577.34
12/22/2023,Expense,Uber Eats,Mike ross,Credit Card - Ramp,22.29,52464599.63
12/22/2023,Expense,SafetyWing,Harvey Spector,Credit Card - Ramp,14.49,52464614.12
12/22/2023,Expense,Yesim,Harvey Spector,Credit Card - Ramp,28.37,52464642.49
12/22/2023,Expense,Uber Eats,Mike ross,Credit Card - Ramp,22.29,52464664.78
12/22/2023,Expense,Yesim,Harvey Spector,Credit Card - Ramp,28.37,52464693.15
12/22/2023,Expense,MakeMyTrip,Balapavan Tirumani,Credit Card - Ramp,1425.45,52466118.6
12/22/2023,Expense,Careem,Harvey Spector,Travelling Expenses,6.59,52466125.19
12/22/2023,Expense,Yesim,Harvey Spector,Office expenses,28.37,52466153.56
12/22/2023,Expense,Sendinblue,Max Kausman,Tools & Subscription - G&A,30.83,52466184.39
12/22/2023,Expense,Careem,Harvey Spector,Travelling Expenses,11.22,52466195.61
12/22/2023,Expense,Sendinblue,Max Kausman,Credit Card - Ramp,30.83,52466226.44
12/23/2023,Expense,Heptabase,Mike ross,Tools & Subscription - G&A,9.99,52466236.43
12/23/2023,Credit Card Credit,MakeMyTrip,Balapavan Tirumani,Travelling Expenses,-1376.72,52464859.71
12/23/2023,Expense,Heptabase,Mike ross,Credit Card - Ramp,9.99,52464869.7
12/23/2023,Expense,Heptabase,Mike ross,Tools & Subscription - G&A,9.99,52464879.69
12/23/2023,Credit Card Credit,MakeMyTrip,Balapavan Tirumani,Credit Card - Ramp,-1376.72,52463502.97
12/23/2023,Expense,Superhuman,Mike ross,Professional Service Charges,90,52463592.97
12/23/2023,Expense,Superhuman,Mike ross,Credit Card - Ramp,90,52463682.97
12/23/2023,Expense,Superhuman,Mike ross,Professional Service Charges,90,52463772.97
12/23/2023,Credit Card Credit,MakeMyTrip,Balapavan Tirumani,Travelling Expenses,-1376.72,52462396.25
12/23/2023,Credit Card Credit,MakeMyTrip,Balapavan Tirumani,Credit Card - Ramp,-1376.72,52461019.53
12/23/2023,Expense,Superhuman,Mike ross,Professional Service Charges,90,52461109.53
12/23/2023,Expense,Superhuman,Mike ross,Credit Card - Ramp,90,52461199.53
12/23/2023,Expense,Superhuman,Mike ross,Professional Service Charges,90,52461289.53
12/23/2023,Expense,Heptabase,Mike ross,Tools & Subscription - G&A,9.99,52461299.52
12/23/2023,Credit Card Credit,MakeMyTrip,Balapavan Tirumani,Travelling Expenses,-1376.72,52459922.8
12/23/2023,Expense,Superhuman,Mike ross,Credit Card - Ramp,90,52460012.8
12/23/2023,Expense,Heptabase,Mike ross,Tools & Subscription - G&A,9.99,52460022.79
12/23/2023,Expense,Superhuman,Mike ross,Credit Card - Ramp,90,52460112.79
12/23/2023,Expense,Heptabase,Mike ross,Credit Card - Ramp,9.99,52460122.78
12/23/2023,Expense,Heptabase,Mike ross,Credit Card - Ramp,9.99,52460132.77
12/23/2023,Credit Card Credit,MakeMyTrip,Balapavan Tirumani,Credit Card - Ramp,-1376.72,52458756.05
12/23/2023,Credit Card Credit,MakeMyTrip,Balapavan Tirumani,Travelling Expenses,-1376.72,52457379.33
12/24/2023,Expense,CleanShot X,Mike ross,Tools & Subscription - G&A,105.6,52457484.93
12/24/2023,Expense,The New York Times,Mike ross,Credit Card - Ramp,8.44,52457493.37
12/24/2023,Expense,The New York Times,Mike ross,General business expenses:Memberships & subscriptions,8.44,52457501.81
12/24/2023,Expense,CleanShot X,Mike ross,Credit Card - Ramp,105.6,52457607.41
12/24/2023,Expense,Uber,Mike ross,Credit Card - Ramp,14.22,52457621.63
12/24/2023,Expense,The New York Times,Mike ross,General business expenses:Memberships & subscriptions,8.44,52457630.07
12/24/2023,Expense,Uber,Mike ross,Travelling Expenses,14.22,52457644.29
12/24/2023,Expense,The New York Times,Mike ross,Credit Card - Ramp,8.44,52457652.73
12/24/2023,Expense,Uber,Mike ross,Travelling Expenses,14.22,52457666.95
12/24/2023,Expense,CleanShot X,Mike ross,Tools & Subscription - G&A,105.6,52457772.55
12/24/2023,Expense,The New York Times,Mike ross,General business expenses:Memberships & subscriptions,8.44,52457780.99
12/24/2023,Expense,CleanShot X,Mike ross,Tools & Subscription - G&A,105.6,52457886.59
12/24/2023,Expense,Uber,Mike ross,Travelling Expenses,14.22,52457900.81
12/24/2023,Expense,The New York Times,Mike ross,General business expenses:Memberships & subscriptions,8.44,52457909.25
12/24/2023,Expense,CleanShot X,Mike ross,Tools & Subscription - G&A,105.6,52458014.85
12/24/2023,Expense,The New York Times,Mike ross,Credit Card - Ramp,8.44,52458023.29
12/24/2023,Expense,The New York Times,Mike ross,Credit Card - Ramp,8.44,52458031.73
12/24/2023,Expense,Uber,Mike ross,Credit Card - Ramp,14.22,52458045.95
12/24/2023,Expense,CleanShot X,Mike ross,Credit Card - Ramp,105.6,52458151.55
12/24/2023,Expense,Uber,Mike ross,Credit Card - Ramp,14.22,52458165.77
12/24/2023,Expense,Uber,Mike ross,Travelling Expenses,14.22,52458179.99
12/24/2023,Expense,CleanShot X,Mike ross,Credit Card - Ramp,105.6,52458285.59
12/25/2023,Expense,Careem Plus,Harvey Spector,Credit Card - Ramp,5.33,52458290.92
12/25/2023,Expense,Uber Eats,Mike ross,Credit Card - Ramp,15.46,52458306.38
12/25/2023,Expense,Uber Eats,Mike ross,Meals & Entertainment,15.46,52458321.84
12/25/2023,Expense,Uber Eats,Mike ross,Meals & Entertainment,29.73,52458351.57
12/25/2023,Expense,Careem Plus,Harvey Spector,Credit Card - Ramp,5.33,52458356.9
12/25/2023,Expense,Careem Plus,Harvey Spector,Travelling Expenses,5.33,52458362.23
12/25/2023,Expense,Careem Plus,Harvey Spector,Travelling Expenses,5.33,52458367.56
12/25/2023,Expense,Careem Plus,Harvey Spector,Credit Card - Ramp,5.33,52458372.89
12/25/2023,Expense,Uber Eats,Mike ross,Meals & Entertainment,15.46,52458388.35
12/25/2023,Expense,Uber Eats,Mike ross,Meals & Entertainment,15.46,52458403.81
12/25/2023,Expense,Uber Eats,Mike ross,Credit Card - Ramp,15.46,52458419.27
12/25/2023,Expense,Uber Eats,Mike ross,Meals & Entertainment,29.73,52458449
12/25/2023,Expense,Uber Eats,Mike ross,Meals & Entertainment,29.73,52458478.73
12/25/2023,Expense,Careem Plus,Harvey Spector,Travelling Expenses,5.33,52458484.06
12/25/2023,Expense,Uber Eats,Mike ross,Meals & Entertainment,29.73,52458513.79
12/25/2023,Expense,Careem Plus,Harvey Spector,Travelling Expenses,5.33,52458519.12
12/25/2023,Expense,Uber Eats,Mike ross,Credit Card - Ramp,29.73,52458548.85
12/25/2023,Expense,Uber Eats,Mike ross,Credit Card - Ramp,15.46,52458564.31
12/25/2023,Expense,Uber Eats,Mike ross,Meals & Entertainment,15.46,52458579.77
12/25/2023,Expense,Uber Eats,Mike ross,Credit Card - Ramp,29.73,52458609.5
12/25/2023,Expense,Uber Eats,Mike ross,Credit Card - Ramp,15.46,52458624.96
12/25/2023,Expense,Uber Eats,Mike ross,Credit Card - Ramp,29.73,52458654.69
12/25/2023,Expense,Uber Eats,Mike ross,Credit Card - Ramp,29.73,52458684.42
12/26/2023,Bill Payment (Check),ANSR Dubai,BOOK TRANSFER DEBIT 45BOOK DEBIT CHRONICLEHQ INC.*BNF:ANSR (EMEA) GLOBAL SERVICES LIM ITED*OBI:/INV/ANSREMEA/049 ANSREMEA/055*BBI:/DAS/REF:03126RJ00TI1 *STBOOK*TIME:0132*YOUR REF:INV 49 AND 55*OUR REF:360129344,Accounts Payable (A/P),-12900,52445784.42
12/26/2023,Bill Payment (Check),ANSR Dubai,,HSBC A/c,-12900,52432884.42
12/26/2023,Bill Payment (Check),ANSR Dubai,BOOK TRANSFER DEBIT 45BOOK DEBIT CHRONICLEHQ INC.*BNF:ANSR (EMEA) GLOBAL SERVICES LIM ITED*OBI:/INV/ANSREMEA/049 ANSREMEA/055*BBI:/DAS/REF:03126RJ00TI1 *STBOOK*TIME:0132*YOUR REF:INV 49 AND 55*OUR REF:360129344,Accounts Payable (A/P),-12900,52419984.42
12/26/2023,Bill Payment (Check),ANSR Dubai,BOOK TRANSFER DEBIT 45BOOK DEBIT CHRONICLEHQ INC.*BNF:ANSR (EMEA) GLOBAL SERVICES LIM ITED*OBI:/INV/ANSREMEA/049 ANSREMEA/055*BBI:/DAS/REF:03126RJ00TI1 *STBOOK*TIME:0132*YOUR REF:INV 49 AND 55*OUR REF:360129344,Accounts Payable (A/P),-12900,52407084.42
12/26/2023,Bill Payment (Check),ANSR Dubai,,HSBC A/c,-12900,52394184.42
12/26/2023,Bill Payment (Check),ANSR Dubai,,HSBC A/c,-12900,52381284.42
12/26/2023,Bill Payment (Check),ANSR Dubai,,HSBC A/c,-12900,52368384.42
12/26/2023,Bill Payment (Check),ANSR Dubai,BOOK TRANSFER DEBIT 45BOOK DEBIT CHRONICLEHQ INC.*BNF:ANSR (EMEA) GLOBAL SERVICES LIM ITED*OBI:/INV/ANSREMEA/049 ANSREMEA/055*BBI:/DAS/REF:03126RJ00TI1 *STBOOK*TIME:0132*YOUR REF:INV 49 AND 55*OUR REF:360129344,Accounts Payable (A/P),-12900,52355484.42
12/27/2023,Expense,Uber,Mike ross,Travelling Expenses,16.07,52355500.49
12/27/2023,Expense,Cleartrip Private Limited,Balapavan Tirumani,Travelling Expenses,1001.23,52356501.72
12/27/2023,Expense,Bolt,Harvey Spector,Travelling Expenses,2.91,52356504.63
12/27/2023,Bill,EntityA,December 2023 Quarter expenses incurred plus 10% mark up per the MSA,Account2,163027.69,52519532.32
12/27/2023,Expense,Cleartrip Private Limited,Balapavan Tirumani,Credit Card - Ramp,1001.23,52520533.55
12/27/2023,Bill,EntityA,,outsources Services - Australia,163027.69,52683561.24
12/27/2023,Expense,Sendinblue,Max Kausman,Credit Card - Ramp,109.25,52683670.49
12/27/2023,Expense,Splitbee,Harris Jose,Credit Card - Ramp,16.52,52683687.01
12/27/2023,Expense,Bolt,Harvey Spector,Credit Card - Ramp,2.91,52683689.92
12/27/2023,Expense,Bolt,Harvey Spector,Travelling Expenses,5.41,52683695.33
12/27/2023,Expense,Sendinblue,Max Kausman,Tools & Subscription - G&A,109.25,52683804.58
12/27/2023,Expense,Uber,Mike ross,Travelling Expenses,16.07,52683820.65
12/27/2023,Expense,Cleartrip Private Limited,Balapavan Tirumani,Travelling Expenses,1001.23,52684821.88
12/27/2023,Expense,Sendinblue,Max Kausman,Tools & Subscription - G&A,109.25,52684931.13
12/27/2023,Expense,Splitbee,Harris Jose,Credit Card - Ramp,16.52,52684947.65
12/27/2023,Expense,Splitbee,Harris Jose,Tools & Subscription - G&A,16.52,52684964.17
12/27/2023,Expense,Bolt,Harvey Spector,Credit Card - Ramp,5.41,52684969.58
12/27/2023,Expense,Bolt,Harvey Spector,Travelling Expenses,5.41,52684974.99
12/27/2023,Expense,Splitbee,Harris Jose,Tools & Subscription - G&A,16.52,52684991.51
12/27/2023,Expense,Sendinblue,Max Kausman,Credit Card - Ramp,109.25,52685100.76
12/27/2023,Expense,Uber,Mike ross,Credit Card - Ramp,16.07,52685116.83
12/27/2023,Bill,EntityA,,outsources Services - Australia,163027.69,52848144.52
12/27/2023,Expense,Bolt,Harvey Spector,Travelling Expenses,2.91,52848147.43
12/27/2023,Expense,Sendinblue,Max Kausman,Tools & Subscription - G&A,109.25,52848256.68
12/27/2023,Expense,Bolt,Harvey Spector,Credit Card - Ramp,5.41,52848262.09
12/27/2023,Expense,Splitbee,Harris Jose,Credit Card - Ramp,16.52,52848278.61
12/27/2023,Expense,Bolt,Harvey Spector,Travelling Expenses,5.41,52848284.02
12/27/2023,Expense,Sendinblue,Max Kausman,Credit Card - Ramp,109.25,52848393.27
12/27/2023,Expense,Bolt,Harvey Spector,Travelling Expenses,2.91,52848396.18
12/27/2023,Expense,Uber,Mike ross,Travelling Expenses,16.07,52848412.25
12/27/2023,Expense,Cleartrip Private Limited,Balapavan Tirumani,Travelling Expenses,1001.23,52849413.48
12/27/2023,Expense,Cleartrip Private Limited,Balapavan Tirumani,Credit Card - Ramp,1001.23,52850414.71
12/27/2023,Expense,Bolt,Harvey Spector,Travelling Expenses,2.91,52850417.62
12/27/2023,Expense,Uber,Mike ross,Credit Card - Ramp,16.07,52850433.69
12/27/2023,Expense,Bolt,Harvey Spector,Credit Card - Ramp,5.41,52850439.1
12/27/2023,Expense,Bolt,Harvey Spector,Credit Card - Ramp,2.91,52850442.01
12/27/2023,Expense,Cleartrip Private Limited,Balapavan Tirumani,Credit Card - Ramp,1001.23,52851443.24
12/27/2023,Expense,Splitbee,Harris Jose,Tools & Subscription - G&A,16.52,52851459.76
12/27/2023,Expense,Bolt,Harvey Spector,Credit Card - Ramp,2.91,52851462.67
12/27/2023,Expense,Bolt,Harvey Spector,Travelling Expenses,5.41,52851468.08
12/27/2023,Bill,EntityA,December 2023 Quarter expenses incurred plus 10% mark up per the MSA,Account2,163027.69,53014495.77
12/27/2023,Expense,Sendinblue,Max Kausman,Tools & Subscription - G&A,109.25,53014605.02
12/27/2023,Expense,Splitbee,Harris Jose,Tools & Subscription - G&A,16.52,53014621.54
12/27/2023,Expense,Uber,Mike ross,Travelling Expenses,16.07,53014637.61
12/27/2023,Expense,Cleartrip Private Limited,Balapavan Tirumani,Travelling Expenses,1001.23,53015638.84
12/27/2023,Bill,EntityA,,outsources Services - Australia,163027.69,53178666.53
12/27/2023,Bill,EntityA,December 2023 Quarter expenses incurred plus 10% mark up per the MSA,Account2,163027.69,53341694.22
12/27/2023,Expense,Uber,Mike ross,Credit Card - Ramp,16.07,53341710.29
12/27/2023,Bill,EntityA,December 2023 Quarter expenses incurred plus 10% mark up per the MSA,Account2,163027.69,53504737.98
12/27/2023,Bill,EntityA,,outsources Services - Australia,163027.69,53667765.67
12/28/2023,Expense,Ay Qonshu Restaurant,Harvey Spector,Meals & Entertainment,10.02,53667775.69
12/28/2023,Expense,Baki Taksi Xidmeti,Harvey Spector,Credit Card - Ramp,9.12,53667784.81
12/28/2023,Expense,Bolt,Harvey Spector,Travelling Expenses,4.38,53667789.19
12/28/2023,Expense,Dubai Taxi,Harvey Spector,Credit Card - Ramp,16.27,53667805.46
12/28/2023,Expense,Bolt,Harvey Spector,Travelling Expenses,4.38,53667809.84
12/28/2023,Expense,Bolt,Harvey Spector,Credit Card - Ramp,4.38,53667814.22
12/28/2023,Expense,Github,Balapavan Tirumani,Tools & Subscription - G&A,10,53667824.22
12/28/2023,Expense,Github,Balapavan Tirumani,Tools & Subscription - G&A,10,53667834.22
12/28/2023,Expense,Bolt,Harvey Spector,Travelling Expenses,4.38,53667838.6
12/28/2023,Expense,Dubai Taxi,Harvey Spector,Travelling Expenses,16.27,53667854.87
12/28/2023,Expense,Heydar Aliyev Centre,Harvey Spector,Meals & Entertainment,9.12,53667863.99
12/28/2023,Expense,Baki Taksi Xidmeti,Harvey Spector,Travelling Expenses,9.12,53667873.11
12/28/2023,Expense,Uber Eats,Mike ross,Meals & Entertainment,23.68,53667896.79
12/28/2023,Expense,Ay Qonshu Restaurant,Harvey Spector,Credit Card - Ramp,10.02,53667906.81
12/28/2023,Expense,Uber Eats,Mike ross,Credit Card - Ramp,23.68,53667930.49
12/28/2023,Expense,Heydar Aliyev Centre,Harvey Spector,Credit Card - Ramp,9.12,53667939.61
12/28/2023,Expense,Uber Eats,Mike ross,Credit Card - Ramp,23.68,53667963.29
12/28/2023,Expense,Google Domains,Mike ross,Tools & Subscription - G&A,13.98,53667977.27
12/28/2023,Expense,Google Domains,Mike ross,Credit Card - Ramp,13.98,53667991.25
12/28/2023,Expense,Google Domains,Mike ross,Tools & Subscription - G&A,13.98,53668005.23
12/28/2023,Expense,Dubai Taxi,Harvey Spector,Travelling Expenses,16.27,53668021.5
12/28/2023,Expense,Heydar Aliyev Centre,Harvey Spector,Credit Card - Ramp,9.12,53668030.62
12/28/2023,Expense,Github,Balapavan Tirumani,Credit Card - Ramp,10,53668040.62
12/28/2023,Expense,Uber Eats,Mike ross,Credit Card - Ramp,23.68,53668064.3
12/28/2023,Expense,Github,Balapavan Tirumani,Credit Card - Ramp,10,53668074.3
12/28/2023,Expense,Baki Taksi Xidmeti,Harvey Spector,Travelling Expenses,9.12,53668083.42
12/28/2023,Expense,Uber Eats,Mike ross,Meals & Entertainment,23.68,53668107.1
12/28/2023,Expense,Github,Balapavan Tirumani,Tools & Subscription - G&A,10,53668117.1
12/28/2023,Expense,Heydar Aliyev Centre,Harvey Spector,Meals & Entertainment,9.12,53668126.22
12/28/2023,Expense,Ay Qonshu Restaurant,Harvey Spector,Meals & Entertainment,10.02,53668136.24
12/28/2023,Expense,Ay Qonshu Restaurant,Harvey Spector,Meals & Entertainment,10.02,53668146.26
12/28/2023,Expense,Baki Taksi Xidmeti,Harvey Spector,Travelling Expenses,9.12,53668155.38
12/28/2023,Expense,Google Domains,Mike ross,Credit Card - Ramp,13.98,53668169.36
12/28/2023,Expense,Heydar Aliyev Centre,Harvey Spector,Credit Card - Ramp,9.12,53668178.48
12/28/2023,Expense,Google Domains,Mike ross,Tools & Subscription - G&A,13.98,53668192.46
12/28/2023,Expense,Ay Qonshu Restaurant,Harvey Spector,Credit Card - Ramp,10.02,53668202.48
12/28/2023,Expense,Dubai Taxi,Harvey Spector,Travelling Expenses,16.27,53668218.75
12/28/2023,Expense,Google Domains,Mike ross,Tools & Subscription - G&A,13.98,53668232.73
12/28/2023,Expense,Ay Qonshu Restaurant,Harvey Spector,Meals & Entertainment,10.02,53668242.75
12/28/2023,Expense,Bolt,Harvey Spector,Travelling Expenses,4.38,53668247.13
12/28/2023,Expense,Github,Balapavan Tirumani,Tools & Subscription - G&A,10,53668257.13
12/28/2023,Expense,Heydar Aliyev Centre,Harvey Spector,Meals & Entertainment,9.12,53668266.25
12/28/2023,Expense,Dubai Taxi,Harvey Spector,Credit Card - Ramp,16.27,53668282.52
12/28/2023,Expense,Baki Taksi Xidmeti,Harvey Spector,Credit Card - Ramp,9.12,53668291.64
12/28/2023,Expense,Baki Taksi Xidmeti,Harvey Spector,Travelling Expenses,9.12,53668300.76
12/28/2023,Expense,Ay Qonshu Restaurant,Harvey Spector,Credit Card - Ramp,10.02,53668310.78
12/28/2023,Expense,Dubai Taxi,Harvey Spector,Travelling Expenses,16.27,53668327.05
12/28/2023,Expense,Bolt,Harvey Spector,Credit Card - Ramp,4.38,53668331.43
12/28/2023,Expense,Uber Eats,Mike ross,Meals & Entertainment,23.68,53668355.11
12/28/2023,Expense,Github,Balapavan Tirumani,Credit Card - Ramp,10,53668365.11
12/28/2023,Expense,Bolt,Harvey Spector,Credit Card - Ramp,4.38,53668369.49
12/28/2023,Expense,Google Domains,Mike ross,Credit Card - Ramp,13.98,53668383.47
12/28/2023,Expense,Dubai Taxi,Harvey Spector,Credit Card - Ramp,16.27,53668399.74
12/28/2023,Expense,Uber Eats,Mike ross,Meals & Entertainment,23.68,53668423.42
12/28/2023,Expense,Heydar Aliyev Centre,Harvey Spector,Meals & Entertainment,9.12,53668432.54
12/28/2023,Expense,Uber Eats,Mike ross,Credit Card - Ramp,23.68,53668456.22
12/28/2023,Expense,Heydar Aliyev Centre,Harvey Spector,Credit Card - Ramp,9.12,53668465.34
12/28/2023,Expense,Ay Qonshu Restaurant,Harvey Spector,Credit Card - Ramp,10.02,53668475.36
12/28/2023,Expense,Baki Taksi Xidmeti,Harvey Spector,Credit Card - Ramp,9.12,53668484.48
12/29/2023,Expense,Uber,Mike ross,Travelling Expenses,23.18,53668507.66
12/29/2023,Expense,Uber Eats,Mike ross,Credit Card - Ramp,35.57,53668543.23
12/29/2023,Expense,Uber,Mike ross,Travelling Expenses,23.18,53668566.41
12/29/2023,Expense,Uber Eats,Mike ross,Credit Card - Ramp,15.84,53668582.25
12/29/2023,Expense,Uber Eats,Mike ross,Meals & Entertainment,35.57,53668617.82
12/29/2023,Expense,Uber,Mike ross,Travelling Expenses,23.18,53668641
12/29/2023,Expense,Uber Eats,Mike ross,Meals & Entertainment,35.57,53668676.57
12/29/2023,Expense,Uber Eats,Mike ross,Meals & Entertainment,35.57,53668712.14
12/29/2023,Expense,Uber Eats,Mike ross,Credit Card - Ramp,35.57,53668747.71
12/29/2023,Expense,Uber Eats,Mike ross,Meals & Entertainment,15.84,53668763.55
12/29/2023,Expense,Uber Eats,Mike ross,Meals & Entertainment,15.84,53668779.39
12/29/2023,Expense,Uber Eats,Mike ross,Meals & Entertainment,15.84,53668795.23
12/29/2023,Expense,Uber Eats,Mike ross,Credit Card - Ramp,35.57,53668830.8
12/29/2023,Expense,Uber Eats,Mike ross,Credit Card - Ramp,15.84,53668846.64
12/29/2023,Expense,Uber,Mike ross,Credit Card - Ramp,23.18,53668869.82
12/29/2023,Expense,Uber Eats,Mike ross,Credit Card - Ramp,15.84,53668885.66
12/29/2023,Expense,Uber Eats,Mike ross,Meals & Entertainment,15.84,53668901.5
12/29/2023,Expense,Uber Eats,Mike ross,Credit Card - Ramp,15.84,53668917.34
12/29/2023,Expense,Uber Eats,Mike ross,Credit Card - Ramp,35.57,53668952.91
12/29/2023,Expense,Uber,Mike ross,Travelling Expenses,23.18,53668976.09
12/29/2023,Expense,Uber Eats,Mike ross,Meals & Entertainment,35.57,53669011.66
12/29/2023,Expense,Uber,Mike ross,Credit Card - Ramp,23.18,53669034.84
12/29/2023,Expense,Uber,Mike ross,Credit Card - Ramp,23.18,53669058.02
12/30/2023,Expense,Telstra,Mike ross,Utilities:Internet & TV services,340.02,53669398.04
12/30/2023,Expense,JB Hi-Fi,Mike ross,Credit Card - Ramp,181.72,53669579.76
12/30/2023,Expense,Telstra,Mike ross,Credit Card - Ramp,340.02,53669919.78
12/30/2023,Expense,inkle,Harvey Spector,Tools & Subscription - G&A,30,53669949.78
12/30/2023,Expense,Cleeng,Harvey Spector,Tools & Subscription - G&A,18,53669967.78
12/30/2023,Expense,Telstra,Mike ross,Utilities:Internet & TV services,340.02,53670307.8
12/30/2023,Expense,Telstra,Mike ross,Credit Card - Ramp,45.86,53670353.66
12/30/2023,Expense,JB Hi-Fi,Mike ross,Tools & Subscription - G&A,181.72,53670535.38
12/30/2023,Expense,JB Hi-Fi,Mike ross,Credit Card - Ramp,181.72,53670717.1
12/30/2023,Expense,inkle,Harvey Spector,Credit Card - Ramp,30,53670747.1
12/30/2023,Expense,Cleeng,Harvey Spector,Credit Card - Ramp,18,53670765.1
12/30/2023,Expense,inkle,Harvey Spector,Tools & Subscription - G&A,30,53670795.1
12/30/2023,Expense,Telstra,Mike ross,Credit Card - Ramp,340.02,53671135.12
12/30/2023,Expense,Telstra,Mike ross,Utilities:Internet & TV services,45.86,53671180.98
12/30/2023,Expense,inkle,Harvey Spector,Tools & Subscription - G&A,30,53671210.98
12/30/2023,Expense,Telstra,Mike ross,Credit Card - Ramp,45.86,53671256.84
12/30/2023,Expense,JB Hi-Fi,Mike ross,Tools & Subscription - G&A,181.72,53671438.56
12/30/2023,Expense,Cleeng,Harvey Spector,Credit Card - Ramp,18,53671456.56
12/30/2023,Expense,Telstra,Mike ross,Credit Card - Ramp,45.86,53671502.42
12/30/2023,Expense,Telstra,Mike ross,Utilities:Internet & TV services,340.02,53671842.44
12/30/2023,Expense,Cleeng,Harvey Spector,Tools & Subscription - G&A,18,53671860.44
12/30/2023,Expense,Telstra,Mike ross,Utilities:Internet & TV services,45.86,53671906.3
12/30/2023,Expense,JB Hi-Fi,Mike ross,Tools & Subscription - G&A,181.72,53672088.02
12/30/2023,Expense,inkle,Harvey Spector,Tools & Subscription - G&A,30,53672118.02
12/30/2023,Expense,Cleeng,Harvey Spector,Tools & Subscription - G&A,18,53672136.02
12/30/2023,Expense,Telstra,Mike ross,Utilities:Internet & TV services,45.86,53672181.88
12/30/2023,Expense,Telstra,Mike ross,Utilities:Internet & TV services,340.02,53672521.9
12/30/2023,Expense,inkle,Harvey Spector,Credit Card - Ramp,30,53672551.9
12/30/2023,Expense,Cleeng,Harvey Spector,Credit Card - Ramp,18,53672569.9
12/30/2023,Expense,inkle,Harvey Spector,Credit Card - Ramp,30,53672599.9
12/30/2023,Expense,Telstra,Mike ross,Utilities:Internet & TV services,45.86,53672645.76
12/30/2023,Expense,JB Hi-Fi,Mike ross,Tools & Subscription - G&A,181.72,53672827.48
12/30/2023,Expense,Cleeng,Harvey Spector,Tools & Subscription - G&A,18,53672845.48
12/30/2023,Expense,Telstra,Mike ross,Credit Card - Ramp,340.02,53673185.5
12/30/2023,Expense,JB Hi-Fi,Mike ross,Credit Card - Ramp,181.72,53673367.22
12/31/2023,Expense,Adobe,Mike ross,Tools & Subscription - S&M,20.46,53673387.68
12/31/2023,Expense,Amazon Au,Chris George,Tools & Subscription,132.91,53673520.59
12/31/2023,Expense,Adobe,Mike ross,Tools & Subscription - S&M,20.46,53673541.05
12/31/2023,Bill,Big Company ,"Service Expenses for the month of December 2023 
INR   23,43,092   @ 83.0424",Accounts Payable (A/P),28216,53701757.05
12/31/2023,Expense,Adobe,Mike ross,Credit Card - Ramp,20.46,53701777.51
12/31/2023,Expense,Adobe,Mike ross,Credit Card - Ramp,20.46,53701797.97
12/31/2023,Expense,Amazon Au,Chris George,Tools & Subscription,132.91,53701930.88
12/31/2023,Expense,Raycast,Harvey Spector,Credit Card - Ramp,20,53701950.88
12/31/2023,Bill,Big Company ,,Outsources Services - India,28216,53730166.88
12/31/2023,Expense,Amazon Au,Chris George,Credit Card - Ramp,132.91,53730299.79
12/31/2023,Expense,Adobe,Mike ross,Tools & Subscription - S&M,20.46,53730320.25
12/31/2023,Expense,Raycast,Harvey Spector,Tools & Subscription - G&A,20,53730340.25
12/31/2023,Bill,Big Company ,,Outsources Services - India,28216,53758556.25
12/31/2023,Expense,Raycast,Harvey Spector,Tools & Subscription - G&A,20,53758576.25
12/31/2023,Expense,Amazon Au,Chris George,Tools & Subscription,132.91,53758709.16
12/31/2023,Expense,Amazon Au,Chris George,Credit Card - Ramp,132.91,53758842.07
12/31/2023,Expense,Raycast,Harvey Spector,Tools & Subscription - G&A,20,53758862.07
12/31/2023,Expense,Amazon Au,Chris George,Tools & Subscription,132.91,53758994.98
12/31/2023,Bill,Big Company ,"Service Expenses for the month of December 2023 
INR   23,43,092   @ 83.0424",Accounts Payable (A/P),28216,53787210.98
12/31/2023,Expense,Adobe,Mike ross,Credit Card - Ramp,20.46,53787231.44
12/31/2023,Expense,Adobe,Mike ross,Tools & Subscription - S&M,20.46,53787251.9
12/31/2023,Bill,Big Company ,,Outsources Services - India,28216,53815467.9
12/31/2023,Expense,Raycast,Harvey Spector,Credit Card - Ramp,20,53815487.9
12/31/2023,Expense,Raycast,Harvey Spector,Credit Card - Ramp,20,53815507.9
12/31/2023,Bill,Big Company ,"Service Expenses for the month of December 2023 
INR   23,43,092   @ 83.0424",Accounts Payable (A/P),28216,53843723.9
12/31/2023,Expense,Amazon Au,Chris George,Credit Card - Ramp,132.91,53843856.81
12/31/2023,Expense,Raycast,Harvey Spector,Tools & Subscription - G&A,20,53843876.81
12/31/2023,Bill,Big Company ,,Outsources Services - India,28216,53872092.81
12/31/2023,Bill,Big Company ,"Service Expenses for the month of December 2023 
INR   23,43,092   @ 83.0424",Accounts Payable (A/P),28216,53900308.81
01/01/2024,Expense,Render,Balapavan Tirumani,Tools & Subscription - G&A,289.04,53900597.85
01/01/2024,Expense,Google G Suite,Mike ross,Tools & Subscription - G&A,110.51,53900708.36
01/01/2024,Expense,Liveblocks,Balapavan Tirumani,Credit Card - Ramp,99,53900807.36
01/01/2024,Expense,Google G Suite,Mike ross,Credit Card - Ramp,110.51,53900917.87
01/01/2024,Expense,Render,Balapavan Tirumani,Credit Card - Ramp,289.04,53901206.91
01/01/2024,Expense,Liveblocks,Balapavan Tirumani,Tools & Subscription - G&A,99,53901305.91
01/01/2024,Expense,Liveblocks,Balapavan Tirumani,Tools & Subscription - G&A,99,53901404.91
01/01/2024,Expense,Render,Balapavan Tirumani,Tools & Subscription - G&A,289.04,53901693.95
01/01/2024,Expense,Google G Suite,Mike ross,Tools & Subscription - G&A,110.51,53901804.46
01/01/2024,Expense,Liveblocks,Balapavan Tirumani,Tools & Subscription - G&A,99,53901903.46
01/01/2024,Expense,Liveblocks,Balapavan Tirumani,Tools & Subscription - G&A,99,53902002.46
01/01/2024,Expense,Liveblocks,Balapavan Tirumani,Credit Card - Ramp,99,53902101.46
01/01/2024,Expense,Google G Suite,Mike ross,Tools & Subscription - G&A,110.51,53902211.97
01/01/2024,Expense,Liveblocks,Balapavan Tirumani,Credit Card - Ramp,99,53902310.97
01/01/2024,Expense,Render,Balapavan Tirumani,Credit Card - Ramp,289.04,53902600.01
01/01/2024,Expense,Google G Suite,Mike ross,Credit Card - Ramp,110.51,53902710.52
01/01/2024,Expense,Google G Suite,Mike ross,Tools & Subscription - G&A,110.51,53902821.03
01/01/2024,Expense,Render,Balapavan Tirumani,Credit Card - Ramp,289.04,53903110.07
01/01/2024,Expense,Google G Suite,Mike ross,Credit Card - Ramp,110.51,53903220.58
01/01/2024,Expense,Render,Balapavan Tirumani,Tools & Subscription - G&A,289.04,53903509.62
01/01/2024,Expense,Render,Balapavan Tirumani,Tools & Subscription - G&A,289.04,53903798.66
01/02/2024,Expense,ExpressVPN,Harvey Spector,Tools & Subscription - G&A,99.95,53903898.61
01/02/2024,Expense,Amazon Web Services,Balapavan Tirumani,Tools & Subscription - G&A,45.12,53903943.73
01/02/2024,Expense,Segment,Balapavan Tirumani,Tools & Subscription - G&A,120,53904063.73
01/02/2024,Expense,June,Balapavan Tirumani,Tools & Subscription - G&A,149,53904212.73
01/02/2024,Expense,June,Balapavan Tirumani,Credit Card - Ramp,149,53904361.73
01/02/2024,Expense,Segment,Balapavan Tirumani,Credit Card - Ramp,120,53904481.73
01/02/2024,Expense,ExpressVPN,Harvey Spector,Credit Card - Ramp,99.95,53904581.68
01/02/2024,Expense,ExpressVPN,Harvey Spector,Credit Card - Ramp,99.95,53904681.63
01/02/2024,Expense,Segment,Balapavan Tirumani,Credit Card - Ramp,120,53904801.63
01/02/2024,Expense,Segment,Balapavan Tirumani,Tools & Subscription - G&A,120,53904921.63
01/02/2024,Expense,Amazon Web Services,Balapavan Tirumani,Credit Card - Ramp,45.12,53904966.75
01/02/2024,Expense,Amazon Web Services,Balapavan Tirumani,Credit Card - Ramp,45.12,53905011.87
01/02/2024,Expense,Amazon Web Services,Balapavan Tirumani,Tools & Subscription - G&A,45.12,53905056.99
01/02/2024,Expense,June,Balapavan Tirumani,Credit Card - Ramp,149,53905205.99
01/02/2024,Expense,Segment,Balapavan Tirumani,Tools & Subscription - G&A,120,53905325.99
01/02/2024,Expense,ExpressVPN,Harvey Spector,Credit Card - Ramp,99.95,53905425.94
01/02/2024,Expense,Segment,Balapavan Tirumani,Credit Card - Ramp,120,53905545.94
01/02/2024,Expense,Amazon Web Services,Balapavan Tirumani,Tools & Subscription - G&A,45.12,53905591.06
01/02/2024,Expense,ExpressVPN,Harvey Spector,Tools & Subscription - G&A,99.95,53905691.01
01/02/2024,Expense,ExpressVPN,Harvey Spector,Tools & Subscription - G&A,99.95,53905790.96
01/02/2024,Expense,Amazon Web Services,Balapavan Tirumani,Credit Card - Ramp,45.12,53905836.08
01/02/2024,Expense,Amazon Web Services,Balapavan Tirumani,Tools & Subscription - G&A,45.12,53905881.2
01/02/2024,Expense,ExpressVPN,Harvey Spector,Tools & Subscription - G&A,99.95,53905981.15
01/02/2024,Expense,June,Balapavan Tirumani,Tools & Subscription - G&A,149,53906130.15
01/02/2024,Expense,Segment,Balapavan Tirumani,Tools & Subscription - G&A,120,53906250.15
01/02/2024,Expense,June,Balapavan Tirumani,Tools & Subscription - G&A,149,53906399.15
01/02/2024,Expense,June,Balapavan Tirumani,Credit Card - Ramp,149,53906548.15
01/02/2024,Expense,June,Balapavan Tirumani,Tools & Subscription - G&A,149,53906697.15
01/03/2024,Expense,Milligram,Mike ross,Meals & Entertainment,57.07,53906754.22
01/03/2024,Expense,VirtualPostMail,Harvey Spector,General business expenses:Memberships & subscriptions,35,53906789.22
01/03/2024,Expense,VirtualPostMail,Harvey Spector,General business expenses:Memberships & subscriptions,35,53906824.22
01/03/2024,Expense,Corporation Service Co,Max Kausman,Professional Service Charges,202.05,53907026.27
01/03/2024,Expense,Corporation Service Co,Max Kausman,Credit Card - Ramp,202.05,53907228.32
01/03/2024,Expense,Sp Minimalissimo,Harvey Spector,Tools & Subscription - G&A,15,53907243.32
01/03/2024,Expense,VirtualPostMail,Harvey Spector,Credit Card - Ramp,35,53907278.32
01/03/2024,Expense,Milligram,Mike ross,Credit Card - Ramp,57.07,53907335.39
01/03/2024,Expense,Corporation Service Co,Max Kausman,Credit Card - Ramp,202.05,53907537.44
01/03/2024,Expense,VirtualPostMail,Harvey Spector,Credit Card - Ramp,35,53907572.44
01/03/2024,Expense,Milligram,Mike ross,Meals & Entertainment,57.07,53907629.51
01/03/2024,Expense,Sp Minimalissimo,Harvey Spector,Tools & Subscription - G&A,15,53907644.51
01/03/2024,Expense,Corporation Service Co,Max Kausman,Professional Service Charges,202.05,53907846.56
01/03/2024,Expense,Corporation Service Co,Max Kausman,Credit Card - Ramp,202.05,53908048.61
01/03/2024,Expense,Sp Minimalissimo,Harvey Spector,Credit Card - Ramp,15,53908063.61
01/03/2024,Expense,VirtualPostMail,Harvey Spector,General business expenses:Memberships & subscriptions,35,53908098.61
01/03/2024,Expense,Milligram,Mike ross,Meals & Entertainment,57.07,53908155.68
01/03/2024,Expense,VirtualPostMail,Harvey Spector,Credit Card - Ramp,35,53908190.68
01/03/2024,Expense,Milligram,Mike ross,Credit Card - Ramp,57.07,53908247.75
01/03/2024,Expense,Milligram,Mike ross,Credit Card - Ramp,57.07,53908304.82
01/03/2024,Expense,Sp Minimalissimo,Harvey Spector,Tools & Subscription - G&A,15,53908319.82
01/03/2024,Expense,Milligram,Mike ross,Credit Card - Ramp,57.07,53908376.89
01/03/2024,Expense,Sp Minimalissimo,Harvey Spector,Tools & Subscription - G&A,15,53908391.89
01/03/2024,Expense,Corporation Service Co,Max Kausman,Professional Service Charges,202.05,53908593.94
01/03/2024,Expense,VirtualPostMail,Harvey Spector,General business expenses:Memberships & subscriptions,35,53908628.94
01/03/2024,Expense,Sp Minimalissimo,Harvey Spector,Credit Card - Ramp,15,53908643.94
01/03/2024,Expense,Corporation Service Co,Max Kausman,Credit Card - Ramp,202.05,53908845.99
01/03/2024,Expense,Milligram,Mike ross,Meals & Entertainment,57.07,53908903.06
01/03/2024,Expense,VirtualPostMail,Harvey Spector,Credit Card - Ramp,35,53908938.06
01/03/2024,Expense,Sp Minimalissimo,Harvey Spector,Credit Card - Ramp,15,53908953.06
01/03/2024,Expense,Corporation Service Co,Max Kausman,Professional Service Charges,202.05,53909155.11
01/04/2024,Expense,OpenAI,Mike ross,Tools & Subscription - G&A,20,53909175.11
01/04/2024,Expense,OpenAI,Mike ross,Tools & Subscription - G&A,20,53909195.11
01/04/2024,Expense,Github,Balapavan Tirumani,Tools & Subscription - G&A,44,53909239.11
01/04/2024,Expense,OpenAI,Mike ross,Credit Card - Ramp,20,53909259.11
01/04/2024,Expense,Noahpinion,Max Kausman,Tools & Subscription - G&A,5.58,53909264.69
01/04/2024,Expense,Noahpinion,Max Kausman,Credit Card - Ramp,5.58,53909270.27
01/04/2024,Expense,Sentry,Balapavan Tirumani,Tools & Subscription - G&A,29,53909299.27
01/04/2024,Expense,Github,Balapavan Tirumani,Credit Card - Ramp,44,53909343.27
01/04/2024,Expense,Noahpinion,Max Kausman,Tools & Subscription - G&A,5.58,53909348.85
01/04/2024,Expense,Noahpinion,Max Kausman,Credit Card - Ramp,5.58,53909354.43
01/04/2024,Expense,Sentry,Balapavan Tirumani,Credit Card - Ramp,29,53909383.43
01/04/2024,Expense,Noahpinion,Max Kausman,Credit Card - Ramp,5.58,53909389.01
01/04/2024,Expense,Github,Balapavan Tirumani,Credit Card - Ramp,44,53909433.01
01/04/2024,Expense,OpenAI,Mike ross,Credit Card - Ramp,20,53909453.01
01/04/2024,Expense,Github,Balapavan Tirumani,Tools & Subscription - G&A,44,53909497.01
01/04/2024,Expense,Sentry,Balapavan Tirumani,Credit Card - Ramp,29,53909526.01
01/04/2024,Expense,Github,Balapavan Tirumani,Credit Card - Ramp,44,53909570.01
01/04/2024,Expense,Noahpinion,Max Kausman,Tools & Subscription - G&A,5.58,53909575.59
01/04/2024,Expense,Sentry,Balapavan Tirumani,Tools & Subscription - G&A,29,53909604.59
01/04/2024,Expense,Github,Balapavan Tirumani,Tools & Subscription - G&A,44,53909648.59
01/04/2024,Expense,Sentry,Balapavan Tirumani,Credit Card - Ramp,29,53909677.59
01/04/2024,Expense,OpenAI,Mike ross,Tools & Subscription - G&A,20,53909697.59
01/04/2024,Expense,Github,Balapavan Tirumani,Tools & Subscription - G&A,44,53909741.59
01/04/2024,Expense,Sentry,Balapavan Tirumani,Tools & Subscription - G&A,29,53909770.59
01/04/2024,Expense,Sentry,Balapavan Tirumani,Tools & Subscription - G&A,29,53909799.59
01/04/2024,Expense,OpenAI,Mike ross,Tools & Subscription - G&A,20,53909819.59
01/04/2024,Expense,Noahpinion,Max Kausman,Tools & Subscription - G&A,5.58,53909825.17
01/04/2024,Expense,OpenAI,Mike ross,Credit Card - Ramp,20,53909845.17
01/05/2024,Expense,OpenAI,Harvey Spector,Tools & Subscription - G&A,20,53909865.17
01/05/2024,Expense,Amazon Pay,Pradeep Kumar,Credit Card - Ramp,61.91,53909927.08
01/05/2024,Expense,OpenAI,Harvey Spector,Credit Card - Ramp,20,53909947.08
01/05/2024,Expense,Namecheap,Harvey Spector,Credit Card - Ramp,136.48,53910083.56
01/05/2024,Expense,Amazon Pay,Pradeep Kumar,Credit Card - Ramp,61.91,53910145.47
01/05/2024,Expense,Namecheap,Harvey Spector,Tools & Subscription - G&A,136.48,53910281.95
01/05/2024,Expense,OpenAI,Harvey Spector,Credit Card - Ramp,20,53910301.95
01/05/2024,Expense,Amazon Pay,Pradeep Kumar,Tools & Subscription - G&A,61.91,53910363.86
01/05/2024,Expense,Amazon Pay,Pradeep Kumar,Tools & Subscription - G&A,61.91,53910425.77
01/05/2024,Expense,OpenAI,Harvey Spector,Tools & Subscription - G&A,20,53910445.77
01/05/2024,Expense,Amazon Pay,Pradeep Kumar,Tools & Subscription - G&A,61.91,53910507.68
01/05/2024,Expense,OpenAI,Harvey Spector,Credit Card - Ramp,20,53910527.68
01/05/2024,Expense,OpenAI,Harvey Spector,Tools & Subscription - G&A,20,53910547.68
01/05/2024,Expense,Namecheap,Harvey Spector,Credit Card - Ramp,136.48,53910684.16
01/05/2024,Expense,Amazon Pay,Pradeep Kumar,Credit Card - Ramp,61.91,53910746.07
01/05/2024,Expense,OpenAI,Harvey Spector,Tools & Subscription - G&A,20,53910766.07
01/05/2024,Expense,Namecheap,Harvey Spector,Tools & Subscription - G&A,136.48,53910902.55
01/05/2024,Expense,Amazon Pay,Pradeep Kumar,Tools & Subscription - G&A,61.91,53910964.46
01/05/2024,Expense,Namecheap,Harvey Spector,Tools & Subscription - G&A,136.48,53911100.94
01/05/2024,Expense,Namecheap,Harvey Spector,Credit Card - Ramp,136.48,53911237.42
01/05/2024,Expense,Namecheap,Harvey Spector,Tools & Subscription - G&A,136.48,53911373.9
01/06/2024,Expense,Netlify,Balapavan Tirumani,Tools & Subscription - G&A,19,53911392.9
01/06/2024,Expense,Netlify,Balapavan Tirumani,Tools & Subscription - G&A,19,53911411.9
01/06/2024,Expense,Netlify,Balapavan Tirumani,Credit Card - Ramp,19,53911430.9
01/06/2024,Expense,Netlify,Balapavan Tirumani,Credit Card - Ramp,19,53911449.9
01/06/2024,Expense,Netlify,Balapavan Tirumani,Tools & Subscription - G&A,19,53911468.9
01/06/2024,Expense,Netlify,Balapavan Tirumani,Tools & Subscription - G&A,19,53911487.9
01/06/2024,Expense,Netlify,Balapavan Tirumani,Credit Card - Ramp,19,53911506.9
01/07/2024,Expense,Uber,Mike ross,Credit Card - Ramp,14.95,53911521.85
01/07/2024,Expense,Adobe,Mike ross,Tools & Subscription - S&M,84.81,53911606.66
01/07/2024,Expense,Supabase,Harris Jose,Tools & Subscription - G&A,35,53911641.66
01/07/2024,Expense,Adobe,Mike ross,Credit Card - Ramp,84.81,53911726.47
01/07/2024,Expense,Supabase,Harris Jose,Credit Card - Ramp,35,53911761.47
01/07/2024,Expense,Uber,Mike ross,Credit Card - Ramp,14.95,53911776.42
01/07/2024,Expense,Supabase,Harris Jose,Credit Card - Ramp,35,53911811.42
01/07/2024,Expense,Uber,Mike ross,Travelling Expenses,14.95,53911826.37
01/07/2024,Expense,Uber,Mike ross,Credit Card - Ramp,14.95,53911841.32
01/07/2024,Expense,Adobe,Mike ross,Credit Card - Ramp,84.81,53911926.13
01/07/2024,Expense,Adobe,Mike ross,Credit Card - Ramp,84.81,53912010.94
01/07/2024,Expense,Supabase,Harris Jose,Tools & Subscription - G&A,35,53912045.94
01/07/2024,Expense,Uber,Mike ross,Travelling Expenses,14.95,53912060.89
01/07/2024,Expense,Uber,Mike ross,Travelling Expenses,14.95,53912075.84
01/07/2024,Expense,Adobe,Mike ross,Tools & Subscription - S&M,84.81,53912160.65
01/07/2024,Expense,Supabase,Harris Jose,Credit Card - Ramp,35,53912195.65
01/07/2024,Expense,Supabase,Harris Jose,Tools & Subscription - G&A,35,53912230.65
01/07/2024,Expense,Adobe,Mike ross,Tools & Subscription - S&M,84.81,53912315.46
01/07/2024,Expense,Uber,Mike ross,Travelling Expenses,14.95,53912330.41
01/07/2024,Expense,Supabase,Harris Jose,Tools & Subscription - G&A,35,53912365.41
01/07/2024,Expense,Adobe,Mike ross,Tools & Subscription - S&M,84.81,53912450.22
01/08/2024,Expense,Heroku,Balapavan Tirumani,Credit Card - Ramp,85,53912535.22
01/08/2024,Expense,Skittle Lane Roastery,Mike ross,Credit Card - Ramp,9.03,53912544.25
01/08/2024,Expense,Heroku,Balapavan Tirumani,Tools & Subscription - S&M,85,53912629.25
01/08/2024,Expense,Heroku,Balapavan Tirumani,Tools & Subscription - S&M,85,53912714.25
01/08/2024,Expense,Skittle Lane Roastery,Mike ross,Meals & Entertainment,9.03,53912723.28
01/08/2024,Expense,Skittle Lane Roastery,Mike ross,Meals & Entertainment,9.03,53912732.31
01/08/2024,Expense,Skittle Lane Roastery,Mike ross,Meals & Entertainment,9.03,53912741.34
01/08/2024,Expense,Skittle Lane Roastery,Mike ross,Credit Card - Ramp,9.03,53912750.37
01/08/2024,Expense,Skittle Lane Roastery,Mike ross,Credit Card - Ramp,9.03,53912759.4
01/08/2024,Expense,Heroku,Balapavan Tirumani,Credit Card - Ramp,85,53912844.4
01/08/2024,Expense,Heroku,Balapavan Tirumani,Tools & Subscription - S&M,85,53912929.4
01/08/2024,Expense,Skittle Lane Roastery,Mike ross,Meals & Entertainment,9.03,53912938.43
01/08/2024,Expense,Skittle Lane Roastery,Mike ross,Credit Card - Ramp,9.03,53912947.46
01/08/2024,Expense,Heroku,Balapavan Tirumani,Tools & Subscription - S&M,85,53913032.46
01/08/2024,Expense,Heroku,Balapavan Tirumani,Credit Card - Ramp,85,53913117.46
01/09/2024,Expense,Rmn Boutique Trading,Harvey Spector,General business expenses:Memberships & subscriptions,57.9,53913175.36
01/09/2024,Expense,Usersnap,Harris Jose,Tools & Subscription - G&A,99,53913274.36
01/09/2024,Expense,Rmn Boutique Trading,Harvey Spector,Credit Card - Ramp,57.9,53913332.26
01/09/2024,Expense,Rmn Boutique Trading,Harvey Spector,General business expenses:Memberships & subscriptions,57.9,53913390.16
01/09/2024,Expense,OpenAI,Balapavan Tirumani,Tools & Subscription - G&A,20,53913410.16
01/09/2024,Expense,Rmn Boutique Trading,Harvey Spector,General business expenses:Memberships & subscriptions,57.9,53913468.06
01/09/2024,Expense,OpenAI,Balapavan Tirumani,Tools & Subscription - G&A,20,53913488.06
01/09/2024,Expense,OpenAI,Balapavan Tirumani,Tools & Subscription - G&A,20,53913508.06
01/09/2024,Expense,Usersnap,Harris Jose,Tools & Subscription - G&A,99,53913607.06
01/09/2024,Expense,OpenAI,Balapavan Tirumani,Credit Card - Ramp,20,53913627.06
01/09/2024,Expense,Rmn Boutique Trading,Harvey Spector,Credit Card - Ramp,57.9,53913684.96
01/09/2024,Expense,OpenAI,Balapavan Tirumani,Credit Card - Ramp,20,53913704.96
01/09/2024,Expense,Usersnap,Harris Jose,Credit Card - Ramp,99,53913803.96
01/09/2024,Expense,OpenAI,Balapavan Tirumani,Tools & Subscription - G&A,20,53913823.96
01/09/2024,Expense,Usersnap,Harris Jose,Credit Card - Ramp,99,53913922.96
01/09/2024,Expense,Rmn Boutique Trading,Harvey Spector,Credit Card - Ramp,57.9,53913980.86
01/09/2024,Expense,OpenAI,Balapavan Tirumani,Credit Card - Ramp,20,53914000.86
01/09/2024,Expense,Rmn Boutique Trading,Harvey Spector,General business expenses:Memberships & subscriptions,57.9,53914058.76
01/09/2024,Expense,Usersnap,Harris Jose,Tools & Subscription - G&A,99,53914157.76
01/09/2024,Expense,Usersnap,Harris Jose,Credit Card - Ramp,99,53914256.76
01/09/2024,Expense,Usersnap,Harris Jose,Tools & Subscription - G&A,99,53914355.76
01/09/2024,Expense,Rmn Boutique Trading,Harvey Spector,Credit Card - Ramp,57.9,53914413.66
01/10/2024,Expense,Zoom,Max Kausman,Credit Card - Ramp,15.99,53914429.65
01/10/2024,Expense,Pause Cafe,Harvey Spector,Meals & Entertainment,12,53914441.65
01/10/2024,Expense,Pause Cafe,Harvey Spector,Credit Card - Ramp,12,53914453.65
01/10/2024,Expense,Uber Eats,Mike ross,Credit Card - Ramp,24.76,53914478.41
01/10/2024,Expense,Zoom,Max Kausman,Credit Card - Ramp,15.99,53914494.4
01/10/2024,Expense,Uber Eats,Mike ross,Credit Card - Ramp,24.76,53914519.16
01/10/2024,Expense,Pause Cafe,Harvey Spector,Credit Card - Ramp,12,53914531.16
01/10/2024,Expense,Pause Cafe,Harvey Spector,Credit Card - Ramp,12,53914543.16
01/10/2024,Expense,Uber Eats,Mike ross,Credit Card - Ramp,24.76,53914567.92
01/10/2024,Expense,Pb Nsw Pty Ltd,Mike ross,Credit Card - Ramp,1491.21,53916059.13
01/10/2024,Expense,Zoom,Max Kausman,Tools & Subscription - G&A,15.99,53916075.12
01/10/2024,Expense,Pb Nsw Pty Ltd,Mike ross,Office expenses:Office supplies,1491.21,53917566.33
01/10/2024,Expense,Pb Nsw Pty Ltd,Mike ross,Credit Card - Ramp,1491.21,53919057.54
01/10/2024,Expense,Uber Eats,Mike ross,Meals & Entertainment,24.76,53919082.3
01/10/2024,Expense,Pb Nsw Pty Ltd,Mike ross,Office expenses:Office supplies,1491.21,53920573.51
01/10/2024,Expense,Pb Nsw Pty Ltd,Mike ross,Credit Card - Ramp,1491.21,53922064.72
01/10/2024,Expense,Pb Nsw Pty Ltd,Mike ross,Office expenses:Office supplies,1491.21,53923555.93
01/10/2024,Expense,Pb Nsw Pty Ltd,Mike ross,Office expenses:Office supplies,1491.21,53925047.14
01/10/2024,Expense,Pb Nsw Pty Ltd,Mike ross,Credit Card - Ramp,1491.21,53926538.35
01/10/2024,Expense,Uber Eats,Mike ross,Meals & Entertainment,24.76,53926563.11
01/10/2024,Expense,Uber Eats,Mike ross,Credit Card - Ramp,24.76,53926587.87
01/10/2024,Expense,Pause Cafe,Harvey Spector,Credit Card - Ramp,12,53926599.87
01/10/2024,Expense,Uber Eats,Mike ross,Meals & Entertainment,24.76,53926624.63
01/10/2024,Expense,Pause Cafe,Harvey Spector,Meals & Entertainment,12,53926636.63
01/10/2024,Expense,Pause Cafe,Harvey Spector,Meals & Entertainment,12,53926648.63
01/10/2024,Expense,Zoom,Max Kausman,Tools & Subscription - G&A,15.99,53926664.62
01/10/2024,Expense,Zoom,Max Kausman,Tools & Subscription - G&A,15.99,53926680.61
01/10/2024,Expense,Uber Eats,Mike ross,Meals & Entertainment,24.76,53926705.37
01/10/2024,Expense,Zoom,Max Kausman,Credit Card - Ramp,15.99,53926721.36
01/10/2024,Expense,Pause Cafe,Harvey Spector,Meals & Entertainment,12,53926733.36
01/10/2024,Expense,Zoom,Max Kausman,Tools & Subscription - G&A,15.99,53926749.35
01/11/2024,Expense,Inventus Law,"INVENTUS LAW, PC",Account1,3957.49,53930706.84
01/11/2024,Deposit,,December Savings Interest,Savings (6977),0.88,53930707.72
01/11/2024,Expense,Github,Anik Das,Tools & Subscription - G&A,10,53930717.72
01/11/2024,Expense,Inventus Law,"INVENTUS LAW, PC",Legal & accounting services,-3957.49,53926760.23
01/11/2024,Expense,Github,Anik Das,Tools & Subscription - G&A,10,53926770.23
01/11/2024,Expense,Inventus Law,"INVENTUS LAW, PC",Account1,3957.49,53930727.72
01/11/2024,Deposit,,December Savings Interest,Interest Received,0.88,53930728.6
01/11/2024,Expense,Github,Anik Das,Credit Card - Ramp,10,53930738.6
01/11/2024,Expense,Github,Anik Das,Credit Card - Ramp,10,53930748.6
01/11/2024,Deposit,,December Savings Interest,Savings (6977),0.88,53930749.48
01/11/2024,Expense,Github,Anik Das,Tools & Subscription - G&A,10,53930759.48
01/11/2024,Expense,Github,Anik Das,Credit Card - Ramp,10,53930769.48
01/11/2024,Expense,Inventus Law,"INVENTUS LAW, PC",Legal & accounting services,-3957.49,53926811.99
01/11/2024,Expense,Inventus Law,"INVENTUS LAW, PC",Account1,3957.49,53930769.48
01/11/2024,Expense,Inventus Law,"INVENTUS LAW, PC",Legal & accounting services,-3957.49,53926811.99
01/11/2024,Deposit,,December Savings Interest,Interest Received,0.88,53926812.87
01/11/2024,Expense,Inventus Law,"INVENTUS LAW, PC",Account1,3957.49,53930770.36
01/11/2024,Deposit,,December Savings Interest,Interest Received,0.88,53930771.24
01/11/2024,Expense,Inventus Law,"INVENTUS LAW, PC",Legal & accounting services,-3957.49,53926813.75
01/11/2024,Expense,Github,Anik Das,Tools & Subscription - G&A,10,53926823.75
01/11/2024,Deposit,,December Savings Interest,Interest Received,0.88,53926824.63
01/11/2024,Deposit,,December Savings Interest,Savings (6977),0.88,53926825.51
01/12/2024,Expense,OpenAI,Max Kausman,Tools & Subscription - G&A,20,53926845.51
01/12/2024,Expense,WordPress,Harris Jose,Tools & Subscription - G&A,15.65,53926861.16
01/12/2024,Expense,OpenAI,Max Kausman,Tools & Subscription - G&A,20,53926881.16
01/12/2024,Expense,Adobe,Chris George,Tools & Subscription - S&M,20.99,53926902.15
01/12/2024,Expense,OpenAI,Max Kausman,Credit Card - Ramp,20,53926922.15
01/12/2024,Expense,OpenAI,Max Kausman,Tools & Subscription - G&A,20,53926942.15
01/12/2024,Expense,Adobe,Chris George,Tools & Subscription - S&M,20.99,53926963.14
01/12/2024,Expense,WordPress,Harris Jose,Tools & Subscription - G&A,15.65,53926978.79
01/12/2024,Expense,Adobe,Chris George,Tools & Subscription - S&M,20.99,53926999.78
01/12/2024,Expense,WordPress,Harris Jose,Credit Card - Ramp,15.65,53927015.43
01/12/2024,Expense,WordPress,Harris Jose,Tools & Subscription - G&A,15.65,53927031.08
01/12/2024,Expense,OpenAI,Max Kausman,Credit Card - Ramp,20,53927051.08
01/12/2024,Expense,Adobe,Chris George,Credit Card - Ramp,20.99,53927072.07
01/12/2024,Expense,Adobe,Chris George,Credit Card - Ramp,20.99,53927093.06
01/12/2024,Expense,WordPress,Harris Jose,Tools & Subscription - G&A,15.65,53927108.71
01/12/2024,Expense,Adobe,Chris George,Credit Card - Ramp,20.99,53927129.7
01/12/2024,Expense,Adobe,Chris George,Tools & Subscription - S&M,20.99,53927150.69
01/12/2024,Expense,OpenAI,Max Kausman,Credit Card - Ramp,20,53927170.69
01/12/2024,Expense,OpenAI,Max Kausman,Tools & Subscription - G&A,20,53927190.69
01/12/2024,Expense,WordPress,Harris Jose,Credit Card - Ramp,15.65,53927206.34
01/12/2024,Expense,WordPress,Harris Jose,Credit Card - Ramp,15.65,53927221.99
01/13/2024,Expense,Vercel,Harris Jose,Credit Card - Ramp,240,53927461.99
01/13/2024,Expense,Vercel,Harris Jose,Credit Card - Ramp,240,53927701.99
01/13/2024,Expense,Figma,Mike ross,Credit Card - Ramp,70,53927771.99
01/13/2024,Expense,Lenny Rachitsky,Max Kausman,General business expenses:Memberships & subscriptions,15,53927786.99
01/13/2024,Expense,Careem,Harvey Spector,Credit Card - Ramp,10.74,53927797.73
01/13/2024,Expense,Lenny Rachitsky,Max Kausman,Credit Card - Ramp,15,53927812.73
01/13/2024,Expense,Careem,Harvey Spector,Credit Card - Ramp,0.33,53927813.06
01/13/2024,Expense,Figma,Mike ross,Credit Card - Ramp,70,53927883.06
01/13/2024,Expense,Telstra,Mike ross,Credit Card - Ramp,45.07,53927928.13
01/13/2024,Expense,Careem,Harvey Spector,Credit Card - Ramp,10.74,53927938.87
01/13/2024,Expense,Figma,Mike ross,Tools & Subscription - G&A,70,53928008.87
01/13/2024,Expense,Careem,Harvey Spector,Credit Card - Ramp,0.33,53928009.2
01/13/2024,Expense,Careem,Harvey Spector,Travelling Expenses,10.74,53928019.94
01/13/2024,Expense,Vercel,Harris Jose,Tools & Subscription - G&A,240,53928259.94
01/13/2024,Expense,Lenny Rachitsky,Max Kausman,Credit Card - Ramp,15,53928274.94
01/13/2024,Expense,Careem,Harvey Spector,Credit Card - Ramp,10.74,53928285.68
01/13/2024,Expense,Careem,Harvey Spector,Travelling Expenses,0.33,53928286.01
01/13/2024,Expense,Careem,Harvey Spector,Credit Card - Ramp,0.33,53928286.34
01/13/2024,Expense,Careem,Harvey Spector,Travelling Expenses,0.33,53928286.67
01/13/2024,Expense,Lenny Rachitsky,Max Kausman,General business expenses:Memberships & subscriptions,15,53928301.67
01/13/2024,Expense,Careem,Harvey Spector,Travelling Expenses,10.74,53928312.41
01/13/2024,Expense,Lenny Rachitsky,Max Kausman,General business expenses:Memberships & subscriptions,15,53928327.41
01/13/2024,Expense,Telstra,Mike ross,Credit Card - Ramp,45.07,53928372.48
01/13/2024,Expense,Vercel,Harris Jose,Tools & Subscription - G&A,240,53928612.48
01/13/2024,Expense,Careem,Harvey Spector,Travelling Expenses,10.74,53928623.22
01/13/2024,Expense,Lenny Rachitsky,Max Kausman,Credit Card - Ramp,15,53928638.22
01/13/2024,Expense,Careem,Harvey Spector,Travelling Expenses,0.33,53928638.55
01/13/2024,Expense,Careem,Harvey Spector,Travelling Expenses,10.74,53928649.29
01/13/2024,Expense,Vercel,Harris Jose,Tools & Subscription - G&A,240,53928889.29
01/13/2024,Expense,Figma,Mike ross,Tools & Subscription - G&A,70,53928959.29
01/13/2024,Expense,Telstra,Mike ross,Utilities:Internet & TV services,45.07,53929004.36
01/13/2024,Expense,Lenny Rachitsky,Max Kausman,Credit Card - Ramp,15,53929019.36
01/13/2024,Expense,Careem,Harvey Spector,Travelling Expenses,0.33,53929019.69
01/13/2024,Expense,Telstra,Mike ross,Utilities:Internet & TV services,45.07,53929064.76
01/13/2024,Expense,Figma,Mike ross,Tools & Subscription - G&A,70,53929134.76
01/13/2024,Expense,Telstra,Mike ross,Credit Card - Ramp,45.07,53929179.83
01/13/2024,Expense,Telstra,Mike ross,Utilities:Internet & TV services,45.07,53929224.9
01/13/2024,Expense,Figma,Mike ross,Tools & Subscription - G&A,70,53929294.9
01/13/2024,Expense,Lenny Rachitsky,Max Kausman,General business expenses:Memberships & subscriptions,15,53929309.9
01/13/2024,Expense,Vercel,Harris Jose,Tools & Subscription - G&A,240,53929549.9
01/13/2024,Expense,Figma,Mike ross,Credit Card - Ramp,70,53929619.9
01/13/2024,Expense,Vercel,Harris Jose,Credit Card - Ramp,240,53929859.9
01/13/2024,Expense,Telstra,Mike ross,Utilities:Internet & TV services,45.07,53929904.97
01/14/2024,Expense,Notion Labs,Harvey Spector,Credit Card - Ramp,10,53929914.97
01/14/2024,Expense,Notion Labs,Harvey Spector,Tools & Subscription - G&A,10,53929924.97
01/14/2024,Expense,Notion Labs,Harvey Spector,Tools & Subscription - G&A,10,53929934.97
01/14/2024,Expense,Notion Labs,Harvey Spector,Credit Card - Ramp,10,53929944.97
01/14/2024,Expense,Notion Labs,Harvey Spector,Tools & Subscription - G&A,10,53929954.97
01/14/2024,Expense,Notion Labs,Harvey Spector,Credit Card - Ramp,10,53929964.97
01/14/2024,Expense,Notion Labs,Harvey Spector,Tools & Subscription - G&A,10,53929974.97
01/15/2024,Expense,Telstra,Mike ross,Credit Card - Ramp,42.99,53930017.96
01/15/2024,Expense,Supercell,Anik Das,Credit Card - Ramp,7.45,53930025.41
01/15/2024,Expense,Uber Eats,Mike ross,Credit Card - Ramp,18.57,53930043.98
01/15/2024,Expense,Supercell,Anik Das,Tools & Subscription - G&A,7.45,53930051.43
01/15/2024,Expense,Telstra,Mike ross,Utilities:Internet & TV services,42.99,53930094.42
01/15/2024,Expense,Uber Eats,Mike ross,Meals & Entertainment,18.57,53930112.99
01/15/2024,Expense,Tattva Spa,Harris Jose,Meals & Entertainment,264.32,53930377.31
01/15/2024,Expense,Supercell,Anik Das,Tools & Subscription - G&A,7.45,53930384.76
01/15/2024,Expense,Telstra,Mike ross,Utilities:Internet & TV services,42.99,53930427.75
01/15/2024,Expense,Uber Eats,Mike ross,Credit Card - Ramp,18.57,53930446.32
01/15/2024,Expense,Telstra,Mike ross,Utilities:Internet & TV services,42.99,53930489.31
01/15/2024,Expense,Supercell,Anik Das,Tools & Subscription - G&A,7.45,53930496.76
01/15/2024,Expense,Telstra,Mike ross,Credit Card - Ramp,42.99,53930539.75
01/15/2024,Expense,Supercell,Anik Das,Credit Card - Ramp,7.45,53930547.2
01/15/2024,Expense,Tattva Spa,Harris Jose,Meals & Entertainment,264.32,53930811.52
01/15/2024,Expense,Uber Eats,Mike ross,Meals & Entertainment,18.57,53930830.09
01/15/2024,Expense,Tattva Spa,Harris Jose,Meals & Entertainment,264.32,53931094.41
01/15/2024,Expense,Uber Eats,Mike ross,Meals & Entertainment,18.57,53931112.98
01/15/2024,Expense,Telstra,Mike ross,Utilities:Internet & TV services,42.99,53931155.97
01/15/2024,Expense,Uber Eats,Mike ross,Meals & Entertainment,18.57,53931174.54
01/15/2024,Expense,Uber Eats,Mike ross,Credit Card - Ramp,18.57,53931193.11
01/15/2024,Expense,Tattva Spa,Harris Jose,Credit Card - Ramp,264.32,53931457.43
01/15/2024,Expense,Telstra,Mike ross,Credit Card - Ramp,42.99,53931500.42
01/15/2024,Expense,Supercell,Anik Das,Tools & Subscription - G&A,7.45,53931507.87
01/15/2024,Expense,Tattva Spa,Harris Jose,Credit Card - Ramp,264.32,53931772.19
01/15/2024,Expense,Supercell,Anik Das,Credit Card - Ramp,7.45,53931779.64
01/15/2024,Expense,Tattva Spa,Harris Jose,Credit Card - Ramp,264.32,53932043.96
01/15/2024,Expense,Tattva Spa,Harris Jose,Meals & Entertainment,264.32,53932308.28
01/15/2024,Expense,Tattva Spa,Harris Jose,Credit Card - Ramp,264.32,53932572.6
01/15/2024,Expense,Uber Eats,Mike ross,Credit Card - Ramp,18.57,53932591.17
01/16/2024,Expense,Raycast,Harvey Spector,Credit Card - Ramp,91.11,53932682.28
01/16/2024,Expense,Emil Kowalski,Ahielan Ravichandran,Credit Card - Ramp,84.25,53932766.53
01/16/2024,Expense,Rewind AI,Harvey Spector,Credit Card - Ramp,59,53932825.53
01/16/2024,Expense,Raycast,Harvey Spector,Credit Card - Ramp,91.11,53932916.64
01/16/2024,Expense,Raycast,Harvey Spector,Credit Card - Ramp,91.11,53933007.75
01/16/2024,Expense,Bondi Buns,Mike ross,Credit Card - Ramp,19.93,53933027.68
01/16/2024,Expense,Emil Kowalski,Ahielan Ravichandran,Tools & Subscription - G&A,84.25,53933111.93
01/16/2024,Expense,Rewind AI,Harvey Spector,Tools & Subscription - G&A,59,53933170.93
01/16/2024,Expense,Bondi Buns,Mike ross,Meals & Entertainment,19.93,53933190.86
01/16/2024,Expense,Emil Kowalski,Ahielan Ravichandran,Tools & Subscription - G&A,84.25,53933275.11
01/16/2024,Expense,Rewind AI,Harvey Spector,Tools & Subscription - G&A,59,53933334.11
01/16/2024,Expense,Bondi Buns,Mike ross,Credit Card - Ramp,19.93,53933354.04
01/16/2024,Expense,Bondi Buns,Mike ross,Meals & Entertainment,19.93,53933373.97
01/16/2024,Expense,Raycast,Harvey Spector,Tools & Subscription - G&A,91.11,53933465.08
01/16/2024,Expense,Raycast,Harvey Spector,Tools & Subscription - G&A,91.11,53933556.19
01/16/2024,Expense,Emil Kowalski,Ahielan Ravichandran,Tools & Subscription - G&A,84.25,53933640.44
01/16/2024,Expense,Rewind AI,Harvey Spector,Tools & Subscription - G&A,59,53933699.44
01/16/2024,Expense,Emil Kowalski,Ahielan Ravichandran,Credit Card - Ramp,84.25,53933783.69
01/16/2024,Expense,Bondi Buns,Mike ross,Meals & Entertainment,19.93,53933803.62
01/16/2024,Expense,Rewind AI,Harvey Spector,Tools & Subscription - G&A,59,53933862.62
01/16/2024,Expense,Raycast,Harvey Spector,Tools & Subscription - G&A,91.11,53933953.73
01/16/2024,Expense,Bondi Buns,Mike ross,Credit Card - Ramp,19.93,53933973.66
01/16/2024,Expense,Emil Kowalski,Ahielan Ravichandran,Tools & Subscription - G&A,84.25,53934057.91
01/16/2024,Expense,Rewind AI,Harvey Spector,Credit Card - Ramp,59,53934116.91
01/16/2024,Expense,Emil Kowalski,Ahielan Ravichandran,Credit Card - Ramp,84.25,53934201.16
01/16/2024,Expense,Raycast,Harvey Spector,Tools & Subscription - G&A,91.11,53934292.27
01/16/2024,Expense,Bondi Buns,Mike ross,Credit Card - Ramp,19.93,53934312.2
01/16/2024,Expense,Bondi Buns,Mike ross,Meals & Entertainment,19.93,53934332.13
01/16/2024,Expense,Rewind AI,Harvey Spector,Credit Card - Ramp,59,53934391.13
01/17/2024,Credit Card Credit,Raycast,Harvey Spector,Tools & Subscription - G&A,-4.93,53934386.2
01/17/2024,Expense,Careem,Harvey Spector,Credit Card - Ramp,4.49,53934390.69
01/17/2024,Bill,ANSR Dubai,Service Fees for January 2024,Accounts Payable (A/P),10874,53945264.69
01/17/2024,Bill,ANSR Dubai,,Professional Service Charges,10874,53956138.69
01/17/2024,Expense,,Fees,HSBC A/c,29.76,53956168.45
01/17/2024,Bill,ANSR Dubai,Service Fees for January 2024,Accounts Payable (A/P),10874,53967042.45
01/17/2024,Expense,Careem,Harvey Spector,Credit Card - Ramp,4.49,53967046.94
01/17/2024,Expense,Booking.com,Balapavan Tirumani,Credit Card - Ramp,307.5,53967354.44
01/17/2024,Expense,Booking.com,Balapavan Tirumani,Credit Card - Ramp,307.5,53967661.94
01/17/2024,Expense,,MONTHLY CHARGE Bank Charges for the per 01DEC2023 TO 31DEC2023 Invoice No 1766672,General business expenses:Bank fees & service charges,-29.76,53967632.18
01/17/2024,Expense,Careem,Harvey Spector,Travelling Expenses,4.49,53967636.67
01/17/2024,Expense,Careem,Harvey Spector,Travelling Expenses,4.49,53967641.16
01/17/2024,Credit Card Credit,Raycast,Harvey Spector,Tools & Subscription - G&A,-4.93,53967636.23
01/17/2024,Expense,Auth0,Praveen Kumar,Tools & Subscription - G&A,35,53967671.23
01/17/2024,Expense,Booking.com,Balapavan Tirumani,Travelling Expenses,307.5,53967978.73
01/17/2024,Expense,Auth0,Praveen Kumar,Tools & Subscription - G&A,35,53968013.73
01/17/2024,Expense,,Fees,HSBC A/c,29.76,53968043.49
01/17/2024,Bill,ANSR Dubai,Service Fees for January 2024,Accounts Payable (A/P),10874,53978917.49
01/17/2024,Expense,Booking.com,Balapavan Tirumani,Travelling Expenses,307.5,53979224.99
01/17/2024,Expense,Auth0,Praveen Kumar,Credit Card - Ramp,35,53979259.99
01/17/2024,Expense,,Fees,HSBC A/c,29.76,53979289.75
01/17/2024,Credit Card Credit,Raycast,Harvey Spector,Credit Card - Ramp,-4.93,53979284.82
01/17/2024,Expense,Auth0,Praveen Kumar,Tools & Subscription - G&A,35,53979319.82
01/17/2024,Credit Card Credit,Raycast,Harvey Spector,Credit Card - Ramp,-4.93,53979314.89
01/17/2024,Expense,Careem,Harvey Spector,Credit Card - Ramp,4.49,53979319.38
01/17/2024,Expense,Auth0,Praveen Kumar,Credit Card - Ramp,35,53979354.38
01/17/2024,Bill,ANSR Dubai,Service Fees for January 2024,Accounts Payable (A/P),10874,53990228.38
01/17/2024,Bill,ANSR Dubai,,Professional Service Charges,10874,54001102.38
01/17/2024,Expense,,Fees,HSBC A/c,29.76,54001132.14
01/17/2024,Credit Card Credit,Raycast,Harvey Spector,Credit Card - Ramp,-4.93,54001127.21
01/17/2024,Expense,Booking.com,Balapavan Tirumani,Credit Card - Ramp,307.5,54001434.71
01/17/2024,Expense,Booking.com,Balapavan Tirumani,Travelling Expenses,307.5,54001742.21
01/17/2024,Expense,,MONTHLY CHARGE Bank Charges for the per 01DEC2023 TO 31DEC2023 Invoice No 1766672,General business expenses:Bank fees & service charges,-29.76,54001712.45
01/17/2024,Credit Card Credit,Raycast,Harvey Spector,Tools & Subscription - G&A,-4.93,54001707.52
01/17/2024,Expense,,MONTHLY CHARGE Bank Charges for the per 01DEC2023 TO 31DEC2023 Invoice No 1766672,General business expenses:Bank fees & service charges,-29.76,54001677.76
01/17/2024,Bill,ANSR Dubai,,Professional Service Charges,10874,54012551.76
01/17/2024,Bill,ANSR Dubai,,Professional Service Charges,10874,54023425.76
01/17/2024,Expense,Careem,Harvey Spector,Travelling Expenses,4.49,54023430.25
01/17/2024,Expense,,MONTHLY CHARGE Bank Charges for the per 01DEC2023 TO 31DEC2023 Invoice No 1766672,General business expenses:Bank fees & service charges,-29.76,54023400.49
01/17/2024,Credit Card Credit,Raycast,Harvey Spector,Tools & Subscription - G&A,-4.93,54023395.56
01/17/2024,Expense,Careem,Harvey Spector,Travelling Expenses,4.49,54023400.05
01/17/2024,Expense,Auth0,Praveen Kumar,Credit Card - Ramp,35,54023435.05
01/17/2024,Expense,Booking.com,Balapavan Tirumani,Travelling Expenses,307.5,54023742.55
01/17/2024,Expense,Auth0,Praveen Kumar,Tools & Subscription - G&A,35,54023777.55
01/18/2024,Expense,Tamarama Kiosk,Mike ross,Meals & Entertainment,16.33,54023793.88
01/18/2024,Expense,Segment,Balapavan Tirumani,Tools & Subscription - G&A,120,54023913.88
01/18/2024,Expense,Reclaim.ai,Max Kausman,Tools & Subscription - G&A,8,54023921.88
01/18/2024,Expense,Reclaim.ai,Max Kausman,Tools & Subscription - G&A,8,54023929.88
01/18/2024,Expense,Intuit,Harvey Spector,Credit Card - Ramp,60,54023989.88
01/18/2024,Expense,Tamarama Kiosk,Mike ross,Meals & Entertainment,16.33,54024006.21
01/18/2024,Expense,Reclaim.ai,Max Kausman,Credit Card - Ramp,8,54024014.21
01/18/2024,Expense,Segment,Balapavan Tirumani,Tools & Subscription - G&A,120,54024134.21
01/18/2024,Expense,Intuit,Harvey Spector,Tools & Subscription - G&A,60,54024194.21
01/18/2024,Expense,Segment,Balapavan Tirumani,Credit Card - Ramp,120,54024314.21
01/18/2024,Expense,Tamarama Kiosk,Mike ross,Meals & Entertainment,16.33,54024330.54
01/18/2024,Expense,Tamarama Kiosk,Mike ross,Credit Card - Ramp,16.33,54024346.87
01/18/2024,Expense,Intuit,Harvey Spector,Tools & Subscription - G&A,60,54024406.87
01/18/2024,Expense,Segment,Balapavan Tirumani,Tools & Subscription - G&A,120,54024526.87
01/18/2024,Expense,Intuit,Harvey Spector,Tools & Subscription - G&A,60,54024586.87
01/18/2024,Expense,Reclaim.ai,Max Kausman,Tools & Subscription - G&A,8,54024594.87
01/18/2024,Expense,Reclaim.ai,Max Kausman,Tools & Subscription - G&A,8,54024602.87
01/18/2024,Expense,Tamarama Kiosk,Mike ross,Credit Card - Ramp,16.33,54024619.2
01/18/2024,Expense,Intuit,Harvey Spector,Credit Card - Ramp,60,54024679.2
01/18/2024,Expense,Segment,Balapavan Tirumani,Credit Card - Ramp,120,54024799.2
01/18/2024,Expense,Intuit,Harvey Spector,Tools & Subscription - G&A,60,54024859.2
01/18/2024,Expense,Tamarama Kiosk,Mike ross,Meals & Entertainment,16.33,54024875.53
01/18/2024,Expense,Tamarama Kiosk,Mike ross,Credit Card - Ramp,16.33,54024891.86
01/18/2024,Expense,Reclaim.ai,Max Kausman,Credit Card - Ramp,8,54024899.86
01/18/2024,Expense,Segment,Balapavan Tirumani,Credit Card - Ramp,120,54025019.86
01/18/2024,Expense,Tamarama Kiosk,Mike ross,Credit Card - Ramp,16.33,54025036.19
01/18/2024,Expense,Intuit,Harvey Spector,Credit Card - Ramp,60,54025096.19
01/18/2024,Expense,Reclaim.ai,Max Kausman,Credit Card - Ramp,8,54025104.19
01/18/2024,Expense,Segment,Balapavan Tirumani,Tools & Subscription - G&A,120,54025224.19
01/19/2024,Expense,Uber Eats,Mike ross,Meals & Entertainment,15.91,54025240.1
01/19/2024,Expense,Uber Eats,Mike ross,Credit Card - Ramp,15.91,54025256.01
01/19/2024,Expense,Careem,Harvey Spector,Travelling Expenses,10.66,54025266.67
01/19/2024,Expense,Yango,Harvey Spector,Travelling Expenses,21.32,54025287.99
01/19/2024,Expense,Uber,Mike ross,Travelling Expenses,14.94,54025302.93
01/19/2024,Expense,PocketSmith,Harvey Spector,Tools & Subscription - G&A,14.95,54025317.88
01/19/2024,Expense,PocketSmith,Harvey Spector,Credit Card - Ramp,14.95,54025332.83
01/19/2024,Expense,Yango,Harvey Spector,Travelling Expenses,21.32,54025354.15
01/19/2024,Expense,Yango,Harvey Spector,Travelling Expenses,28.61,54025382.76
01/19/2024,Expense,Uber Eats,Mike ross,Meals & Entertainment,15.91,54025398.67
01/19/2024,Expense,Uber,Mike ross,Travelling Expenses,14.94,54025413.61
01/19/2024,Expense,Uber,Mike ross,Credit Card - Ramp,14.94,54025428.55
01/19/2024,Expense,Careem,Harvey Spector,Travelling Expenses,10.66,54025439.21
01/19/2024,Bill Payment (Check),ANSR Dubai,,HSBC A/c,-10874,54014565.21
01/19/2024,Expense,Careem,Harvey Spector,Credit Card - Ramp,10.66,54014575.87
01/19/2024,Expense,Yango,Harvey Spector,Credit Card - Ramp,28.61,54014604.48
01/19/2024,Expense,Yango,Harvey Spector,Credit Card - Ramp,21.32,54014625.8
01/19/2024,Expense,Yango,Harvey Spector,Travelling Expenses,21.32,54014647.12
01/19/2024,Bill Payment (Check),ANSR Dubai,BOOK TRANSFER DEBIT 45BOOK DEBIT CHRONICLEHQ INC.*BNF:ANSR (EMEA) GLOBAL SERVICES LIM ITED*BBI:/DAS/REF:58486SI00DA9*STBOOK*TIME:0339*YOUR REF:58486SI0 0DA9*OUR REF:019159769,Accounts Payable (A/P),-10874,54003773.12
01/19/2024,Expense,Yango,Harvey Spector,Travelling Expenses,28.61,54003801.73
01/19/2024,Bill Payment (Check),ANSR Dubai,,HSBC A/c,-10874,53992927.73
01/19/2024,Bill Payment (Check),ANSR Dubai,,HSBC A/c,-10874,53982053.73
01/19/2024,Expense,Uber Eats,Mike ross,Meals & Entertainment,15.91,53982069.64
01/19/2024,Expense,PocketSmith,Harvey Spector,Tools & Subscription - G&A,14.95,53982084.59
01/19/2024,Expense,Yango,Harvey Spector,Travelling Expenses,28.61,53982113.2
01/19/2024,Expense,Careem,Harvey Spector,Travelling Expenses,10.66,53982123.86
01/19/2024,Expense,PocketSmith,Harvey Spector,Tools & Subscription - G&A,14.95,53982138.81
01/19/2024,Expense,Uber Eats,Mike ross,Meals & Entertainment,15.91,53982154.72
01/19/2024,Expense,Uber Eats,Mike ross,Credit Card - Ramp,15.91,53982170.63
01/19/2024,Expense,Yango,Harvey Spector,Travelling Expenses,21.32,53982191.95
01/19/2024,Expense,Yango,Harvey Spector,Credit Card - Ramp,28.61,53982220.56
01/19/2024,Expense,Careem,Harvey Spector,Credit Card - Ramp,10.66,53982231.22
01/19/2024,Expense,Yango,Harvey Spector,Credit Card - Ramp,21.32,53982252.54
01/19/2024,Expense,Uber,Mike ross,Credit Card - Ramp,14.94,53982267.48
01/19/2024,Expense,PocketSmith,Harvey Spector,Tools & Subscription - G&A,14.95,53982282.43
01/19/2024,Bill Payment (Check),ANSR Dubai,BOOK TRANSFER DEBIT 45BOOK DEBIT CHRONICLEHQ INC.*BNF:ANSR (EMEA) GLOBAL SERVICES LIM ITED*BBI:/DAS/REF:58486SI00DA9*STBOOK*TIME:0339*YOUR REF:58486SI0 0DA9*OUR REF:019159769,Accounts Payable (A/P),-10874,53971408.43
01/19/2024,Expense,Uber Eats,Mike ross,Credit Card - Ramp,15.91,53971424.34
01/19/2024,Expense,Careem,Harvey Spector,Travelling Expenses,10.66,53971435
01/19/2024,Expense,PocketSmith,Harvey Spector,Credit Card - Ramp,14.95,53971449.95
01/19/2024,Expense,Uber,Mike ross,Travelling Expenses,14.94,53971464.89
01/19/2024,Bill Payment (Check),ANSR Dubai,BOOK TRANSFER DEBIT 45BOOK DEBIT CHRONICLEHQ INC.*BNF:ANSR (EMEA) GLOBAL SERVICES LIM ITED*BBI:/DAS/REF:58486SI00DA9*STBOOK*TIME:0339*YOUR REF:58486SI0 0DA9*OUR REF:019159769,Accounts Payable (A/P),-10874,53960590.89
01/19/2024,Expense,Uber,Mike ross,Travelling Expenses,14.94,53960605.83
01/19/2024,Expense,Uber,Mike ross,Credit Card - Ramp,14.94,53960620.77
01/19/2024,Expense,PocketSmith,Harvey Spector,Credit Card - Ramp,14.95,53960635.72
01/19/2024,Expense,Careem,Harvey Spector,Credit Card - Ramp,10.66,53960646.38
01/19/2024,Expense,Yango,Harvey Spector,Travelling Expenses,28.61,53960674.99
01/19/2024,Expense,Yango,Harvey Spector,Credit Card - Ramp,21.32,53960696.31
01/19/2024,Bill Payment (Check),ANSR Dubai,BOOK TRANSFER DEBIT 45BOOK DEBIT CHRONICLEHQ INC.*BNF:ANSR (EMEA) GLOBAL SERVICES LIM ITED*BBI:/DAS/REF:58486SI00DA9*STBOOK*TIME:0339*YOUR REF:58486SI0 0DA9*OUR REF:019159769,Accounts Payable (A/P),-10874,53949822.31
01/19/2024,Expense,Uber Eats,Mike ross,Credit Card - Ramp,15.91,53949838.22
01/19/2024,Bill Payment (Check),ANSR Dubai,,HSBC A/c,-10874,53938964.22
01/19/2024,Expense,Yango,Harvey Spector,Credit Card - Ramp,28.61,53938992.83
01/20/2024,Expense,BuildBetter,Max Kausman,Tools & Subscription - G&A,100,53939092.83
01/20/2024,Expense,Careem,Harvey Spector,Travelling Expenses,6.45,53939099.28
01/20/2024,Expense,BuildBetter,Max Kausman,Credit Card - Ramp,100,53939199.28
01/20/2024,Expense,BuildBetter,Max Kausman,Tools & Subscription - G&A,100,53939299.28
01/20/2024,Expense,Careem,Harvey Spector,Credit Card - Ramp,6.45,53939305.73
01/20/2024,Expense,Careem,Harvey Spector,Travelling Expenses,6.45,53939312.18
01/20/2024,Expense,BuildBetter,Max Kausman,Credit Card - Ramp,100,53939412.18
01/20/2024,Expense,Careem,Harvey Spector,Credit Card - Ramp,6.45,53939418.63
01/20/2024,Expense,Careem,Harvey Spector,Credit Card - Ramp,6.45,53939425.08
01/20/2024,Expense,BuildBetter,Max Kausman,Tools & Subscription - G&A,100,53939525.08
01/20/2024,Expense,BuildBetter,Max Kausman,Tools & Subscription - G&A,100,53939625.08
01/20/2024,Expense,Careem,Harvey Spector,Travelling Expenses,6.45,53939631.53
01/20/2024,Expense,Careem,Harvey Spector,Travelling Expenses,6.45,53939637.98
01/20/2024,Expense,BuildBetter,Max Kausman,Credit Card - Ramp,100,53939737.98
01/21/2024,Expense,THE SUM OF US,Harvey Spector,Meals & Entertainment,31.95,53939769.93
01/21/2024,Expense,Telstra,Mike ross,Utilities:Internet & TV services,108.83,53939878.76
01/21/2024,Expense,THE SUM OF US,Harvey Spector,Credit Card - Ramp,31.95,53939910.71
01/21/2024,Expense,Telstra,Mike ross,Utilities:Internet & TV services,108.83,53940019.54
01/21/2024,Expense,THE SUM OF US,Harvey Spector,Credit Card - Ramp,31.95,53940051.49
01/21/2024,Expense,Telstra,Mike ross,Credit Card - Ramp,108.83,53940160.32
01/21/2024,Expense,Telstra,Mike ross,Credit Card - Ramp,108.83,53940269.15
01/21/2024,Expense,The New York Times,Mike ross,Credit Card - Ramp,8.16,53940277.31
01/21/2024,Expense,Telstra,Mike ross,Credit Card - Ramp,108.83,53940386.14
01/21/2024,Expense,The New York Times,Mike ross,Credit Card - Ramp,8.16,53940394.3
01/21/2024,Expense,Telstra,Mike ross,Utilities:Internet & TV services,108.83,53940503.13
01/21/2024,Expense,The New York Times,Mike ross,General business expenses:Memberships & subscriptions,8.16,53940511.29
01/21/2024,Expense,THE SUM OF US,Harvey Spector,Meals & Entertainment,31.95,53940543.24
01/21/2024,Expense,THE SUM OF US,Harvey Spector,Meals & Entertainment,31.95,53940575.19
01/21/2024,Expense,The New York Times,Mike ross,General business expenses:Memberships & subscriptions,8.16,53940583.35
01/21/2024,Expense,THE SUM OF US,Harvey Spector,Meals & Entertainment,31.95,53940615.3
01/21/2024,Expense,THE SUM OF US,Harvey Spector,Credit Card - Ramp,31.95,53940647.25
01/21/2024,Expense,The New York Times,Mike ross,General business expenses:Memberships & subscriptions,8.16,53940655.41
01/21/2024,Expense,Telstra,Mike ross,Utilities:Internet & TV services,108.83,53940764.24
01/21/2024,Expense,THE SUM OF US,Harvey Spector,Credit Card - Ramp,31.95,53940796.19
01/21/2024,Expense,The New York Times,Mike ross,Credit Card - Ramp,8.16,53940804.35
01/21/2024,Expense,The New York Times,Mike ross,Credit Card - Ramp,8.16,53940812.51
01/21/2024,Expense,The New York Times,Mike ross,General business expenses:Memberships & subscriptions,8.16,53940820.67
01/22/2024,Expense,Stately.ai,Chris Jerochim,Tools & Subscription - G&A,39,53940859.67
01/22/2024,Expense,Stately.ai,Chris Jerochim,Credit Card - Ramp,39,53940898.67
01/22/2024,Credit Card Payment,RAMP BUSINESS CO,RAMP STATEMENT,Credit Card - Ramp,-8804,53932094.67
01/22/2024,Credit Card Payment,RAMP BUSINESS CO,RAMP STATEMENT,Credit Card - Ramp,-8804,53923290.67
01/22/2024,Expense,Geekbot,Mike ross,Credit Card - Ramp,330,53923620.67
01/22/2024,Expense,Geekbot,Mike ross,Credit Card - Ramp,330,53923950.67
01/22/2024,Expense,Stately.ai,Chris Jerochim,Credit Card - Ramp,39,53923989.67
01/22/2024,Expense,Geekbot,Mike ross,Tools & Subscription - G&A,330,53924319.67
01/22/2024,Expense,Geekbot,Mike ross,Tools & Subscription - G&A,330,53924649.67
01/22/2024,Credit Card Payment,RAMP BUSINESS CO,RAMP STATEMENT,Credit Card - Ramp,-8804,53915845.67
01/22/2024,Credit Card Payment,RAMP BUSINESS CO,RAMP STATEMENT,Account1,-8804,53907041.67
01/22/2024,Expense,Geekbot,Mike ross,Credit Card - Ramp,330,53907371.67
01/22/2024,Credit Card Payment,RAMP BUSINESS CO,RAMP STATEMENT,Account1,-8804,53898567.67
01/22/2024,Credit Card Payment,RAMP BUSINESS CO,RAMP STATEMENT,Account1,-8804,53889763.67
01/22/2024,Expense,Stately.ai,Chris Jerochim,Tools & Subscription - G&A,39,53889802.67
01/22/2024,Expense,Stately.ai,Chris Jerochim,Tools & Subscription - G&A,39,53889841.67
01/22/2024,Expense,Geekbot,Mike ross,Tools & Subscription - G&A,330,53890171.67
01/22/2024,Credit Card Payment,RAMP BUSINESS CO,RAMP STATEMENT,Credit Card - Ramp,-8804,53881367.67
01/22/2024,Expense,Geekbot,Mike ross,Tools & Subscription - G&A,330,53881697.67
01/22/2024,Expense,Stately.ai,Chris Jerochim,Credit Card - Ramp,39,53881736.67
01/22/2024,Expense,Stately.ai,Chris Jerochim,Tools & Subscription - G&A,39,53881775.67
01/22/2024,Credit Card Payment,RAMP BUSINESS CO,RAMP STATEMENT,Account1,-8804,53872971.67
01/23/2024,Expense,Superhuman,Mike ross,Professional Service Charges,90,53873061.67
01/23/2024,Expense,Aussie Broadband,Mike ross,Tools & Subscription - G&A,278.75,53873340.42
01/23/2024,Expense,Uber,Mike ross,Travelling Expenses,16.49,53873356.91
01/23/2024,Expense,Superhuman,Mike ross,Professional Service Charges,90,53873446.91
01/23/2024,Expense,Heptabase,Mike ross,Tools & Subscription - G&A,9.99,53873456.9
01/23/2024,Expense,Superhuman,Mike ross,Professional Service Charges,90,53873546.9
01/23/2024,Expense,Aussie Broadband,Mike ross,Tools & Subscription - G&A,278.75,53873825.65
01/23/2024,Expense,Aussie Broadband,Mike ross,Tools & Subscription - G&A,278.75,53874104.4
01/23/2024,Expense,Superhuman,Mike ross,Credit Card - Ramp,90,53874194.4
01/23/2024,Expense,Heptabase,Mike ross,Tools & Subscription - G&A,9.99,53874204.39
01/23/2024,Expense,Aussie Broadband,Mike ross,Credit Card - Ramp,278.75,53874483.14
01/23/2024,Expense,Uber,Mike ross,Travelling Expenses,16.49,53874499.63
01/23/2024,Expense,Uber,Mike ross,Travelling Expenses,16.49,53874516.12
01/23/2024,Expense,Heptabase,Mike ross,Credit Card - Ramp,9.99,53874526.11
01/23/2024,Expense,Superhuman,Mike ross,Credit Card - Ramp,90,53874616.11
01/23/2024,Expense,Superhuman,Mike ross,Credit Card - Ramp,90,53874706.11
01/23/2024,Expense,Heptabase,Mike ross,Credit Card - Ramp,9.99,53874716.1
01/23/2024,Expense,Uber,Mike ross,Travelling Expenses,16.49,53874732.59
01/23/2024,Expense,Heptabase,Mike ross,Credit Card - Ramp,9.99,53874742.58
01/23/2024,Expense,Aussie Broadband,Mike ross,Credit Card - Ramp,278.75,53875021.33
01/23/2024,Expense,Superhuman,Mike ross,Credit Card - Ramp,90,53875111.33
01/23/2024,Expense,Uber,Mike ross,Credit Card - Ramp,16.49,53875127.82
01/23/2024,Expense,Uber,Mike ross,Credit Card - Ramp,16.49,53875144.31
01/23/2024,Expense,Superhuman,Mike ross,Professional Service Charges,90,53875234.31
01/23/2024,Expense,Aussie Broadband,Mike ross,Tools & Subscription - G&A,278.75,53875513.06
01/23/2024,Expense,Aussie Broadband,Mike ross,Credit Card - Ramp,278.75,53875791.81
01/23/2024,Expense,Heptabase,Mike ross,Tools & Subscription - G&A,9.99,53875801.8
01/23/2024,Expense,Heptabase,Mike ross,Tools & Subscription - G&A,9.99,53875811.79
01/23/2024,Expense,Uber,Mike ross,Credit Card - Ramp,16.49,53875828.28
01/24/2024,Expense,Felt,Harvey Spector,Tools & Subscription - G&A,36,53875864.28
01/24/2024,Expense,Felt,Harvey Spector,Tools & Subscription - G&A,36,53875900.28
01/24/2024,Expense,Felt,Harvey Spector,Credit Card - Ramp,36,53875936.28
01/24/2024,Expense,Felt,Harvey Spector,Credit Card - Ramp,36,53875972.28
01/24/2024,Expense,Felt,Harvey Spector,Credit Card - Ramp,36,53876008.28
01/24/2024,Expense,Felt,Harvey Spector,Tools & Subscription - G&A,36,53876044.28
01/24/2024,Expense,Felt,Harvey Spector,Tools & Subscription - G&A,36,53876080.28
01/25/2024,Expense,GitKraken,Ahielan Ravichandran,Tools & Subscription - G&A,48,53876128.28
01/25/2024,Expense,Uber,Mike ross,Travelling Expenses,29.93,53876158.21
01/25/2024,Expense,GitKraken,Ahielan Ravichandran,Tools & Subscription - G&A,48,53876206.21
01/25/2024,Expense,GitKraken,Ahielan Ravichandran,Credit Card - Ramp,48,53876254.21
01/25/2024,Expense,Uber,Mike ross,Credit Card - Ramp,29.93,53876284.14
01/25/2024,Expense,Careem Plus,Harvey Spector,Credit Card - Ramp,5.33,53876289.47
01/25/2024,Expense,Careem,Harvey Spector,Credit Card - Ramp,10.52,53876299.99
01/25/2024,Expense,Uber,Mike ross,Credit Card - Ramp,29.93,53876329.92
01/25/2024,Expense,Careem Plus,Harvey Spector,Credit Card - Ramp,5.33,53876335.25
01/25/2024,Expense,Careem,Harvey Spector,Credit Card - Ramp,10.52,53876345.77
01/25/2024,Expense,Careem Plus,Harvey Spector,Travelling Expenses,5.33,53876351.1
01/25/2024,Expense,Careem,Harvey Spector,Travelling Expenses,10.52,53876361.62
01/25/2024,Expense,Careem Plus,Harvey Spector,Travelling Expenses,5.33,53876366.95
01/25/2024,Expense,GitKraken,Ahielan Ravichandran,Tools & Subscription - G&A,48,53876414.95
01/25/2024,Expense,GitKraken,Ahielan Ravichandran,Credit Card - Ramp,48,53876462.95
01/25/2024,Expense,Careem,Harvey Spector,Travelling Expenses,10.52,53876473.47
01/25/2024,Expense,Careem,Harvey Spector,Travelling Expenses,10.52,53876483.99
01/25/2024,Expense,Careem Plus,Harvey Spector,Credit Card - Ramp,5.33,53876489.32
01/25/2024,Expense,Uber,Mike ross,Travelling Expenses,29.93,53876519.25
01/25/2024,Expense,Uber,Mike ross,Credit Card - Ramp,29.93,53876549.18
01/25/2024,Expense,GitKraken,Ahielan Ravichandran,Credit Card - Ramp,48,53876597.18
01/25/2024,Expense,Uber,Mike ross,Travelling Expenses,29.93,53876627.11
01/25/2024,Expense,Uber,Mike ross,Travelling Expenses,29.93,53876657.04
01/25/2024,Expense,Careem,Harvey Spector,Travelling Expenses,10.52,53876667.56
01/25/2024,Expense,GitKraken,Ahielan Ravichandran,Tools & Subscription - G&A,48,53876715.56
01/25/2024,Expense,Careem Plus,Harvey Spector,Travelling Expenses,5.33,53876720.89
01/25/2024,Expense,Careem Plus,Harvey Spector,Travelling Expenses,5.33,53876726.22
01/25/2024,Expense,Careem,Harvey Spector,Credit Card - Ramp,10.52,53876736.74
01/26/2024,Expense,NordVPN,Harvey Spector,Tools & Subscription - G&A,81.36,53876818.1
01/26/2024,Expense,Amazon Pay,Harris Jose,Credit Card - Ramp,10.29,53876828.39
01/26/2024,Expense,NordVPN,Harvey Spector,Credit Card - Ramp,81.36,53876909.75
01/26/2024,Expense,Amazon Pay,Harris Jose,Credit Card - Ramp,10.29,53876920.04
01/26/2024,Expense,NordVPN,Harvey Spector,Tools & Subscription - G&A,81.36,53877001.4
01/26/2024,Expense,NordVPN,Harvey Spector,Credit Card - Ramp,81.36,53877082.76
01/26/2024,Expense,Amazon Pay,Harris Jose,Credit Card - Ramp,10.29,53877093.05
01/26/2024,Expense,Amazon Pay,Harris Jose,Professional Service Charges,10.29,53877103.34
01/26/2024,Expense,Amazon Pay,Harris Jose,Professional Service Charges,10.29,53877113.63
01/26/2024,Expense,Amazon Pay,Harris Jose,Professional Service Charges,10.29,53877123.92
01/26/2024,Expense,Amazon Pay,Harris Jose,Credit Card - Ramp,10.29,53877134.21
01/26/2024,Expense,NordVPN,Harvey Spector,Tools & Subscription - G&A,81.36,53877215.57
01/26/2024,Expense,Amazon Pay,Harris Jose,Professional Service Charges,10.29,53877225.86
01/26/2024,Expense,NordVPN,Harvey Spector,Credit Card - Ramp,81.36,53877307.22
01/26/2024,Expense,NordVPN,Harvey Spector,Tools & Subscription - G&A,81.36,53877388.58
01/27/2024,Expense,Sentry,Balapavan Tirumani,Tools & Subscription - G&A,29,53877417.58
01/27/2024,Expense,Amie,Harvey Spector,Credit Card - Ramp,200,53877617.58
01/27/2024,Expense,JB Hi-Fi,Mike ross - WFH expense - Airpods,Tools & Subscription - G&A,271.73,53877889.31
01/27/2024,Expense,Amie,Harvey Spector,Tools & Subscription - G&A,200,53878089.31
01/27/2024,Expense,Amie,Harvey Spector,Credit Card - Ramp,200,53878289.31
01/27/2024,Expense,JB Hi-Fi,Mike ross - WFH expense - Airpods,Credit Card - Ramp,271.73,53878561.04
01/27/2024,Expense,Amie,Harvey Spector,Tools & Subscription - G&A,200,53878761.04
01/27/2024,Expense,JB Hi-Fi,Mike ross - WFH expense - Airpods,Credit Card - Ramp,271.73,53879032.77
01/27/2024,Expense,Sentry,Balapavan Tirumani,Credit Card - Ramp,29,53879061.77
01/27/2024,Expense,Amie,Harvey Spector,Credit Card - Ramp,200,53879261.77
01/27/2024,Expense,Sentry,Balapavan Tirumani,Tools & Subscription - G&A,29,53879290.77
01/27/2024,Expense,Sentry,Balapavan Tirumani,Credit Card - Ramp,29,53879319.77
01/27/2024,Expense,Sentry,Balapavan Tirumani,Tools & Subscription - G&A,29,53879348.77
01/27/2024,Expense,JB Hi-Fi,Mike ross - WFH expense - Airpods,Tools & Subscription - G&A,271.73,53879620.5
01/27/2024,Expense,Amie,Harvey Spector,Tools & Subscription - G&A,200,53879820.5
01/27/2024,Expense,JB Hi-Fi,Mike ross - WFH expense - Airpods,Credit Card - Ramp,271.73,53880092.23
01/27/2024,Expense,JB Hi-Fi,Mike ross - WFH expense - Airpods,Tools & Subscription - G&A,271.73,53880363.96
01/27/2024,Expense,Sentry,Balapavan Tirumani,Tools & Subscription - G&A,29,53880392.96
01/27/2024,Expense,JB Hi-Fi,Mike ross - WFH expense - Airpods,Tools & Subscription - G&A,271.73,53880664.69
01/27/2024,Expense,Amie,Harvey Spector,Tools & Subscription - G&A,200,53880864.69
01/27/2024,Expense,Sentry,Balapavan Tirumani,Credit Card - Ramp,29,53880893.69
01/28/2024,Expense,Github,Balapavan Tirumani,Tools & Subscription - G&A,10,53880903.69
01/28/2024,Expense,Github,Balapavan Tirumani,Credit Card - Ramp,10,53880913.69
01/28/2024,Expense,Github,Balapavan Tirumani,Credit Card - Ramp,44,53880957.69
01/28/2024,Expense,Github,Balapavan Tirumani,Credit Card - Ramp,10,53880967.69
01/28/2024,Expense,Github,Balapavan Tirumani,Credit Card - Ramp,44,53881011.69
01/28/2024,Expense,Github,Balapavan Tirumani,Tools & Subscription - G&A,44,53881055.69
01/28/2024,Expense,Github,Balapavan Tirumani,Credit Card - Ramp,10,53881065.69
01/28/2024,Expense,Github,Balapavan Tirumani,Tools & Subscription - G&A,10,53881075.69
01/28/2024,Expense,Github,Balapavan Tirumani,Tools & Subscription - G&A,44,53881119.69
01/28/2024,Expense,Github,Balapavan Tirumani,Tools & Subscription - G&A,10,53881129.69
01/28/2024,Expense,Github,Balapavan Tirumani,Tools & Subscription - G&A,44,53881173.69
01/28/2024,Expense,Github,Balapavan Tirumani,Tools & Subscription - G&A,10,53881183.69
01/28/2024,Expense,Github,Balapavan Tirumani,Tools & Subscription - G&A,44,53881227.69
01/28/2024,Expense,Github,Balapavan Tirumani,Credit Card - Ramp,44,53881271.69
01/29/2024,Expense,Dubai Taxi,Harvey Spector,Credit Card - Ramp,13.74,53881285.43
01/29/2024,Bill Payment (Check),Big Company ,,Accounts Payable (A/P),-100000,53781285.43
01/29/2024,Expense,Netlify,Balapavan Tirumani,Credit Card - Ramp,19,53781304.43
01/29/2024,Expense,Netlify,Balapavan Tirumani,Tools & Subscription - G&A,19,53781323.43
01/29/2024,Expense,Scotia York Pty Ltd,Mike ross,Credit Card - Ramp,32.38,53781355.81
01/29/2024,Bill Payment (Check),Big Company ,,HSBC A/c,-100000,53681355.81
01/29/2024,Bill Payment (Check),Big Company ,,HSBC A/c,-100000,53581355.81
01/29/2024,Bill Payment (Check),Big Company ,,Accounts Payable (A/P),-100000,53481355.81
01/29/2024,Expense,Netlify,Balapavan Tirumani,Tools & Subscription - G&A,19,53481374.81
01/29/2024,Expense,Scotia York Pty Ltd,Mike ross,Credit Card - Ramp,32.38,53481407.19
01/29/2024,Expense,Scotia York Pty Ltd,Mike ross,Meals & Entertainment,32.38,53481439.57
01/29/2024,Expense,Scotia York Pty Ltd,Mike ross,Meals & Entertainment,32.38,53481471.95
01/29/2024,Expense,Scotia York Pty Ltd,Mike ross,Credit Card - Ramp,32.38,53481504.33
01/29/2024,Bill Payment (Check),Big Company ,,Accounts Payable (A/P),-100000,53381504.33
01/29/2024,Expense,Netlify,Balapavan Tirumani,Tools & Subscription - G&A,19,53381523.33
01/29/2024,Bill Payment (Check),Big Company ,,Accounts Payable (A/P),-100000,53281523.33
01/29/2024,Expense,Dubai Taxi,Harvey Spector,Travelling Expenses,13.74,53281537.07
01/29/2024,Expense,Netlify,Balapavan Tirumani,Credit Card - Ramp,19,53281556.07
01/29/2024,Expense,Dubai Taxi,Harvey Spector,Travelling Expenses,13.74,53281569.81
01/29/2024,Expense,Netlify,Balapavan Tirumani,Tools & Subscription - G&A,19,53281588.81
01/29/2024,Expense,Dubai Taxi,Harvey Spector,Travelling Expenses,13.74,53281602.55
01/29/2024,Bill Payment (Check),Big Company ,,HSBC A/c,-100000,53181602.55
01/29/2024,Expense,Scotia York Pty Ltd,Mike ross,Meals & Entertainment,32.38,53181634.93
01/29/2024,Expense,Scotia York Pty Ltd,Mike ross,Meals & Entertainment,32.38,53181667.31
01/29/2024,Expense,Dubai Taxi,Harvey Spector,Travelling Expenses,13.74,53181681.05
01/29/2024,Expense,Dubai Taxi,Harvey Spector,Credit Card - Ramp,13.74,53181694.79
01/29/2024,Expense,Netlify,Balapavan Tirumani,Credit Card - Ramp,19,53181713.79
01/29/2024,Bill Payment (Check),Big Company ,,HSBC A/c,-100000,53081713.79
01/29/2024,Expense,Dubai Taxi,Harvey Spector,Credit Card - Ramp,13.74,53081727.53
01/29/2024,Expense,Scotia York Pty Ltd,Mike ross,Credit Card - Ramp,32.38,53081759.91
01/30/2024,Expense,Assembly Label,Mike ross - Welcome gift for Pavan,Credit Card - Ramp,81.81,53081841.72
01/30/2024,Expense,inkle,Harvey Spector,Tools & Subscription - G&A,30,53081871.72
01/30/2024,Expense,inkle,Harvey Spector,Credit Card - Ramp,30,53081901.72
01/30/2024,Expense,Assembly Label,Mike ross - Welcome gift for Pavan,Meals & Entertainment,81.81,53081983.53
01/30/2024,Expense,Assembly Label,Mike ross - Welcome gift for Pavan,Meals & Entertainment,81.81,53082065.34
01/30/2024,Expense,inkle,Harvey Spector,Tools & Subscription - G&A,30,53082095.34
01/30/2024,Expense,Assembly Label,Mike ross - Welcome gift for Pavan,Meals & Entertainment,81.81,53082177.15
01/30/2024,Bill,ANSR Dubai,Reimbursement of  Laptop Cost,Accounts Payable (A/P),3946,53086123.15
01/30/2024,Bill,ANSR Dubai,,laptop - Macbook,3946,53090069.15
01/30/2024,Bill,ANSR Dubai,Reimbursement of  Laptop Cost,Accounts Payable (A/P),3946,53094015.15
01/30/2024,Expense,inkle,Harvey Spector,Tools & Subscription - G&A,30,53094045.15
01/30/2024,Bill,ANSR Dubai,,laptop - Macbook,3946,53097991.15
01/30/2024,Bill,ANSR Dubai,,laptop - Macbook,3946,53101937.15
01/30/2024,Expense,Assembly Label,Mike ross - Welcome gift for Pavan,Meals & Entertainment,81.81,53102018.96
01/30/2024,Expense,inkle,Harvey Spector,Tools & Subscription - G&A,30,53102048.96
01/30/2024,Bill,ANSR Dubai,Reimbursement of  Laptop Cost,Accounts Payable (A/P),3946,53105994.96
01/30/2024,Bill,ANSR Dubai,,laptop - Macbook,3946,53109940.96
01/30/2024,Expense,inkle,Harvey Spector,Credit Card - Ramp,30,53109970.96
01/30/2024,Expense,Assembly Label,Mike ross - Welcome gift for Pavan,Credit Card - Ramp,81.81,53110052.77
01/30/2024,Bill,ANSR Dubai,Reimbursement of  Laptop Cost,Accounts Payable (A/P),3946,53113998.77
01/30/2024,Expense,Assembly Label,Mike ross - Welcome gift for Pavan,Credit Card - Ramp,81.81,53114080.58
01/30/2024,Expense,inkle,Harvey Spector,Credit Card - Ramp,30,53114110.58
01/30/2024,Expense,Assembly Label,Mike ross - Welcome gift for Pavan,Credit Card - Ramp,81.81,53114192.39
01/31/2024,Expense,,Reimbursement,HSBC A/c,1552.91,53115745.3
01/31/2024,Expense,Sendinblue,Balapavan Tirumani,Tools & Subscription - G&A,78.42,53115823.72
01/31/2024,Expense,Apify,Harvey Spector,Credit Card - Ramp,34.3,53115858.02
01/31/2024,Credit Card Credit,PocketSmith,Harvey Spector,Credit Card - Ramp,-14.95,53115843.07
01/31/2024,Expense,Sendinblue,Balapavan Tirumani,Credit Card - Ramp,78.42,53115921.49
01/31/2024,Expense,Sendinblue,Balapavan Tirumani,Tools & Subscription - G&A,78.42,53115999.91
01/31/2024,Expense,Adobe,Mike ross,Credit Card - Ramp,19.79,53116019.7
01/31/2024,Bill,Big Company ,"Service Expenses for the month of January 2024 
INR   48,78,658   @ 83.1214",Accounts Payable (A/P),58693,53174712.7
01/31/2024,Expense,Syd Aprt Intnl Carp50,Mike ross,Credit Card - Ramp,7.3,53174720
01/31/2024,Expense,,Reimbursement,HSBC A/c,1552.91,53176272.91
01/31/2024,Bill,Big Company ,"Service Expenses for the month of January 2024 
INR   48,78,658   @ 83.1214",Accounts Payable (A/P),58693,53234965.91
01/31/2024,Credit Card Credit,PocketSmith,Harvey Spector,Tools & Subscription - G&A,-14.95,53234950.96
01/31/2024,Expense,,Reimbursement,HSBC A/c,1552.91,53236503.87
01/31/2024,Expense,Will & Co,Mike ross,Meals & Entertainment,10.24,53236514.11
01/31/2024,Expense,,BOOK TRANSFER DEBIT 45BOOK DEBIT CHRONICLEHQ INC.*BNF:Harvey Spector*BBI:/DAS/RE F:17006SV00YOX*EXCH:AED 5551.00 AT 0.2797539*STBOOK*TIME:0604*YOU R REF:REIMBURSEMENT*OUR REF:031170070*TMS:2024-01-31T11:04:22 GMT *MID:0.27225849,Cost of goods sold:Supplies & materials - COGS:Reimbursement-Tejas,-1552.91,53234961.2
01/31/2024,Expense,Adobe,Mike ross,Credit Card - Ramp,19.79,53234980.99
01/31/2024,Expense,Apify,Harvey Spector,Tools & Subscription - G&A,34.3,53235015.29
01/31/2024,Expense,Syd Aprt Intnl Carp50,Mike ross,Travelling Expenses,7.3,53235022.59
01/31/2024,Expense,Adobe,Mike ross,Tools & Subscription - S&M,19.79,53235042.38
01/31/2024,Expense,Syd Aprt Intnl Carp50,Mike ross,Travelling Expenses,7.3,53235049.68
01/31/2024,Expense,Apify,Harvey Spector,Tools & Subscription - G&A,34.3,53235083.98
01/31/2024,Credit Card Credit,PocketSmith,Harvey Spector,Tools & Subscription - G&A,-14.95,53235069.03
01/31/2024,Expense,Sendinblue,Balapavan Tirumani,Tools & Subscription - G&A,78.42,53235147.45
01/31/2024,Credit Card Credit,PocketSmith,Harvey Spector,Tools & Subscription - G&A,-14.95,53235132.5
01/31/2024,Expense,Adobe,Mike ross,Tools & Subscription - S&M,19.79,53235152.29
01/31/2024,Expense,Will & Co,Mike ross,Meals & Entertainment,10.24,53235162.53
01/31/2024,Expense,Adobe,Mike ross,Tools & Subscription - S&M,19.79,53235182.32
01/31/2024,Expense,Will & Co,Mike ross,Meals & Entertainment,10.24,53235192.56
01/31/2024,Expense,Syd Aprt Intnl Carp50,Mike ross,Travelling Expenses,7.3,53235199.86
01/31/2024,Expense,Apify,Harvey Spector,Credit Card - Ramp,34.3,53235234.16
01/31/2024,Bill,Big Company ,"Service Expenses for the month of January 2024 
INR   48,78,658   @ 83.1214",Accounts Payable (A/P),58693,53293927.16
01/31/2024,Expense,Apify,Harvey Spector,Tools & Subscription - G&A,34.3,53293961.46
01/31/2024,Expense,Will & Co,Mike ross,Credit Card - Ramp,10.24,53293971.7
01/31/2024,Expense,Syd Aprt Intnl Carp50,Mike ross,Credit Card - Ramp,7.3,53293979
01/31/2024,Expense,Sendinblue,Balapavan Tirumani,Credit Card - Ramp,78.42,53294057.42
01/31/2024,Bill,Big Company ,,Outsources Services - India,58693,53352750.42
01/31/2024,Expense,Will & Co,Mike ross,Credit Card - Ramp,10.24,53352760.66
01/31/2024,Expense,,Reimbursement,HSBC A/c,1552.91,53354313.57
01/31/2024,Credit Card Credit,PocketSmith,Harvey Spector,Credit Card - Ramp,-14.95,53354298.62
01/31/2024,Expense,Apify,Harvey Spector,Credit Card - Ramp,34.3,53354332.92
01/31/2024,Expense,,BOOK TRANSFER DEBIT 45BOOK DEBIT CHRONICLEHQ INC.*BNF:Harvey Spector*BBI:/DAS/RE F:17006SV00YOX*EXCH:AED 5551.00 AT 0.2797539*STBOOK*TIME:0604*YOU R REF:REIMBURSEMENT*OUR REF:031170070*TMS:2024-01-31T11:04:22 GMT *MID:0.27225849,Cost of goods sold:Supplies & materials - COGS:Reimbursement-Tejas,-1552.91,53352780.01
01/31/2024,Expense,Sendinblue,Balapavan Tirumani,Credit Card - Ramp,78.42,53352858.43
01/31/2024,Expense,,BOOK TRANSFER DEBIT 45BOOK DEBIT CHRONICLEHQ INC.*BNF:Harvey Spector*BBI:/DAS/RE F:17006SV00YOX*EXCH:AED 5551.00 AT 0.2797539*STBOOK*TIME:0604*YOU R REF:REIMBURSEMENT*OUR REF:031170070*TMS:2024-01-31T11:04:22 GMT *MID:0.27225849,Cost of goods sold:Supplies & materials - COGS:Reimbursement-Tejas,-1552.91,53351305.52
01/31/2024,Expense,Will & Co,Mike ross,Meals & Entertainment,10.24,53351315.76
01/31/2024,Bill,Big Company ,"Service Expenses for the month of January 2024 
INR   48,78,658   @ 83.1214",Accounts Payable (A/P),58693,53410008.76
01/31/2024,Expense,Adobe,Mike ross,Tools & Subscription - S&M,19.79,53410028.55
01/31/2024,Bill,Big Company ,,Outsources Services - India,58693,53468721.55
01/31/2024,Credit Card Credit,PocketSmith,Harvey Spector,Tools & Subscription - G&A,-14.95,53468706.6
01/31/2024,Expense,,BOOK TRANSFER DEBIT 45BOOK DEBIT CHRONICLEHQ INC.*BNF:Harvey Spector*BBI:/DAS/RE F:17006SV00YOX*EXCH:AED 5551.00 AT 0.2797539*STBOOK*TIME:0604*YOU R REF:REIMBURSEMENT*OUR REF:031170070*TMS:2024-01-31T11:04:22 GMT *MID:0.27225849,Cost of goods sold:Supplies & materials - COGS:Reimbursement-Tejas,-1552.91,53467153.69
01/31/2024,Expense,Sendinblue,Balapavan Tirumani,Tools & Subscription - G&A,78.42,53467232.11
01/31/2024,Credit Card Credit,PocketSmith,Harvey Spector,Credit Card - Ramp,-14.95,53467217.16
01/31/2024,Expense,Will & Co,Mike ross,Credit Card - Ramp,10.24,53467227.4
01/31/2024,Expense,Will & Co,Mike ross,Credit Card - Ramp,10.24,53467237.64
01/31/2024,Bill,Big Company ,,Outsources Services - India,58693,53525930.64
01/31/2024,Expense,Adobe,Mike ross,Credit Card - Ramp,19.79,53525950.43
01/31/2024,Bill,Big Company ,,Outsources Services - India,58693,53584643.43
01/31/2024,Expense,Apify,Harvey Spector,Tools & Subscription - G&A,34.3,53584677.73
01/31/2024,Expense,Syd Aprt Intnl Carp50,Mike ross,Credit Card - Ramp,7.3,53584685.03
01/31/2024,Expense,Syd Aprt Intnl Carp50,Mike ross,Travelling Expenses,7.3,53584692.33
02/01/2024,Expense,Carbon Mexican Steakhouse - Port Orchard,"Mike ross - Team dinner - Pavan, MP, Max, CJ",Credit Card - Ramp,192.45,53584884.78
02/01/2024,Expense,MAPO,Balapavan Tirumani,Meals & Entertainment,13.47,53584898.25
02/01/2024,Expense,The Commons Surry Hil,Mike ross,Credit Card - Ramp,4.09,53584902.34
02/01/2024,Expense,La Renaissance,Mike ross,Credit Card - Ramp,18.31,53584920.65
02/01/2024,Expense,Liveblocks,Balapavan Tirumani,Credit Card - Ramp,99,53585019.65
02/01/2024,Expense,La Renaissance,Mike ross,Credit Card - Ramp,18.31,53585037.96
02/01/2024,Expense,Google G Suite,Mike ross - Google workspace,Tools & Subscription - G&A,105.93,53585143.89
02/01/2024,Expense,La Renaissance,Mike ross,Meals & Entertainment,18.31,53585162.2
02/01/2024,Expense,Grumpy's Pizza Pasta Bar,Balapavan Tirumani,Meals & Entertainment,28.87,53585191.07
02/01/2024,Expense,Grumpy's Pizza Pasta Bar,Balapavan Tirumani,Meals & Entertainment,28.87,53585219.94
02/01/2024,Expense,Render,Balapavan Tirumani,Tools & Subscription - G&A,289.03,53585508.97
02/01/2024,Expense,Google G Suite,Mike ross - Google workspace,Tools & Subscription - G&A,105.93,53585614.9
02/01/2024,Expense,Akiflow,Harvey Spector,Tools & Subscription - G&A,15,53585629.9
02/01/2024,Expense,Liveblocks,Balapavan Tirumani,Tools & Subscription - G&A,99,53585728.9
02/01/2024,Expense,Transport for NSW,Mike ross,Credit Card - Ramp,1.52,53585730.42
02/01/2024,Expense,Render,Balapavan Tirumani,Tools & Subscription - G&A,289.03,53586019.45
02/01/2024,Expense,Carbon Mexican Steakhouse - Port Orchard,"Mike ross - Team dinner - Pavan, MP, Max, CJ",Meals & Entertainment,192.45,53586211.9
02/01/2024,Expense,MAPO,Balapavan Tirumani,Credit Card - Ramp,13.47,53586225.37
02/01/2024,Expense,Transport for NSW,Mike ross,Credit Card - Ramp,1.52,53586226.89
02/01/2024,Expense,Render,Balapavan Tirumani,Credit Card - Ramp,289.03,53586515.92
02/01/2024,Expense,Google G Suite,Mike ross - Google workspace,Credit Card - Ramp,105.93,53586621.85
02/01/2024,Expense,Grumpy's Pizza Pasta Bar,Balapavan Tirumani,Meals & Entertainment,28.87,53586650.72
02/01/2024,Expense,The Commons Surry Hil,Mike ross,Travel:Hotels,4.09,53586654.81
02/01/2024,Expense,Grumpy's Pizza Pasta Bar,Balapavan Tirumani,Credit Card - Ramp,28.87,53586683.68
02/01/2024,Expense,Google G Suite,Mike ross - Google workspace,Tools & Subscription - G&A,105.93,53586789.61
02/01/2024,Expense,La Renaissance,Mike ross,Meals & Entertainment,18.31,53586807.92
02/01/2024,Expense,Render,Balapavan Tirumani,Tools & Subscription - G&A,289.03,53587096.95
02/01/2024,Expense,The Commons Surry Hil,Mike ross,Credit Card - Ramp,4.09,53587101.04
02/01/2024,Expense,Liveblocks,Balapavan Tirumani,Credit Card - Ramp,99,53587200.04
02/01/2024,Expense,Akiflow,Harvey Spector,Credit Card - Ramp,15,53587215.04
02/01/2024,Expense,The Commons Surry Hil,Mike ross,Travel:Hotels,4.09,53587219.13
02/01/2024,Expense,Akiflow,Harvey Spector,Tools & Subscription - G&A,15,53587234.13
02/01/2024,Expense,MAPO,Balapavan Tirumani,Meals & Entertainment,13.47,53587247.6
02/01/2024,Expense,Liveblocks,Balapavan Tirumani,Tools & Subscription - G&A,99,53587346.6
02/01/2024,Expense,Transport for NSW,Mike ross,Travelling Expenses,1.52,53587348.12
02/01/2024,Expense,Transport for NSW,Mike ross,Credit Card - Ramp,1.52,53587349.64
02/01/2024,Expense,Transport for NSW,Mike ross,Travelling Expenses,1.52,53587351.16
02/01/2024,Expense,MAPO,Balapavan Tirumani,Credit Card - Ramp,13.47,53587364.63
02/01/2024,Expense,Liveblocks,Balapavan Tirumani,Credit Card - Ramp,99,53587463.63
02/01/2024,Expense,MAPO,Balapavan Tirumani,Credit Card - Ramp,13.47,53587477.1
02/01/2024,Expense,Grumpy's Pizza Pasta Bar,Balapavan Tirumani,Credit Card - Ramp,28.87,53587505.97
02/01/2024,Expense,Carbon Mexican Steakhouse - Port Orchard,"Mike ross - Team dinner - Pavan, MP, Max, CJ",Credit Card - Ramp,192.45,53587698.42
02/01/2024,Expense,The Commons Surry Hil,Mike ross,Credit Card - Ramp,4.09,53587702.51
02/01/2024,Expense,Akiflow,Harvey Spector,Credit Card - Ramp,15,53587717.51
02/01/2024,Expense,Carbon Mexican Steakhouse - Port Orchard,"Mike ross - Team dinner - Pavan, MP, Max, CJ",Meals & Entertainment,192.45,53587909.96
02/01/2024,Expense,Transport for NSW,Mike ross,Travelling Expenses,1.52,53587911.48
02/01/2024,Expense,Liveblocks,Balapavan Tirumani,Tools & Subscription - G&A,99,53588010.48
02/01/2024,Expense,Grumpy's Pizza Pasta Bar,Balapavan Tirumani,Credit Card - Ramp,28.87,53588039.35
02/01/2024,Expense,The Commons Surry Hil,Mike ross,Travel:Hotels,4.09,53588043.44
02/01/2024,Expense,La Renaissance,Mike ross,Credit Card - Ramp,18.31,53588061.75
02/01/2024,Expense,Carbon Mexican Steakhouse - Port Orchard,"Mike ross - Team dinner - Pavan, MP, Max, CJ",Credit Card - Ramp,192.45,53588254.2
02/01/2024,Expense,Render,Balapavan Tirumani,Credit Card - Ramp,289.03,53588543.23
02/01/2024,Expense,Google G Suite,Mike ross - Google workspace,Credit Card - Ramp,105.93,53588649.16
02/01/2024,Expense,Carbon Mexican Steakhouse - Port Orchard,"Mike ross - Team dinner - Pavan, MP, Max, CJ",Meals & Entertainment,192.45,53588841.61
02/01/2024,Expense,MAPO,Balapavan Tirumani,Meals & Entertainment,13.47,53588855.08
02/01/2024,Expense,Grumpy's Pizza Pasta Bar,Balapavan Tirumani,Meals & Entertainment,28.87,53588883.95
02/01/2024,Expense,Grumpy's Pizza Pasta Bar,Balapavan Tirumani,Credit Card - Ramp,28.87,53588912.82
02/01/2024,Expense,La Renaissance,Mike ross,Meals & Entertainment,18.31,53588931.13
02/01/2024,Expense,Akiflow,Harvey Spector,Credit Card - Ramp,15,53588946.13
02/01/2024,Expense,Google G Suite,Mike ross - Google workspace,Tools & Subscription - G&A,105.93,53589052.06
02/01/2024,Expense,Google G Suite,Mike ross - Google workspace,Credit Card - Ramp,105.93,53589157.99
02/01/2024,Expense,La Renaissance,Mike ross,Credit Card - Ramp,18.31,53589176.3
02/01/2024,Expense,Carbon Mexican Steakhouse - Port Orchard,"Mike ross - Team dinner - Pavan, MP, Max, CJ",Credit Card - Ramp,192.45,53589368.75
02/01/2024,Expense,La Renaissance,Mike ross,Meals & Entertainment,18.31,53589387.06
02/01/2024,Expense,Akiflow,Harvey Spector,Tools & Subscription - G&A,15,53589402.06
02/01/2024,Expense,Render,Balapavan Tirumani,Credit Card - Ramp,289.03,53589691.09
02/01/2024,Expense,Render,Balapavan Tirumani,Tools & Subscription - G&A,289.03,53589980.12
02/01/2024,Expense,Carbon Mexican Steakhouse - Port Orchard,"Mike ross - Team dinner - Pavan, MP, Max, CJ",Meals & Entertainment,192.45,53590172.57
02/01/2024,Expense,Transport for NSW,Mike ross,Travelling Expenses,1.52,53590174.09
02/01/2024,Expense,Liveblocks,Balapavan Tirumani,Tools & Subscription - G&A,99,53590273.09
02/01/2024,Expense,The Commons Surry Hil,Mike ross,Travel:Hotels,4.09,53590277.18
02/01/2024,Expense,MAPO,Balapavan Tirumani,Meals & Entertainment,13.47,53590290.65
02/01/2024,Expense,Akiflow,Harvey Spector,Tools & Subscription - G&A,15,53590305.65
02/01/2024,Expense,MAPO,Balapavan Tirumani,Credit Card - Ramp,13.47,53590319.12
02/02/2024,Expense,noon Minutes,Harvey Spector,Credit Card - Ramp,8.78,53590327.9
02/02/2024,Expense,Scotia York Pty Ltd,Mike ross,Credit Card - Ramp,10.17,53590338.07
02/02/2024,Expense,June,Balapavan Tirumani,Tools & Subscription - G&A,149,53590487.07
02/02/2024,Deposit,,Savings Interest,Interest Received,0.88,53590487.95
02/02/2024,Expense,noon Minutes,Harvey Spector,Credit Card - Ramp,8.78,53590496.73
02/02/2024,Expense,Careem,Harvey Spector,Credit Card - Ramp,10.38,53590507.11
02/02/2024,Expense,lime,Balapavan Tirumani,Tools & Subscription - G&A,3.38,53590510.49
02/02/2024,Expense,Careem,Harvey Spector,Travelling Expenses,10.38,53590520.87
02/02/2024,Expense,lime,Balapavan Tirumani,Tools & Subscription - G&A,3.38,53590524.25
02/02/2024,Expense,Uber Eats,Mike ross,Credit Card - Ramp,37.14,53590561.39
02/02/2024,Expense,Scotia York Pty Ltd,Mike ross,Meals & Entertainment,10.17,53590571.56
02/02/2024,Expense,Uber Eats,Mike ross,Credit Card - Ramp,37.14,53590608.7
02/02/2024,Expense,lime,Balapavan Tirumani,Tools & Subscription - G&A,3.38,53590612.08
02/02/2024,Expense,June,Balapavan Tirumani,Credit Card - Ramp,149,53590761.08
02/02/2024,Expense,Uber Eats,Mike ross,Meals & Entertainment,37.14,53590798.22
02/02/2024,Deposit,,Savings Interest,Interest Received,0.88,53590799.1
02/02/2024,Expense,Scotia York Pty Ltd,Mike ross,Credit Card - Ramp,10.17,53590809.27
02/02/2024,Expense,Uber Eats,Mike ross,Credit Card - Ramp,37.14,53590846.41
02/02/2024,Expense,noon Minutes,Harvey Spector,Credit Card - Ramp,8.78,53590855.19
02/02/2024,Expense,noon Minutes,Harvey Spector,Credit Card - Ramp,8.78,53590863.97
02/02/2024,Deposit,,Savings Interest,Interest Received,0.88,53590864.85
02/02/2024,Expense,Uber Eats,Mike ross,Credit Card - Ramp,37.14,53590901.99
02/02/2024,Expense,Scotia York Pty Ltd,Mike ross,Credit Card - Ramp,10.17,53590912.16
02/02/2024,Expense,lime,Balapavan Tirumani,Credit Card - Ramp,3.38,53590915.54
02/02/2024,Expense,Amazon Web Services,Balapavan Tirumani,Credit Card - Ramp,45.12,53590960.66
02/02/2024,Deposit,,Savings Interest,Interest Received,0.88,53590961.54
02/02/2024,Expense,Careem,Harvey Spector,Credit Card - Ramp,10.38,53590971.92
02/02/2024,Deposit,,Savings Interest,Savings (6977),0.88,53590972.8
02/02/2024,Expense,Amazon Web Services,Balapavan Tirumani,Office expenses:Office supplies,45.12,53591017.92
02/02/2024,Expense,noon Minutes,Harvey Spector,Meals & Entertainment,8.78,53591026.7
02/02/2024,Expense,June,Balapavan Tirumani,Tools & Subscription - G&A,149,53591175.7
02/02/2024,Expense,Amazon Web Services,Balapavan Tirumani,Office expenses:Office supplies,45.12,53591220.82
02/02/2024,Expense,Careem,Harvey Spector,Travelling Expenses,10.38,53591231.2
02/02/2024,Expense,June,Balapavan Tirumani,Credit Card - Ramp,149,53591380.2
02/02/2024,Expense,lime,Balapavan Tirumani,Credit Card - Ramp,3.38,53591383.58
02/02/2024,Expense,June,Balapavan Tirumani,Tools & Subscription - G&A,149,53591532.58
02/02/2024,Deposit,,Savings Interest,Savings (6977),0.88,53591533.46
02/02/2024,Expense,June,Balapavan Tirumani,Credit Card - Ramp,149,53591682.46
02/02/2024,Expense,Amazon Web Services,Balapavan Tirumani,Credit Card - Ramp,45.12,53591727.58
02/02/2024,Expense,June,Balapavan Tirumani,Tools & Subscription - G&A,149,53591876.58
02/02/2024,Expense,Amazon Web Services,Balapavan Tirumani,Credit Card - Ramp,45.12,53591921.7
02/02/2024,Expense,Careem,Harvey Spector,Credit Card - Ramp,10.38,53591932.08
02/02/2024,Expense,noon Minutes,Harvey Spector,Meals & Entertainment,8.78,53591940.86
02/02/2024,Expense,Scotia York Pty Ltd,Mike ross,Meals & Entertainment,10.17,53591951.03
02/02/2024,Expense,Uber Eats,Mike ross,Meals & Entertainment,37.14,53591988.17
02/02/2024,Expense,lime,Balapavan Tirumani,Credit Card - Ramp,3.38,53591991.55
02/02/2024,Expense,Careem,Harvey Spector,Travelling Expenses,10.38,53592001.93
02/02/2024,Expense,Amazon Web Services,Balapavan Tirumani,Credit Card - Ramp,45.12,53592047.05
02/02/2024,Expense,Scotia York Pty Ltd,Mike ross,Meals & Entertainment,10.17,53592057.22
02/02/2024,Deposit,,Savings Interest,Savings (6977),0.88,53592058.1
02/02/2024,Expense,Scotia York Pty Ltd,Mike ross,Meals & Entertainment,10.17,53592068.27
02/02/2024,Expense,Scotia York Pty Ltd,Mike ross,Credit Card - Ramp,10.17,53592078.44
02/02/2024,Expense,noon Minutes,Harvey Spector,Meals & Entertainment,8.78,53592087.22
02/02/2024,Expense,Careem,Harvey Spector,Travelling Expenses,10.38,53592097.6
02/02/2024,Expense,Uber Eats,Mike ross,Meals & Entertainment,37.14,53592134.74
02/02/2024,Expense,Uber Eats,Mike ross,Meals & Entertainment,37.14,53592171.88
02/02/2024,Expense,noon Minutes,Harvey Spector,Meals & Entertainment,8.78,53592180.66
02/02/2024,Expense,Amazon Web Services,Balapavan Tirumani,Office expenses:Office supplies,45.12,53592225.78
02/02/2024,Expense,lime,Balapavan Tirumani,Tools & Subscription - G&A,3.38,53592229.16
02/02/2024,Expense,Amazon Web Services,Balapavan Tirumani,Office expenses:Office supplies,45.12,53592274.28
02/03/2024,Expense,Apple R254 Bondi,Mike ross,Credit Card - Ramp,680.46,53592954.74
02/03/2024,Expense,Canva,Harvey Spector,Tools & Subscription - G&A,119.99,53593074.73
02/03/2024,Expense,Bondi Trattoria,Balapavan Tirumani,Meals & Entertainment,23.23,53593097.96
02/03/2024,Expense,Apple R254 Bondi,Mike ross,Office expenses:Office supplies,680.46,53593778.42
02/03/2024,Expense,Live The Dream Pty Ltd.,Balapavan Tirumani,Meals & Entertainment,4.2,53593782.62
02/03/2024,Expense,VirtualPostMail,Harvey Spector,General business expenses:Memberships & subscriptions,35,53593817.62
02/03/2024,Expense,Apple R254 Bondi,Mike ross,Credit Card - Ramp,680.46,53594498.08
02/03/2024,Expense,Careem,Harvey Spector,Travelling Expenses,10.24,53594508.32
02/03/2024,Expense,Bondi Mart Pty Ltd,Balapavan Tirumani,Credit Card - Ramp,4.14,53594512.46
02/03/2024,Expense,Bondi Mart Pty Ltd,Balapavan Tirumani,Meals & Entertainment,4.14,53594516.6
02/03/2024,Expense,Careem,Harvey Spector,Credit Card - Ramp,10.24,53594526.84
02/03/2024,Expense,Canva,Harvey Spector,Tools & Subscription - G&A,119.99,53594646.83
02/03/2024,Expense,VirtualPostMail,Harvey Spector,Credit Card - Ramp,35,53594681.83
02/03/2024,Expense,Apple R254 Bondi,Mike ross,Office expenses:Office supplies,680.46,53595362.29
02/03/2024,Expense,Live The Dream Pty Ltd.,Balapavan Tirumani,Meals & Entertainment,4.2,53595366.49
02/03/2024,Expense,VirtualPostMail,Harvey Spector,General business expenses:Memberships & subscriptions,35,53595401.49
02/03/2024,Expense,Apple R254 Bondi,Mike ross,Credit Card - Ramp,680.46,53596081.95
02/03/2024,Expense,Bondi Mart Pty Ltd,Balapavan Tirumani,Meals & Entertainment,4.14,53596086.09
02/03/2024,Expense,Live The Dream Pty Ltd.,Balapavan Tirumani,Meals & Entertainment,4.2,53596090.29
02/03/2024,Expense,Apple R254 Bondi,Mike ross,Credit Card - Ramp,680.46,53596770.75
02/03/2024,Expense,Bondi Mart Pty Ltd,Balapavan Tirumani,Meals & Entertainment,4.14,53596774.89
02/03/2024,Expense,Apple R254 Bondi,Mike ross,Office expenses:Office supplies,680.46,53597455.35
02/03/2024,Expense,Bondi Trattoria,Balapavan Tirumani,Meals & Entertainment,23.23,53597478.58
02/03/2024,Expense,Canva,Harvey Spector,Tools & Subscription - G&A,119.99,53597598.57
02/03/2024,Expense,Bondi Trattoria,Balapavan Tirumani,Meals & Entertainment,23.23,53597621.8
02/03/2024,Expense,VirtualPostMail,Harvey Spector,Credit Card - Ramp,35,53597656.8
02/03/2024,Expense,Bondi Trattoria,Balapavan Tirumani,Credit Card - Ramp,23.23,53597680.03
02/03/2024,Expense,Bondi Mart Pty Ltd,Balapavan Tirumani,Meals & Entertainment,4.14,53597684.17
02/03/2024,Expense,Canva,Harvey Spector,Credit Card - Ramp,119.99,53597804.16
02/03/2024,Expense,Bondi Mart Pty Ltd,Balapavan Tirumani,Credit Card - Ramp,4.14,53597808.3
02/03/2024,Expense,Live The Dream Pty Ltd.,Balapavan Tirumani,Credit Card - Ramp,4.2,53597812.5
02/03/2024,Expense,Careem,Harvey Spector,Travelling Expenses,10.24,53597822.74
02/03/2024,Expense,Canva,Harvey Spector,Credit Card - Ramp,119.99,53597942.73
02/03/2024,Expense,VirtualPostMail,Harvey Spector,General business expenses:Memberships & subscriptions,35,53597977.73
02/03/2024,Expense,Bondi Trattoria,Balapavan Tirumani,Credit Card - Ramp,23.23,53598000.96
02/03/2024,Expense,Live The Dream Pty Ltd.,Balapavan Tirumani,Credit Card - Ramp,4.2,53598005.16
02/03/2024,Expense,Careem,Harvey Spector,Travelling Expenses,10.24,53598015.4
02/03/2024,Expense,Live The Dream Pty Ltd.,Balapavan Tirumani,Credit Card - Ramp,4.2,53598019.6
02/03/2024,Expense,Bondi Trattoria,Balapavan Tirumani,Credit Card - Ramp,23.23,53598042.83
02/03/2024,Expense,Bondi Mart Pty Ltd,Balapavan Tirumani,Credit Card - Ramp,4.14,53598046.97
02/03/2024,Expense,Canva,Harvey Spector,Credit Card - Ramp,119.99,53598166.96
02/03/2024,Expense,Apple R254 Bondi,Mike ross,Office expenses:Office supplies,680.46,53598847.42
02/03/2024,Expense,VirtualPostMail,Harvey Spector,Credit Card - Ramp,35,53598882.42
02/03/2024,Expense,VirtualPostMail,Harvey Spector,Credit Card - Ramp,35,53598917.42
02/03/2024,Expense,Careem,Harvey Spector,Credit Card - Ramp,10.24,53598927.66
02/03/2024,Expense,Bondi Trattoria,Balapavan Tirumani,Meals & Entertainment,23.23,53598950.89
02/03/2024,Expense,Live The Dream Pty Ltd.,Balapavan Tirumani,Credit Card - Ramp,4.2,53598955.09
02/03/2024,Expense,Canva,Harvey Spector,Tools & Subscription - G&A,119.99,53599075.08
02/03/2024,Expense,VirtualPostMail,Harvey Spector,General business expenses:Memberships & subscriptions,35,53599110.08
02/03/2024,Expense,Careem,Harvey Spector,Travelling Expenses,10.24,53599120.32
02/03/2024,Expense,Bondi Trattoria,Balapavan Tirumani,Credit Card - Ramp,23.23,53599143.55
02/03/2024,Expense,Bondi Mart Pty Ltd,Balapavan Tirumani,Credit Card - Ramp,4.14,53599147.69
02/03/2024,Expense,Careem,Harvey Spector,Credit Card - Ramp,10.24,53599157.93
02/03/2024,Expense,Live The Dream Pty Ltd.,Balapavan Tirumani,Meals & Entertainment,4.2,53599162.13
02/04/2024,Expense,Bondi Mart Pty Ltd,Balapavan Tirumani,Credit Card - Ramp,18.99,53599181.12
02/04/2024,Expense,Cleeng,Harvey Spector,Tools & Subscription - G&A,18,53599199.12
02/04/2024,Expense,Bondi Mart Pty Ltd,Balapavan Tirumani,Credit Card - Ramp,6.32,53599205.44
02/04/2024,Expense,Wake Up!,Balapavan Tirumani,Credit Card - Ramp,6.81,53599212.25
02/04/2024,Expense,Booking.com,Balapavan Tirumani,Credit Card - Ramp,276.47,53599488.72
02/04/2024,Expense,Zambrero,Balapavan Tirumani,Meals & Entertainment,12.2,53599500.92
02/04/2024,Expense,Wake Up!,Balapavan Tirumani,Travel:Hotels,6.81,53599507.73
02/04/2024,Expense,Bondi Mart Pty Ltd,Balapavan Tirumani,Meals & Entertainment,18.99,53599526.72
02/04/2024,Expense,Lemon Squeezy,Mike ross,Credit Card - Ramp,89,53599615.72
02/04/2024,Expense,Bondi Mart Pty Ltd,Balapavan Tirumani,Meals & Entertainment,6.32,53599622.04
02/04/2024,Expense,Lemon Squeezy,Mike ross,Tools & Subscription - G&A,89,53599711.04
02/04/2024,Expense,Noahpinion,Max Kausman,Tools & Subscription - S&M,5.45,53599716.49
02/04/2024,Expense,Linear,Chris Jerochim,Credit Card - Ramp,110,53599826.49
02/04/2024,Expense,Cleeng,Harvey Spector,Credit Card - Ramp,18,53599844.49
02/04/2024,Expense,Cleeng,Harvey Spector,Credit Card - Ramp,18,53599862.49
02/04/2024,Expense,Zambrero,Balapavan Tirumani,Credit Card - Ramp,12.2,53599874.69
02/04/2024,Expense,OpenAI,Mike ross,Tools & Subscription - G&A,20,53599894.69
02/04/2024,Expense,Linear,Chris Jerochim,Credit Card - Ramp,110,53600004.69
02/04/2024,Expense,Linear,Chris Jerochim,Tools & Subscription - G&A,110,53600114.69
02/04/2024,Expense,Linear,Chris Jerochim,Credit Card - Ramp,110,53600224.69
02/04/2024,Expense,Booking.com,Balapavan Tirumani,Credit Card - Ramp,276.47,53600501.16
02/04/2024,Expense,Splitbee,Harris Jose,Tools & Subscription - G&A,16.52,53600517.68
02/04/2024,Expense,Linear,Chris Jerochim,Tools & Subscription - G&A,110,53600627.68
02/04/2024,Expense,Booking.com,Balapavan Tirumani,Travelling Expenses,276.47,53600904.15
02/04/2024,Expense,Cleeng,Harvey Spector,Tools & Subscription - G&A,18,53600922.15
02/04/2024,Expense,Splitbee,Harris Jose,Credit Card - Ramp,16.52,53600938.67
02/04/2024,Expense,Splitbee,Harris Jose,Tools & Subscription - G&A,16.52,53600955.19
02/04/2024,Expense,Noahpinion,Max Kausman,Tools & Subscription - S&M,5.45,53600960.64
02/04/2024,Expense,Lemon Squeezy,Mike ross,Tools & Subscription - G&A,89,53601049.64
02/04/2024,Expense,Noahpinion,Max Kausman,Credit Card - Ramp,5.45,53601055.09
02/04/2024,Expense,Zambrero,Balapavan Tirumani,Credit Card - Ramp,12.2,53601067.29
02/04/2024,Expense,Bondi Mart Pty Ltd,Balapavan Tirumani,Meals & Entertainment,18.99,53601086.28
02/04/2024,Expense,Wake Up!,Balapavan Tirumani,Credit Card - Ramp,6.81,53601093.09
02/04/2024,Expense,Noahpinion,Max Kausman,Credit Card - Ramp,5.45,53601098.54
02/04/2024,Expense,Wake Up!,Balapavan Tirumani,Travel:Hotels,6.81,53601105.35
02/04/2024,Expense,Booking.com,Balapavan Tirumani,Credit Card - Ramp,276.47,53601381.82
02/04/2024,Expense,Zambrero,Balapavan Tirumani,Meals & Entertainment,12.2,53601394.02
02/04/2024,Expense,Lemon Squeezy,Mike ross,Credit Card - Ramp,89,53601483.02
02/04/2024,Expense,OpenAI,Mike ross,Credit Card - Ramp,20,53601503.02
02/04/2024,Expense,Booking.com,Balapavan Tirumani,Travelling Expenses,276.47,53601779.49
02/04/2024,Expense,Splitbee,Harris Jose,Credit Card - Ramp,16.52,53601796.01
02/04/2024,Expense,Bondi Mart Pty Ltd,Balapavan Tirumani,Meals & Entertainment,18.99,53601815
02/04/2024,Expense,Booking.com,Balapavan Tirumani,Travelling Expenses,276.47,53602091.47
02/04/2024,Expense,Linear,Chris Jerochim,Tools & Subscription - G&A,110,53602201.47
02/04/2024,Expense,Splitbee,Harris Jose,Tools & Subscription - G&A,16.52,53602217.99
02/04/2024,Expense,Lemon Squeezy,Mike ross,Tools & Subscription - G&A,89,53602306.99
02/04/2024,Expense,Bondi Mart Pty Ltd,Balapavan Tirumani,Meals & Entertainment,6.32,53602313.31
02/04/2024,Expense,OpenAI,Mike ross,Tools & Subscription - G&A,20,53602333.31
02/04/2024,Expense,Bondi Mart Pty Ltd,Balapavan Tirumani,Meals & Entertainment,6.32,53602339.63
02/04/2024,Expense,Bondi Mart Pty Ltd,Balapavan Tirumani,Credit Card - Ramp,18.99,53602358.62
02/04/2024,Expense,Wake Up!,Balapavan Tirumani,Travel:Hotels,6.81,53602365.43
02/04/2024,Expense,Zambrero,Balapavan Tirumani,Meals & Entertainment,12.2,53602377.63
02/04/2024,Expense,OpenAI,Mike ross,Tools & Subscription - G&A,20,53602397.63
02/04/2024,Expense,Linear,Chris Jerochim,Tools & Subscription - G&A,110,53602507.63
02/04/2024,Expense,Booking.com,Balapavan Tirumani,Travelling Expenses,276.47,53602784.1
02/04/2024,Expense,Bondi Mart Pty Ltd,Balapavan Tirumani,Meals & Entertainment,18.99,53602803.09
02/04/2024,Expense,Cleeng,Harvey Spector,Tools & Subscription - G&A,18,53602821.09
02/04/2024,Expense,Noahpinion,Max Kausman,Tools & Subscription - S&M,5.45,53602826.54
02/04/2024,Expense,Cleeng,Harvey Spector,Tools & Subscription - G&A,18,53602844.54
02/04/2024,Expense,Wake Up!,Balapavan Tirumani,Travel:Hotels,6.81,53602851.35
02/04/2024,Expense,Noahpinion,Max Kausman,Tools & Subscription - S&M,5.45,53602856.8
02/04/2024,Expense,Wake Up!,Balapavan Tirumani,Credit Card - Ramp,6.81,53602863.61
02/04/2024,Expense,OpenAI,Mike ross,Credit Card - Ramp,20,53602883.61
02/04/2024,Expense,OpenAI,Mike ross,Credit Card - Ramp,20,53602903.61
02/04/2024,Expense,Splitbee,Harris Jose,Credit Card - Ramp,16.52,53602920.13
02/04/2024,Expense,Zambrero,Balapavan Tirumani,Meals & Entertainment,12.2,53602932.33
02/04/2024,Expense,Splitbee,Harris Jose,Tools & Subscription - G&A,16.52,53602948.85
02/04/2024,Expense,Lemon Squeezy,Mike ross,Credit Card - Ramp,89,53603037.85
02/04/2024,Expense,Lemon Squeezy,Mike ross,Tools & Subscription - G&A,89,53603126.85
02/04/2024,Expense,Bondi Mart Pty Ltd,Balapavan Tirumani,Credit Card - Ramp,18.99,53603145.84
02/04/2024,Expense,OpenAI,Mike ross,Tools & Subscription - G&A,20,53603165.84
02/04/2024,Expense,Cleeng,Harvey Spector,Credit Card - Ramp,18,53603183.84
02/04/2024,Expense,Bondi Mart Pty Ltd,Balapavan Tirumani,Credit Card - Ramp,6.32,53603190.16
02/04/2024,Expense,Bondi Mart Pty Ltd,Balapavan Tirumani,Credit Card - Ramp,6.32,53603196.48
02/04/2024,Expense,Bondi Mart Pty Ltd,Balapavan Tirumani,Credit Card - Ramp,18.99,53603215.47
02/04/2024,Expense,Zambrero,Balapavan Tirumani,Credit Card - Ramp,12.2,53603227.67
02/04/2024,Expense,Zambrero,Balapavan Tirumani,Credit Card - Ramp,12.2,53603239.87
02/04/2024,Expense,Bondi Mart Pty Ltd,Balapavan Tirumani,Meals & Entertainment,6.32,53603246.19
02/04/2024,Expense,Bondi Mart Pty Ltd,Balapavan Tirumani,Credit Card - Ramp,6.32,53603252.51
02/04/2024,Expense,Noahpinion,Max Kausman,Credit Card - Ramp,5.45,53603257.96
02/05/2024,Expense,Rice Pot Thai Cuisine,Balapavan Tirumani,Credit Card - Ramp,17.91,53603275.87
02/05/2024,Expense,Rice Pot Thai Cuisine,Balapavan Tirumani,Credit Card - Ramp,17.91,53603293.78
02/05/2024,Expense,Zambrero,Balapavan Tirumani,Credit Card - Ramp,10.15,53603303.93
02/05/2024,Expense,Uber,Mike ross,Credit Card - Ramp,19.93,53603323.86
02/05/2024,Expense,Rice Pot Thai Cuisine,Balapavan Tirumani,Credit Card - Ramp,17.91,53603341.77
02/05/2024,Expense,Uber,Mike ross,Travelling Expenses,19.93,53603361.7
02/05/2024,Expense,Zambrero,Balapavan Tirumani,Meals & Entertainment,10.15,53603371.85
02/05/2024,Expense,Rice Pot Thai Cuisine,Balapavan Tirumani,Meals & Entertainment,17.91,53603389.76
02/05/2024,Expense,Zambrero,Balapavan Tirumani,Credit Card - Ramp,10.15,53603399.91
02/05/2024,Expense,Zambrero,Balapavan Tirumani,Credit Card - Ramp,10.15,53603410.06
02/05/2024,Expense,Rice Pot Thai Cuisine,Balapavan Tirumani,Credit Card - Ramp,17.91,53603427.97
02/05/2024,Expense,Uber,Mike ross,Credit Card - Ramp,19.93,53603447.9
02/05/2024,Bill Payment (Check),ANSR Dubai,,HSBC A/c,-3946,53599501.9
02/05/2024,Bill Payment (Check),ANSR Dubai,"BOOK TRANSFER DEBIT 45BOOK DEBIT CHRONICLEHQ INC.*BNF:ANSR (EMEA) GLOBAL SERVICES LIM ITED*OBI:/INV/ANSREMEA/074*BBI:/DAS/REF:53276SX0057J*STBOOK*TIME: 0510*YOUR REF:LAPTOP REIMBURSE*OUR REF:036221526
LAPTOP REIMBURSE",Accounts Payable (A/P),-3946,53595555.9
02/05/2024,Bill Payment (Check),ANSR Dubai,"BOOK TRANSFER DEBIT 45BOOK DEBIT CHRONICLEHQ INC.*BNF:ANSR (EMEA) GLOBAL SERVICES LIM ITED*OBI:/INV/ANSREMEA/074*BBI:/DAS/REF:53276SX0057J*STBOOK*TIME: 0510*YOUR REF:LAPTOP REIMBURSE*OUR REF:036221526
LAPTOP REIMBURSE",Accounts Payable (A/P),-3946,53591609.9
02/05/2024,Expense,Rice Pot Thai Cuisine,Balapavan Tirumani,Meals & Entertainment,17.91,53591627.81
02/05/2024,Bill Payment (Check),ANSR Dubai,"BOOK TRANSFER DEBIT 45BOOK DEBIT CHRONICLEHQ INC.*BNF:ANSR (EMEA) GLOBAL SERVICES LIM ITED*OBI:/INV/ANSREMEA/074*BBI:/DAS/REF:53276SX0057J*STBOOK*TIME: 0510*YOUR REF:LAPTOP REIMBURSE*OUR REF:036221526
LAPTOP REIMBURSE",Accounts Payable (A/P),-3946,53587681.81
02/05/2024,Expense,Zambrero,Balapavan Tirumani,Credit Card - Ramp,10.15,53587691.96
02/05/2024,Expense,Uber,Mike ross,Travelling Expenses,19.93,53587711.89
02/05/2024,Bill Payment (Check),ANSR Dubai,,HSBC A/c,-3946,53583765.89
02/05/2024,Bill Payment (Check),ANSR Dubai,,HSBC A/c,-3946,53579819.89
02/05/2024,Expense,Uber,Mike ross,Travelling Expenses,19.93,53579839.82
02/05/2024,Bill Payment (Check),ANSR Dubai,"BOOK TRANSFER DEBIT 45BOOK DEBIT CHRONICLEHQ INC.*BNF:ANSR (EMEA) GLOBAL SERVICES LIM ITED*OBI:/INV/ANSREMEA/074*BBI:/DAS/REF:53276SX0057J*STBOOK*TIME: 0510*YOUR REF:LAPTOP REIMBURSE*OUR REF:036221526
LAPTOP REIMBURSE",Accounts Payable (A/P),-3946,53575893.82
02/05/2024,Bill Payment (Check),ANSR Dubai,,HSBC A/c,-3946,53571947.82
02/05/2024,Expense,Zambrero,Balapavan Tirumani,Meals & Entertainment,10.15,53571957.97
02/05/2024,Expense,Zambrero,Balapavan Tirumani,Meals & Entertainment,10.15,53571968.12
02/05/2024,Expense,Zambrero,Balapavan Tirumani,Meals & Entertainment,10.15,53571978.27
02/05/2024,Expense,Rice Pot Thai Cuisine,Balapavan Tirumani,Meals & Entertainment,17.91,53571996.18
02/05/2024,Expense,Uber,Mike ross,Travelling Expenses,19.93,53572016.11
02/05/2024,Expense,Uber,Mike ross,Credit Card - Ramp,19.93,53572036.04
02/05/2024,Expense,Rice Pot Thai Cuisine,Balapavan Tirumani,Meals & Entertainment,17.91,53572053.95
02/06/2024,Expense,Le Paris-Go Cafe,Balapavan Tirumani,Meals & Entertainment,16.43,53572070.38
02/06/2024,Expense,Le Paris-Go Cafe,Balapavan Tirumani,Credit Card - Ramp,16.43,53572086.81
02/06/2024,Expense,OpenAI,Harvey Spector,Tools & Subscription - G&A,20,53572106.81
02/06/2024,Expense,OpenAI,Harvey Spector,Tools & Subscription - G&A,20,53572126.81
02/06/2024,Expense,E-Gov Services,Balapavan Tirumani,Professional Service Charges,57.15,53572183.96
02/06/2024,Expense,E-Gov Services,Balapavan Tirumani,Professional Service Charges,57.15,53572241.11
02/06/2024,Expense,E-Gov Services,Balapavan Tirumani,Professional Service Charges,57.15,53572298.26
02/06/2024,Expense,Bondi Mart Pty Ltd,Balapavan Tirumani,Meals & Entertainment,2.73,53572300.99
02/06/2024,Expense,Wake Up!,Balapavan Tirumani,Travel:Hotels,58.71,53572359.7
02/06/2024,Expense,Wake Up!,Balapavan Tirumani,Credit Card - Ramp,58.71,53572418.41
02/06/2024,Expense,E-Gov Services,Balapavan Tirumani,Credit Card - Ramp,57.15,53572475.56
02/06/2024,Expense,OpenAI,Harvey Spector,Tools & Subscription - G&A,20,53572495.56
02/06/2024,Expense,Le Paris-Go Cafe,Balapavan Tirumani,Meals & Entertainment,16.43,53572511.99
02/06/2024,Expense,E-Gov Services,Balapavan Tirumani,Credit Card - Ramp,57.15,53572569.14
02/06/2024,Expense,Bondi Mart Pty Ltd,Balapavan Tirumani,Meals & Entertainment,2.73,53572571.87
02/06/2024,Expense,Bondi Mart Pty Ltd,Balapavan Tirumani,Credit Card - Ramp,2.73,53572574.6
02/06/2024,Expense,Wake Up!,Balapavan Tirumani,Travel:Hotels,58.71,53572633.31
02/06/2024,Expense,Le Paris-Go Cafe,Balapavan Tirumani,Credit Card - Ramp,16.43,53572649.74
02/06/2024,Expense,Bondi Mart Pty Ltd,Balapavan Tirumani,Credit Card - Ramp,2.73,53572652.47
02/06/2024,Expense,Bondi Mart Pty Ltd,Balapavan Tirumani,Meals & Entertainment,2.73,53572655.2
02/06/2024,Expense,Bondi Mart Pty Ltd,Balapavan Tirumani,Credit Card - Ramp,2.73,53572657.93
02/06/2024,Expense,Le Paris-Go Cafe,Balapavan Tirumani,Meals & Entertainment,16.43,53572674.36
02/06/2024,Expense,E-Gov Services,Balapavan Tirumani,Professional Service Charges,57.15,53572731.51
02/06/2024,Expense,Wake Up!,Balapavan Tirumani,Credit Card - Ramp,58.71,53572790.22
02/06/2024,Expense,Wake Up!,Balapavan Tirumani,Travel:Hotels,58.71,53572848.93
02/06/2024,Expense,Le Paris-Go Cafe,Balapavan Tirumani,Credit Card - Ramp,16.43,53572865.36
02/06/2024,Expense,Le Paris-Go Cafe,Balapavan Tirumani,Meals & Entertainment,16.43,53572881.79
02/06/2024,Expense,Bondi Mart Pty Ltd,Balapavan Tirumani,Meals & Entertainment,2.73,53572884.52
02/06/2024,Expense,OpenAI,Harvey Spector,Tools & Subscription - G&A,20,53572904.52
02/06/2024,Expense,OpenAI,Harvey Spector,Credit Card - Ramp,20,53572924.52
02/06/2024,Expense,Le Paris-Go Cafe,Balapavan Tirumani,Credit Card - Ramp,16.43,53572940.95
02/06/2024,Expense,Bondi Mart Pty Ltd,Balapavan Tirumani,Credit Card - Ramp,2.73,53572943.68
02/06/2024,Expense,Wake Up!,Balapavan Tirumani,Credit Card - Ramp,58.71,53573002.39
02/06/2024,Expense,OpenAI,Harvey Spector,Credit Card - Ramp,20,53573022.39
02/06/2024,Expense,E-Gov Services,Balapavan Tirumani,Credit Card - Ramp,57.15,53573079.54
02/06/2024,Expense,OpenAI,Harvey Spector,Credit Card - Ramp,20,53573099.54
02/06/2024,Expense,Wake Up!,Balapavan Tirumani,Travel:Hotels,58.71,53573158.25
02/07/2024,Expense,Circumtec,Balapavan Tirumani,Professional Service Charges,3.22,53573161.47
02/07/2024,Expense,Circumtec,Balapavan Tirumani,Credit Card - Ramp,2.21,53573163.68
02/07/2024,Expense,Booking.com,Balapavan Tirumani,Travelling Expenses,365.77,53573529.45
02/07/2024,Expense,Supabase,Harris Jose,Tools & Subscription - G&A,35,53573564.45
02/07/2024,Expense,Surf & Souvenirs,Balapavan Tirumani,Tools & Subscription - G&A,13.64,53573578.09
02/07/2024,Expense,Surf & Souvenirs,Balapavan Tirumani,Tools & Subscription - G&A,13.64,53573591.73
02/07/2024,Expense,Booking.com,Balapavan Tirumani,Credit Card - Ramp,365.77,53573957.5
02/07/2024,Expense,Careem,Harvey Spector,Credit Card - Ramp,9.11,53573966.61
02/07/2024,Expense,Supabase,Harris Jose,Credit Card - Ramp,35,53574001.61
02/07/2024,Expense,Surf & Souvenirs,Balapavan Tirumani,Credit Card - Ramp,13.64,53574015.25
02/07/2024,Expense,Circumtec,Balapavan Tirumani,Credit Card - Ramp,3.22,53574018.47
02/07/2024,Expense,Grumpy's Pizza Pasta Bar,Balapavan Tirumani,Credit Card - Ramp,18.41,53574036.88
02/07/2024,Expense,Supabase,Harris Jose,Tools & Subscription - G&A,35,53574071.88
02/07/2024,Expense,Grumpy's Pizza Pasta Bar,Balapavan Tirumani,Meals & Entertainment,18.41,53574090.29
02/07/2024,Expense,Circumtec,Balapavan Tirumani,Professional Service Charges,2.21,53574092.5
02/07/2024,Expense,Careem,Harvey Spector,Travelling Expenses,9.11,53574101.61
02/07/2024,Expense,Grumpy's Pizza Pasta Bar,Balapavan Tirumani,Meals & Entertainment,18.41,53574120.02
02/07/2024,Expense,Surf & Souvenirs,Balapavan Tirumani,Tools & Subscription - G&A,13.64,53574133.66
02/07/2024,Expense,Circumtec,Balapavan Tirumani,Professional Service Charges,3.22,53574136.88
02/07/2024,Expense,Booking.com,Balapavan Tirumani,Travelling Expenses,365.77,53574502.65
02/07/2024,Expense,Supabase,Harris Jose,Tools & Subscription - G&A,35,53574537.65
02/07/2024,Expense,Circumtec,Balapavan Tirumani,Professional Service Charges,3.22,53574540.87
02/07/2024,Expense,Circumtec,Balapavan Tirumani,Credit Card - Ramp,3.22,53574544.09
02/07/2024,Expense,Careem,Harvey Spector,Travelling Expenses,9.11,53574553.2
02/07/2024,Expense,Circumtec,Balapavan Tirumani,Professional Service Charges,2.21,53574555.41
02/07/2024,Expense,Aussie Broadband,Mike ross,Tools & Subscription - G&A,86.74,53574642.15
02/07/2024,Expense,Aussie Broadband,Mike ross,Tools & Subscription - G&A,86.74,53574728.89
02/07/2024,Expense,Circumtec,Balapavan Tirumani,Credit Card - Ramp,2.21,53574731.1
02/07/2024,Expense,Aussie Broadband,Mike ross,Credit Card - Ramp,86.74,53574817.84
02/07/2024,Expense,Supabase,Harris Jose,Credit Card - Ramp,35,53574852.84
02/07/2024,Expense,Circumtec,Balapavan Tirumani,Credit Card - Ramp,3.22,53574856.06
02/07/2024,Expense,Aussie Broadband,Mike ross,Credit Card - Ramp,86.74,53574942.8
02/07/2024,Expense,Grumpy's Pizza Pasta Bar,Balapavan Tirumani,Credit Card - Ramp,18.41,53574961.21
02/07/2024,Expense,Circumtec,Balapavan Tirumani,Professional Service Charges,3.22,53574964.43
02/07/2024,Expense,Supabase,Harris Jose,Tools & Subscription - G&A,35,53574999.43
02/07/2024,Expense,Booking.com,Balapavan Tirumani,Travelling Expenses,365.77,53575365.2
02/07/2024,Expense,Aussie Broadband,Mike ross,Tools & Subscription - G&A,86.74,53575451.94
02/07/2024,Expense,Circumtec,Balapavan Tirumani,Professional Service Charges,2.21,53575454.15
02/07/2024,Expense,Careem,Harvey Spector,Travelling Expenses,9.11,53575463.26
02/07/2024,Expense,Grumpy's Pizza Pasta Bar,Balapavan Tirumani,Credit Card - Ramp,18.41,53575481.67
02/07/2024,Expense,Grumpy's Pizza Pasta Bar,Balapavan Tirumani,Meals & Entertainment,18.41,53575500.08
02/07/2024,Expense,Aussie Broadband,Mike ross,Tools & Subscription - G&A,86.74,53575586.82
02/07/2024,Expense,Grumpy's Pizza Pasta Bar,Balapavan Tirumani,Credit Card - Ramp,18.41,53575605.23
02/07/2024,Expense,Surf & Souvenirs,Balapavan Tirumani,Tools & Subscription - G&A,13.64,53575618.87
02/07/2024,Expense,Careem,Harvey Spector,Travelling Expenses,9.11,53575627.98
02/07/2024,Expense,Grumpy's Pizza Pasta Bar,Balapavan Tirumani,Meals & Entertainment,18.41,53575646.39
02/07/2024,Expense,Surf & Souvenirs,Balapavan Tirumani,Credit Card - Ramp,13.64,53575660.03
02/07/2024,Expense,Careem,Harvey Spector,Credit Card - Ramp,9.11,53575669.14
02/07/2024,Expense,Aussie Broadband,Mike ross,Credit Card - Ramp,86.74,53575755.88
02/07/2024,Expense,Supabase,Harris Jose,Credit Card - Ramp,35,53575790.88
02/07/2024,Expense,Booking.com,Balapavan Tirumani,Credit Card - Ramp,365.77,53576156.65
02/07/2024,Expense,Booking.com,Balapavan Tirumani,Credit Card - Ramp,365.77,53576522.42
02/07/2024,Expense,Circumtec,Balapavan Tirumani,Professional Service Charges,2.21,53576524.63
02/07/2024,Expense,Surf & Souvenirs,Balapavan Tirumani,Credit Card - Ramp,13.64,53576538.27
02/07/2024,Expense,Booking.com,Balapavan Tirumani,Travelling Expenses,365.77,53576904.04
02/07/2024,Expense,Careem,Harvey Spector,Credit Card - Ramp,9.11,53576913.15
02/07/2024,Expense,Circumtec,Balapavan Tirumani,Credit Card - Ramp,2.21,53576915.36
02/08/2024,Expense,Heroku,Balapavan Tirumani,Credit Card - Ramp,85,53577000.36
02/08/2024,Expense,Bondi Mart Pty Ltd,Balapavan Tirumani,Meals & Entertainment,3.08,53577003.44
02/08/2024,Expense,Bondi Mart Pty Ltd,Balapavan Tirumani,Meals & Entertainment,3.08,53577006.52
02/08/2024,Expense,Lamrock Cafe,Balapavan Tirumani,Meals & Entertainment,14.28,53577020.8
02/08/2024,Expense,Heroku,Balapavan Tirumani,Tools & Subscription - S&M,85,53577105.8
02/08/2024,Expense,Le Paris-Go Cafe,Balapavan Tirumani,Meals & Entertainment,13,53577118.8
02/08/2024,Expense,Bondi Mart Pty Ltd,Balapavan Tirumani,Meals & Entertainment,2.72,53577121.52
02/08/2024,Expense,Rice Pot Thai Cuisine,Balapavan Tirumani,Credit Card - Ramp,9.51,53577131.03
02/08/2024,Expense,Lamrock Cafe,Balapavan Tirumani,Credit Card - Ramp,14.97,53577146
02/08/2024,Expense,Lamrock Cafe,Balapavan Tirumani,Meals & Entertainment,14.28,53577160.28
02/08/2024,Expense,Bondi Mart Pty Ltd,Balapavan Tirumani,Credit Card - Ramp,3.08,53577163.36
02/08/2024,Expense,Rice Pot Thai Cuisine,Balapavan Tirumani,Meals & Entertainment,9.51,53577172.87
02/08/2024,Expense,Heroku,Balapavan Tirumani,Tools & Subscription - S&M,85,53577257.87
02/08/2024,Expense,Bondi Mart Pty Ltd,Balapavan Tirumani,Credit Card - Ramp,2.72,53577260.59
02/08/2024,Expense,Lamrock Cafe,Balapavan Tirumani,Meals & Entertainment,14.97,53577275.56
02/08/2024,Expense,Rice Pot Thai Cuisine,Balapavan Tirumani,Meals & Entertainment,9.51,53577285.07
02/08/2024,Expense,Bondi Mart Pty Ltd,Balapavan Tirumani,Meals & Entertainment,2.72,53577287.79
02/08/2024,Expense,Lamrock Cafe,Balapavan Tirumani,Credit Card - Ramp,14.28,53577302.07
02/08/2024,Expense,Le Paris-Go Cafe,Balapavan Tirumani,Meals & Entertainment,13,53577315.07
02/08/2024,Expense,Lamrock Cafe,Balapavan Tirumani,Credit Card - Ramp,14.97,53577330.04
02/08/2024,Expense,Lamrock Cafe,Balapavan Tirumani,Meals & Entertainment,14.97,53577345.01
02/08/2024,Expense,Lamrock Cafe,Balapavan Tirumani,Credit Card - Ramp,14.97,53577359.98
02/08/2024,Expense,Bondi Mart Pty Ltd,Balapavan Tirumani,Credit Card - Ramp,3.08,53577363.06
02/08/2024,Expense,Le Paris-Go Cafe,Balapavan Tirumani,Credit Card - Ramp,13,53577376.06
02/08/2024,Expense,Bondi Mart Pty Ltd,Balapavan Tirumani,Credit Card - Ramp,3.08,53577379.14
02/08/2024,Expense,Rice Pot Thai Cuisine,Balapavan Tirumani,Credit Card - Ramp,9.51,53577388.65
02/08/2024,Expense,Rice Pot Thai Cuisine,Balapavan Tirumani,Credit Card - Ramp,9.51,53577398.16
02/08/2024,Expense,Lamrock Cafe,Balapavan Tirumani,Credit Card - Ramp,14.97,53577413.13
02/08/2024,Expense,Lamrock Cafe,Balapavan Tirumani,Credit Card - Ramp,14.28,53577427.41
02/08/2024,Expense,Bondi Mart Pty Ltd,Balapavan Tirumani,Credit Card - Ramp,2.72,53577430.13
02/08/2024,Expense,Lamrock Cafe,Balapavan Tirumani,Credit Card - Ramp,14.28,53577444.41
02/08/2024,Expense,Bondi Mart Pty Ltd,Balapavan Tirumani,Credit Card - Ramp,3.08,53577447.49
02/08/2024,Expense,Heroku,Balapavan Tirumani,Credit Card - Ramp,85,53577532.49
02/08/2024,Expense,Rice Pot Thai Cuisine,Balapavan Tirumani,Credit Card - Ramp,9.51,53577542
02/08/2024,Expense,Le Paris-Go Cafe,Balapavan Tirumani,Credit Card - Ramp,13,53577555
02/08/2024,Expense,Bondi Mart Pty Ltd,Balapavan Tirumani,Meals & Entertainment,3.08,53577558.08
02/08/2024,Expense,Bondi Mart Pty Ltd,Balapavan Tirumani,Credit Card - Ramp,2.72,53577560.8
02/08/2024,Expense,Heroku,Balapavan Tirumani,Tools & Subscription - S&M,85,53577645.8
02/08/2024,Expense,Le Paris-Go Cafe,Balapavan Tirumani,Meals & Entertainment,13,53577658.8
02/08/2024,Expense,Bondi Mart Pty Ltd,Balapavan Tirumani,Meals & Entertainment,2.72,53577661.52
02/08/2024,Expense,Rice Pot Thai Cuisine,Balapavan Tirumani,Meals & Entertainment,9.51,53577671.03
02/08/2024,Expense,Lamrock Cafe,Balapavan Tirumani,Meals & Entertainment,14.28,53577685.31
02/08/2024,Expense,Lamrock Cafe,Balapavan Tirumani,Meals & Entertainment,14.28,53577699.59
02/08/2024,Expense,Bondi Mart Pty Ltd,Balapavan Tirumani,Meals & Entertainment,3.08,53577702.67
02/08/2024,Expense,Le Paris-Go Cafe,Balapavan Tirumani,Credit Card - Ramp,13,53577715.67
02/08/2024,Expense,Bondi Mart Pty Ltd,Balapavan Tirumani,Credit Card - Ramp,2.72,53577718.39
02/08/2024,Expense,Le Paris-Go Cafe,Balapavan Tirumani,Credit Card - Ramp,13,53577731.39
02/08/2024,Expense,Lamrock Cafe,Balapavan Tirumani,Credit Card - Ramp,14.28,53577745.67
02/08/2024,Expense,Heroku,Balapavan Tirumani,Credit Card - Ramp,85,53577830.67
02/08/2024,Expense,Lamrock Cafe,Balapavan Tirumani,Meals & Entertainment,14.97,53577845.64
02/08/2024,Expense,Rice Pot Thai Cuisine,Balapavan Tirumani,Meals & Entertainment,9.51,53577855.15
02/08/2024,Expense,Bondi Mart Pty Ltd,Balapavan Tirumani,Meals & Entertainment,2.72,53577857.87
02/08/2024,Expense,Le Paris-Go Cafe,Balapavan Tirumani,Meals & Entertainment,13,53577870.87
02/08/2024,Expense,Heroku,Balapavan Tirumani,Tools & Subscription - S&M,85,53577955.87
02/08/2024,Expense,Lamrock Cafe,Balapavan Tirumani,Meals & Entertainment,14.97,53577970.84
02/09/2024,Expense,Read.Cv,Max Kausman,Office expenses:Office supplies,99,53578069.84
02/09/2024,Expense,Circumtec,Balapavan Tirumani,Credit Card - Ramp,2.22,53578072.06
02/09/2024,Expense,Lamrock Cafe,Balapavan Tirumani,Credit Card - Ramp,11.19,53578083.25
02/09/2024,Expense,LottieFiles,Balapavan Tirumani,Tools & Subscription - G&A,239.88,53578323.13
02/09/2024,Expense,OpenAI,Balapavan Tirumani,Tools & Subscription - G&A,20,53578343.13
02/09/2024,Expense,LottieFiles,Balapavan Tirumani,Tools & Subscription - G&A,239.88,53578583.01
02/09/2024,Expense,Read.Cv,Max Kausman,Office expenses:Office supplies,99,53578682.01
02/09/2024,Expense,Surf & Souvenirs,Balapavan Tirumani,Tools & Subscription - G&A,17.11,53578699.12
02/09/2024,Expense,Usersnap,Harris Jose,Credit Card - Ramp,99,53578798.12
02/09/2024,Expense,Circumtec,Balapavan Tirumani,Professional Service Charges,2.22,53578800.34
02/09/2024,Expense,Surf & Souvenirs,Balapavan Tirumani,Credit Card - Ramp,17.11,53578817.45
02/09/2024,Expense,Circumtec,Balapavan Tirumani,Professional Service Charges,2.22,53578819.67
02/09/2024,Expense,Usersnap,Harris Jose,Tools & Subscription - G&A,99,53578918.67
02/09/2024,Expense,Surf & Souvenirs,Balapavan Tirumani,Tools & Subscription - G&A,17.11,53578935.78
02/09/2024,Expense,Lamrock Cafe,Balapavan Tirumani,Meals & Entertainment,11.19,53578946.97
02/09/2024,Expense,Usersnap,Harris Jose,Tools & Subscription - G&A,99,53579045.97
02/09/2024,Expense,OpenAI,Balapavan Tirumani,Tools & Subscription - G&A,20,53579065.97
02/09/2024,Expense,LottieFiles,Balapavan Tirumani,Tools & Subscription - G&A,239.88,53579305.85
02/09/2024,Expense,Circumtec,Balapavan Tirumani,Professional Service Charges,2.22,53579308.07
02/09/2024,Expense,Lamrock Cafe,Balapavan Tirumani,Credit Card - Ramp,11.19,53579319.26
02/09/2024,Expense,LottieFiles,Balapavan Tirumani,Credit Card - Ramp,239.88,53579559.14
02/09/2024,Expense,Read.Cv,Max Kausman,Credit Card - Ramp,99,53579658.14
02/09/2024,Expense,Circumtec,Balapavan Tirumani,Credit Card - Ramp,2.22,53579660.36
02/09/2024,Expense,Lamrock Cafe,Balapavan Tirumani,Meals & Entertainment,11.19,53579671.55
02/09/2024,Expense,OpenAI,Balapavan Tirumani,Credit Card - Ramp,20,53579691.55
02/09/2024,Expense,OpenAI,Balapavan Tirumani,Credit Card - Ramp,20,53579711.55
02/09/2024,Expense,Surf & Souvenirs,Balapavan Tirumani,Credit Card - Ramp,17.11,53579728.66
02/09/2024,Expense,OpenAI,Balapavan Tirumani,Tools & Subscription - G&A,20,53579748.66
02/09/2024,Expense,Usersnap,Harris Jose,Credit Card - Ramp,99,53579847.66
02/09/2024,Expense,OpenAI,Balapavan Tirumani,Tools & Subscription - G&A,20,53579867.66
02/09/2024,Expense,Circumtec,Balapavan Tirumani,Credit Card - Ramp,2.22,53579869.88
02/09/2024,Expense,OpenAI,Balapavan Tirumani,Credit Card - Ramp,20,53579889.88
02/09/2024,Expense,LottieFiles,Balapavan Tirumani,Credit Card - Ramp,239.88,53580129.76
02/09/2024,Expense,Read.Cv,Max Kausman,Credit Card - Ramp,99,53580228.76
02/09/2024,Expense,LottieFiles,Balapavan Tirumani,Credit Card - Ramp,239.88,53580468.64
02/09/2024,Expense,Lamrock Cafe,Balapavan Tirumani,Credit Card - Ramp,11.19,53580479.83
02/09/2024,Expense,Lamrock Cafe,Balapavan Tirumani,Credit Card - Ramp,11.19,53580491.02
02/09/2024,Expense,Usersnap,Harris Jose,Tools & Subscription - G&A,99,53580590.02
02/09/2024,Expense,Surf & Souvenirs,Balapavan Tirumani,Credit Card - Ramp,17.11,53580607.13
02/09/2024,Expense,Surf & Souvenirs,Balapavan Tirumani,Tools & Subscription - G&A,17.11,53580624.24
02/09/2024,Expense,Lamrock Cafe,Balapavan Tirumani,Meals & Entertainment,11.19,53580635.43
02/09/2024,Expense,Usersnap,Harris Jose,Credit Card - Ramp,99,53580734.43
02/09/2024,Expense,Read.Cv,Max Kausman,Credit Card - Ramp,99,53580833.43
02/09/2024,Expense,Circumtec,Balapavan Tirumani,Professional Service Charges,2.22,53580835.65
02/09/2024,Expense,LottieFiles,Balapavan Tirumani,Tools & Subscription - G&A,239.88,53581075.53
02/09/2024,Expense,Read.Cv,Max Kausman,Credit Card - Ramp,99,53581174.53
02/09/2024,Expense,Lamrock Cafe,Balapavan Tirumani,Meals & Entertainment,11.19,53581185.72
02/09/2024,Expense,Surf & Souvenirs,Balapavan Tirumani,Tools & Subscription - G&A,17.11,53581202.83
02/09/2024,Expense,Read.Cv,Max Kausman,Office expenses:Office supplies,99,53581301.83
02/09/2024,Expense,Read.Cv,Max Kausman,Office expenses:Office supplies,99,53581400.83
02/09/2024,Expense,Usersnap,Harris Jose,Tools & Subscription - G&A,99,53581499.83
02/10/2024,Expense,Careem,Harvey Spector,Credit Card - Ramp,10.24,53581510.07
02/10/2024,Expense,Careem,Harvey Spector,Credit Card - Ramp,10.24,53581520.31
02/10/2024,Expense,Le Paris-Go Cafe,Balapavan Tirumani,Credit Card - Ramp,28.98,53581549.29
02/10/2024,Expense,Grill'd,Balapavan Tirumani,Credit Card - Ramp,14.81,53581564.1
02/10/2024,Expense,Romeo's IGA Foodhall,Balapavan Tirumani,Credit Card - Ramp,1.74,53581565.84
02/10/2024,Expense,Grill'd,Balapavan Tirumani,Credit Card - Ramp,14.81,53581580.65
02/10/2024,Expense,Le Paris-Go Cafe,Balapavan Tirumani,Credit Card - Ramp,28.98,53581609.63
02/10/2024,Expense,Zoom,Max Kausman,Credit Card - Ramp,15.99,53581625.62
02/10/2024,Expense,Romeo's IGA Foodhall,Balapavan Tirumani,Credit Card - Ramp,1.74,53581627.36
02/10/2024,Expense,Pause Cafe,Harvey Spector,Credit Card - Ramp,12,53581639.36
02/10/2024,Expense,Pause Cafe,Harvey Spector,Credit Card - Ramp,12,53581651.36
02/10/2024,Expense,Zoom,Max Kausman,Tools & Subscription - G&A,15.99,53581667.35
02/10/2024,Expense,Grill'd,Balapavan Tirumani,Credit Card - Ramp,14.81,53581682.16
02/10/2024,Expense,Cars Taxi Services Co,Harvey Spector,Credit Card - Ramp,16.97,53581699.13
02/10/2024,Expense,Grill'd,Balapavan Tirumani,Credit Card - Ramp,14.81,53581713.94
02/10/2024,Expense,Le Paris-Go Cafe,Balapavan Tirumani,Credit Card - Ramp,28.98,53581742.92
02/10/2024,Expense,Le Paris-Go Cafe,Balapavan Tirumani,Meals & Entertainment,28.98,53581771.9
02/10/2024,Expense,Pause Cafe,Harvey Spector,Meals & Entertainment,12,53581783.9
02/10/2024,Expense,Careem,Harvey Spector,Travelling Expenses,10.24,53581794.14
02/10/2024,Expense,Pause Cafe,Harvey Spector,Credit Card - Ramp,12,53581806.14
02/10/2024,Expense,Romeo's IGA Foodhall,Balapavan Tirumani,Credit Card - Ramp,1.74,53581807.88
02/10/2024,Expense,Zoom,Max Kausman,Credit Card - Ramp,15.99,53581823.87
02/10/2024,Expense,Cars Taxi Services Co,Harvey Spector,Travelling Expenses,16.97,53581840.84
02/10/2024,Expense,Le Paris-Go Cafe,Balapavan Tirumani,Credit Card - Ramp,28.98,53581869.82
02/10/2024,Expense,Grill'd,Balapavan Tirumani,Meals & Entertainment,14.81,53581884.63
02/10/2024,Expense,Cars Taxi Services Co,Harvey Spector,Credit Card - Ramp,16.97,53581901.6
02/10/2024,Expense,Careem,Harvey Spector,Travelling Expenses,10.24,53581911.84
02/10/2024,Expense,Careem,Harvey Spector,Travelling Expenses,10.24,53581922.08
02/10/2024,Expense,Zoom,Max Kausman,Credit Card - Ramp,15.99,53581938.07
02/10/2024,Expense,Cars Taxi Services Co,Harvey Spector,Credit Card - Ramp,16.97,53581955.04
02/10/2024,Expense,Cars Taxi Services Co,Harvey Spector,Travelling Expenses,16.97,53581972.01
02/10/2024,Expense,Pause Cafe,Harvey Spector,Meals & Entertainment,12,53581984.01
02/10/2024,Expense,Grill'd,Balapavan Tirumani,Meals & Entertainment,14.81,53581998.82
02/10/2024,Expense,Romeo's IGA Foodhall,Balapavan Tirumani,Meals & Entertainment,1.74,53582000.56
02/10/2024,Expense,Le Paris-Go Cafe,Balapavan Tirumani,Meals & Entertainment,28.98,53582029.54
02/10/2024,Expense,Le Paris-Go Cafe,Balapavan Tirumani,Meals & Entertainment,28.98,53582058.52
02/10/2024,Expense,Romeo's IGA Foodhall,Balapavan Tirumani,Meals & Entertainment,1.74,53582060.26
02/10/2024,Expense,Grill'd,Balapavan Tirumani,Meals & Entertainment,14.81,53582075.07
02/10/2024,Expense,Zoom,Max Kausman,Tools & Subscription - G&A,15.99,53582091.06
02/10/2024,Expense,Cars Taxi Services Co,Harvey Spector,Travelling Expenses,16.97,53582108.03
02/10/2024,Expense,Pause Cafe,Harvey Spector,Meals & Entertainment,12,53582120.03
02/10/2024,Expense,Zoom,Max Kausman,Tools & Subscription - G&A,15.99,53582136.02
02/10/2024,Expense,Cars Taxi Services Co,Harvey Spector,Travelling Expenses,16.97,53582152.99
02/10/2024,Expense,Careem,Harvey Spector,Travelling Expenses,10.24,53582163.23
02/10/2024,Expense,Pause Cafe,Harvey Spector,Meals & Entertainment,12,53582175.23
02/10/2024,Expense,Romeo's IGA Foodhall,Balapavan Tirumani,Meals & Entertainment,1.74,53582176.97
02/10/2024,Expense,Grill'd,Balapavan Tirumani,Meals & Entertainment,14.81,53582191.78
02/10/2024,Expense,Le Paris-Go Cafe,Balapavan Tirumani,Meals & Entertainment,28.98,53582220.76
02/10/2024,Expense,Romeo's IGA Foodhall,Balapavan Tirumani,Credit Card - Ramp,1.74,53582222.5
02/10/2024,Expense,Pause Cafe,Harvey Spector,Credit Card - Ramp,12,53582234.5
02/10/2024,Expense,Romeo's IGA Foodhall,Balapavan Tirumani,Meals & Entertainment,1.74,53582236.24
02/10/2024,Expense,Careem,Harvey Spector,Credit Card - Ramp,10.24,53582246.48
02/10/2024,Expense,Zoom,Max Kausman,Tools & Subscription - G&A,15.99,53582262.47
02/11/2024,Expense,Spitz Kebab,Balapavan Tirumani,Meals & Entertainment,2.4,53582264.87
02/11/2024,Expense,Romeo's IGA Foodhall,Balapavan Tirumani,Meals & Entertainment,5.2,53582270.07
02/11/2024,Expense,Uber,Mike ross,Travelling Expenses,14.42,53582284.49
02/11/2024,Expense,Spitz Kebab,Balapavan Tirumani,Credit Card - Ramp,2.4,53582286.89
02/11/2024,Expense,Spitz Kebab,Balapavan Tirumani,Credit Card - Ramp,8.9,53582295.79
02/11/2024,Expense,Romeo's IGA Foodhall,Balapavan Tirumani,Credit Card - Ramp,5.2,53582300.99
02/11/2024,Expense,Le Paris-Go Cafe,Balapavan Tirumani,Credit Card - Ramp,20.7,53582321.69
02/11/2024,Expense,Spitz Kebab,Balapavan Tirumani,Meals & Entertainment,8.9,53582330.59
02/11/2024,Expense,Careem,Harvey Spector,Travelling Expenses,14.86,53582345.45
02/11/2024,Expense,Uber,Mike ross,Travelling Expenses,14.42,53582359.87
02/11/2024,Expense,Spitz Kebab,Balapavan Tirumani,Meals & Entertainment,2.4,53582362.27
02/11/2024,Expense,Careem,Harvey Spector,Travelling Expenses,14.86,53582377.13
02/11/2024,Expense,Spitz Kebab,Balapavan Tirumani,Meals & Entertainment,8.9,53582386.03
02/11/2024,Expense,Spitz Kebab,Balapavan Tirumani,Meals & Entertainment,2.4,53582388.43
02/11/2024,Expense,Romeo's IGA Foodhall,Balapavan Tirumani,Meals & Entertainment,5.2,53582393.63
02/11/2024,Expense,Le Paris-Go Cafe,Balapavan Tirumani,Meals & Entertainment,20.7,53582414.33
02/11/2024,Expense,Careem,Harvey Spector,Travelling Expenses,14.86,53582429.19
02/11/2024,Expense,Spitz Kebab,Balapavan Tirumani,Meals & Entertainment,2.4,53582431.59
02/11/2024,Expense,Romeo's IGA Foodhall,Balapavan Tirumani,Meals & Entertainment,5.2,53582436.79
02/11/2024,Expense,Uber,Mike ross,Travelling Expenses,14.42,53582451.21
02/11/2024,Expense,Le Paris-Go Cafe,Balapavan Tirumani,Meals & Entertainment,20.7,53582471.91
02/11/2024,Expense,Le Paris-Go Cafe,Balapavan Tirumani,Meals & Entertainment,20.7,53582492.61
02/11/2024,Expense,Spitz Kebab,Balapavan Tirumani,Meals & Entertainment,8.9,53582501.51
02/11/2024,Expense,Le Paris-Go Cafe,Balapavan Tirumani,Credit Card - Ramp,20.7,53582522.21
02/11/2024,Expense,Le Paris-Go Cafe,Balapavan Tirumani,Meals & Entertainment,20.7,53582542.91
02/11/2024,Expense,Careem,Harvey Spector,Travelling Expenses,14.86,53582557.77
02/11/2024,Expense,Careem,Harvey Spector,Credit Card - Ramp,14.86,53582572.63
02/11/2024,Expense,Romeo's IGA Foodhall,Balapavan Tirumani,Credit Card - Ramp,5.2,53582577.83
02/11/2024,Expense,Uber,Mike ross,Credit Card - Ramp,14.42,53582592.25
02/11/2024,Expense,Spitz Kebab,Balapavan Tirumani,Credit Card - Ramp,8.9,53582601.15
02/11/2024,Expense,Romeo's IGA Foodhall,Balapavan Tirumani,Credit Card - Ramp,5.2,53582606.35
02/11/2024,Expense,Spitz Kebab,Balapavan Tirumani,Credit Card - Ramp,8.9,53582615.25
02/11/2024,Expense,Spitz Kebab,Balapavan Tirumani,Credit Card - Ramp,2.4,53582617.65
02/11/2024,Expense,Careem,Harvey Spector,Credit Card - Ramp,14.86,53582632.51
02/11/2024,Expense,Uber,Mike ross,Credit Card - Ramp,14.42,53582646.93
02/11/2024,Expense,Le Paris-Go Cafe,Balapavan Tirumani,Credit Card - Ramp,20.7,53582667.63
02/11/2024,Expense,Spitz Kebab,Balapavan Tirumani,Credit Card - Ramp,2.4,53582670.03
02/11/2024,Expense,Le Paris-Go Cafe,Balapavan Tirumani,Credit Card - Ramp,20.7,53582690.73
02/11/2024,Expense,Romeo's IGA Foodhall,Balapavan Tirumani,Credit Card - Ramp,5.2,53582695.93
02/11/2024,Expense,Spitz Kebab,Balapavan Tirumani,Credit Card - Ramp,2.4,53582698.33
02/11/2024,Expense,Uber,Mike ross,Credit Card - Ramp,14.42,53582712.75
02/11/2024,Expense,Spitz Kebab,Balapavan Tirumani,Credit Card - Ramp,8.9,53582721.65
02/11/2024,Expense,Romeo's IGA Foodhall,Balapavan Tirumani,Meals & Entertainment,5.2,53582726.85
02/11/2024,Expense,Careem,Harvey Spector,Credit Card - Ramp,14.86,53582741.71
02/11/2024,Expense,Spitz Kebab,Balapavan Tirumani,Meals & Entertainment,8.9,53582750.61
02/11/2024,Expense,Uber,Mike ross,Travelling Expenses,14.42,53582765.03
02/12/2024,Expense,WordPress,Harris Jose,Tools & Subscription - G&A,15.65,53582780.68
02/12/2024,Expense,WordPress,Harris Jose,Credit Card - Ramp,15.65,53582796.33
02/12/2024,Expense,OpenAI,Max Kausman,Credit Card - Ramp,20,53582816.33
02/12/2024,Expense,Adobe,Chris George,Credit Card - Ramp,20.99,53582837.32
02/12/2024,Expense,Uber Eats,Balapavan Tirumani,Credit Card - Ramp,15.47,53582852.79
02/12/2024,Expense,Airbnb,Mike ross,Travel:Hotels,3189.27,53586042.06
02/12/2024,Expense,Uber Eats,Balapavan Tirumani,Meals & Entertainment,15.47,53586057.53
02/12/2024,Expense,Uber Eats,Balapavan Tirumani,Credit Card - Ramp,15.47,53586073
02/12/2024,Expense,OpenAI,Max Kausman,Tools & Subscription - G&A,20,53586093
02/12/2024,Expense,Airbnb,Mike ross,Credit Card - Ramp,3189.27,53589282.27
02/12/2024,Expense,Airbnb,Mike ross,Credit Card - Ramp,3189.27,53592471.54
02/12/2024,Expense,Adobe,Chris George,Credit Card - Ramp,20.99,53592492.53
02/12/2024,Expense,OpenAI,Max Kausman,Credit Card - Ramp,20,53592512.53
02/12/2024,Expense,WordPress,Harris Jose,Credit Card - Ramp,15.65,53592528.18
02/12/2024,Expense,Airbnb,Mike ross,Travel:Hotels,3189.27,53595717.45
02/12/2024,Expense,Adobe,Chris George,Tools & Subscription - S&M,20.99,53595738.44
02/12/2024,Expense,Airbnb,Mike ross,Credit Card - Ramp,3189.27,53598927.71
02/12/2024,Expense,WordPress,Harris Jose,Tools & Subscription - G&A,15.65,53598943.36
02/12/2024,Expense,Adobe,Chris George,Tools & Subscription - S&M,20.99,53598964.35
02/12/2024,Expense,Adobe,Chris George,Credit Card - Ramp,20.99,53598985.34
02/12/2024,Expense,OpenAI,Max Kausman,Tools & Subscription - G&A,20,53599005.34
02/12/2024,Expense,Adobe,Chris George,Tools & Subscription - S&M,20.99,53599026.33
02/12/2024,Expense,Uber Eats,Balapavan Tirumani,Meals & Entertainment,15.47,53599041.8
02/12/2024,Expense,OpenAI,Max Kausman,Tools & Subscription - G&A,20,53599061.8
02/12/2024,Expense,Uber Eats,Balapavan Tirumani,Credit Card - Ramp,15.47,53599077.27
02/12/2024,Expense,OpenAI,Max Kausman,Tools & Subscription - G&A,20,53599097.27
02/12/2024,Expense,Adobe,Chris George,Tools & Subscription - S&M,20.99,53599118.26
02/12/2024,Expense,Airbnb,Mike ross,Travel:Hotels,3189.27,53602307.53
02/12/2024,Expense,Airbnb,Mike ross,Travel:Hotels,3189.27,53605496.8
02/12/2024,Expense,WordPress,Harris Jose,Tools & Subscription - G&A,15.65,53605512.45
02/12/2024,Expense,WordPress,Harris Jose,Tools & Subscription - G&A,15.65,53605528.1
02/12/2024,Expense,OpenAI,Max Kausman,Credit Card - Ramp,20,53605548.1
02/12/2024,Expense,WordPress,Harris Jose,Credit Card - Ramp,15.65,53605563.75
02/12/2024,Expense,Uber Eats,Balapavan Tirumani,Credit Card - Ramp,15.47,53605579.22
02/12/2024,Expense,Uber Eats,Balapavan Tirumani,Meals & Entertainment,15.47,53605594.69
02/12/2024,Expense,Uber Eats,Balapavan Tirumani,Meals & Entertainment,15.47,53605610.16
02/13/2024,Expense,Zambrero,Balapavan Tirumani,Credit Card - Ramp,9.37,53605619.53
02/13/2024,Expense,Figma,Mike ross,Tools & Subscription - G&A,130,53605749.53
02/13/2024,Expense,Zambrero,Balapavan Tirumani,Meals & Entertainment,9.37,53605758.9
02/13/2024,Expense,Vercel,Balapavan Tirumani,Credit Card - Ramp,240,53605998.9
02/13/2024,Expense,Playa Betty's,Balapavan Tirumani,Meals & Entertainment,0.67,53605999.57
02/13/2024,Expense,Bondi Mart Pty Ltd,Balapavan Tirumani,Meals & Entertainment,1.36,53606000.93
02/13/2024,Expense,Playa Betty's,Balapavan Tirumani,Meals & Entertainment,0.67,53606001.6
02/13/2024,Expense,Zambrero,Balapavan Tirumani,Meals & Entertainment,9.37,53606010.97
02/13/2024,Expense,Lenny Rachitsky,Max Kausman,General business expenses:Memberships & subscriptions,15,53606025.97
02/13/2024,Expense,Calendly,Harvey Spector,Tools & Subscription - G&A,48,53606073.97
02/13/2024,Expense,Playa Betty's,Balapavan Tirumani,Meals & Entertainment,0.67,53606074.64
02/13/2024,Expense,Bondi Mart Pty Ltd,Balapavan Tirumani,Meals & Entertainment,1.36,53606076
02/13/2024,Expense,Vercel,Balapavan Tirumani,Tools & Subscription - G&A,240,53606316
02/13/2024,Expense,Romeo's IGA Foodhall,Balapavan Tirumani,Meals & Entertainment,33.71,53606349.71
02/13/2024,Expense,Playa Betty's,Balapavan Tirumani,Meals & Entertainment,11.12,53606360.83
02/13/2024,Expense,Playa Betty's,Balapavan Tirumani,Credit Card - Ramp,11.12,53606371.95
02/13/2024,Expense,Playa Betty's,Balapavan Tirumani,Meals & Entertainment,11.12,53606383.07
02/13/2024,Expense,Figma,Mike ross,Credit Card - Ramp,130,53606513.07
02/13/2024,Expense,Romeo's IGA Foodhall,Balapavan Tirumani,Credit Card - Ramp,33.71,53606546.78
02/13/2024,Expense,Playa Betty's,Balapavan Tirumani,Credit Card - Ramp,11.12,53606557.9
02/13/2024,Expense,Vercel,Balapavan Tirumani,Tools & Subscription - G&A,240,53606797.9
02/13/2024,Expense,Coursera,Balapavan Tirumani,Credit Card - Ramp,49.22,53606847.12
02/13/2024,Expense,Playa Betty's,Balapavan Tirumani,Credit Card - Ramp,11.12,53606858.24
02/13/2024,Expense,Bondi Mart Pty Ltd,Balapavan Tirumani,Credit Card - Ramp,1.36,53606859.6
02/13/2024,Expense,Romeo's IGA Foodhall,Balapavan Tirumani,Credit Card - Ramp,33.71,53606893.31
02/13/2024,Expense,Zambrero,Balapavan Tirumani,Credit Card - Ramp,9.37,53606902.68
02/13/2024,Expense,Playa Betty's,Balapavan Tirumani,Credit Card - Ramp,0.67,53606903.35
02/13/2024,Expense,Playa Betty's,Balapavan Tirumani,Credit Card - Ramp,0.67,53606904.02
02/13/2024,Expense,Playa Betty's,Balapavan Tirumani,Credit Card - Ramp,0.67,53606904.69
02/13/2024,Expense,Bondi Mart Pty Ltd,Balapavan Tirumani,Credit Card - Ramp,1.36,53606906.05
02/13/2024,Expense,Bondi Mart Pty Ltd,Balapavan Tirumani,Credit Card - Ramp,1.36,53606907.41
02/13/2024,Expense,Lenny Rachitsky,Max Kausman,Credit Card - Ramp,15,53606922.41
02/13/2024,Expense,Romeo's IGA Foodhall,Balapavan Tirumani,Credit Card - Ramp,33.71,53606956.12
02/13/2024,Expense,Vercel,Balapavan Tirumani,Credit Card - Ramp,240,53607196.12
02/13/2024,Expense,Calendly,Harvey Spector,Credit Card - Ramp,48,53607244.12
02/13/2024,Expense,Coursera,Balapavan Tirumani,Credit Card - Ramp,49.22,53607293.34
02/13/2024,Expense,Zambrero,Balapavan Tirumani,Credit Card - Ramp,9.37,53607302.71
02/13/2024,Expense,Figma,Mike ross,Tools & Subscription - G&A,130,53607432.71
02/13/2024,Expense,Coursera,Balapavan Tirumani,General business expenses:Continuing education,49.22,53607481.93
02/13/2024,Expense,Lenny Rachitsky,Max Kausman,Credit Card - Ramp,15,53607496.93
02/13/2024,Expense,Coursera,Balapavan Tirumani,Credit Card - Ramp,49.22,53607546.15
02/13/2024,Expense,Lenny Rachitsky,Max Kausman,Credit Card - Ramp,15,53607561.15
02/13/2024,Expense,Figma,Mike ross,Tools & Subscription - G&A,130,53607691.15
02/13/2024,Expense,Figma,Mike ross,Credit Card - Ramp,130,53607821.15
02/13/2024,Expense,Romeo's IGA Foodhall,Balapavan Tirumani,Meals & Entertainment,33.71,53607854.86
02/13/2024,Expense,Lenny Rachitsky,Max Kausman,Credit Card - Ramp,15,53607869.86
02/13/2024,Expense,Zambrero,Balapavan Tirumani,Meals & Entertainment,9.37,53607879.23
02/13/2024,Expense,Calendly,Harvey Spector,Tools & Subscription - G&A,48,53607927.23
02/13/2024,Expense,Playa Betty's,Balapavan Tirumani,Meals & Entertainment,11.12,53607938.35
02/13/2024,Expense,Bondi Mart Pty Ltd,Balapavan Tirumani,Meals & Entertainment,1.36,53607939.71
02/13/2024,Expense,Vercel,Balapavan Tirumani,Credit Card - Ramp,240,53608179.71
02/13/2024,Expense,Romeo's IGA Foodhall,Balapavan Tirumani,Meals & Entertainment,33.71,53608213.42
02/13/2024,Expense,Coursera,Balapavan Tirumani,General business expenses:Continuing education,49.22,53608262.64
02/13/2024,Expense,Vercel,Balapavan Tirumani,Tools & Subscription - G&A,240,53608502.64
02/13/2024,Expense,Lenny Rachitsky,Max Kausman,General business expenses:Memberships & subscriptions,15,53608517.64
02/13/2024,Expense,Calendly,Harvey Spector,Tools & Subscription - G&A,48,53608565.64
02/13/2024,Expense,Romeo's IGA Foodhall,Balapavan Tirumani,Meals & Entertainment,33.71,53608599.35
02/13/2024,Expense,Bondi Mart Pty Ltd,Balapavan Tirumani,Credit Card - Ramp,1.36,53608600.71
02/13/2024,Expense,Lenny Rachitsky,Max Kausman,General business expenses:Memberships & subscriptions,15,53608615.71
02/13/2024,Expense,Calendly,Harvey Spector,Credit Card - Ramp,48,53608663.71
02/13/2024,Expense,Romeo's IGA Foodhall,Balapavan Tirumani,Credit Card - Ramp,33.71,53608697.42
02/13/2024,Expense,Calendly,Harvey Spector,Tools & Subscription - G&A,48,53608745.42
02/13/2024,Expense,Zambrero,Balapavan Tirumani,Meals & Entertainment,9.37,53608754.79
02/13/2024,Expense,Playa Betty's,Balapavan Tirumani,Meals & Entertainment,11.12,53608765.91
02/13/2024,Expense,Coursera,Balapavan Tirumani,Credit Card - Ramp,49.22,53608815.13
02/13/2024,Expense,Bondi Mart Pty Ltd,Balapavan Tirumani,Meals & Entertainment,1.36,53608816.49
02/13/2024,Expense,Coursera,Balapavan Tirumani,General business expenses:Continuing education,49.22,53608865.71
02/13/2024,Expense,Playa Betty's,Balapavan Tirumani,Meals & Entertainment,0.67,53608866.38
02/13/2024,Expense,Figma,Mike ross,Tools & Subscription - G&A,130,53608996.38
02/13/2024,Expense,Coursera,Balapavan Tirumani,General business expenses:Continuing education,49.22,53609045.6
02/13/2024,Expense,Vercel,Balapavan Tirumani,Tools & Subscription - G&A,240,53609285.6
02/13/2024,Expense,Calendly,Harvey Spector,Credit Card - Ramp,48,53609333.6
02/13/2024,Expense,Playa Betty's,Balapavan Tirumani,Credit Card - Ramp,11.12,53609344.72
02/13/2024,Expense,Zambrero,Balapavan Tirumani,Credit Card - Ramp,9.37,53609354.09
02/13/2024,Expense,Playa Betty's,Balapavan Tirumani,Credit Card - Ramp,0.67,53609354.76
02/13/2024,Expense,Lenny Rachitsky,Max Kausman,General business expenses:Memberships & subscriptions,15,53609369.76
02/13/2024,Expense,Figma,Mike ross,Credit Card - Ramp,130,53609499.76
02/14/2024,Expense,Qantas,Chris George,Credit Card - Ramp,356.29,53609856.05
02/14/2024,Expense,Careem,Harvey Spector,Credit Card - Ramp,11.44,53609867.49
02/14/2024,Expense,Rentalcars.Com,Chris George,Credit Card - Ramp,146.06,53610013.55
02/14/2024,Expense,Bondi Mart Pty Ltd,Balapavan Tirumani,Credit Card - Ramp,8.54,53610022.09
02/14/2024,Expense,Rentalcars.Com,Chris George,Credit Card - Ramp,146.06,53610168.15
02/14/2024,Expense,Bondi Mart Pty Ltd,Balapavan Tirumani,Meals & Entertainment,8.54,53610176.69
02/14/2024,Expense,Rentalcars.Com,Chris George,Credit Card - Ramp,146.06,53610322.75
02/14/2024,Expense,Bondi Mart Pty Ltd,Balapavan Tirumani,Credit Card - Ramp,8.54,53610331.29
02/14/2024,Expense,Zambrero,Balapavan Tirumani,Credit Card - Ramp,9.36,53610340.65
02/14/2024,Expense,Bondi Mart Pty Ltd,Balapavan Tirumani,Credit Card - Ramp,8.54,53610349.19
02/14/2024,Expense,Rentalcars.Com,Chris George,Travelling Expenses,146.06,53610495.25
02/14/2024,Expense,Grumpy's Pizza Pasta Bar,Balapavan Tirumani,Credit Card - Ramp,13.32,53610508.57
02/14/2024,Expense,Bondi Mart Pty Ltd,Balapavan Tirumani,Meals & Entertainment,8.54,53610517.11
02/14/2024,Expense,Qantas,Chris George,Travel:Airfare,356.29,53610873.4
02/14/2024,Expense,Grumpy's Pizza Pasta Bar,Balapavan Tirumani,Credit Card - Ramp,13.32,53610886.72
02/14/2024,Expense,Wake Up!,Balapavan Tirumani,Credit Card - Ramp,3.37,53610890.09
02/14/2024,Expense,Mx2Games,Anik Das,Tools & Subscription - G&A,613.41,53611503.5
02/14/2024,Expense,Zambrero,Balapavan Tirumani,Meals & Entertainment,9.36,53611512.86
02/14/2024,Expense,Careem,Harvey Spector,Credit Card - Ramp,11.44,53611524.3
02/14/2024,Expense,Wake Up!,Balapavan Tirumani,Credit Card - Ramp,3.37,53611527.67
02/14/2024,Expense,Bondi Mart Pty Ltd,Balapavan Tirumani,Meals & Entertainment,8.54,53611536.21
02/14/2024,Expense,Zambrero,Balapavan Tirumani,Meals & Entertainment,9.36,53611545.57
02/14/2024,Expense,Zambrero,Balapavan Tirumani,Credit Card - Ramp,9.36,53611554.93
02/14/2024,Expense,Zambrero,Balapavan Tirumani,Credit Card - Ramp,9.36,53611564.29
02/14/2024,Expense,Careem,Harvey Spector,Travelling Expenses,11.44,53611575.73
02/14/2024,Expense,Calendly,Harvey Spector,Credit Card - Ramp,11.68,53611587.41
02/14/2024,Expense,Grumpy's Pizza Pasta Bar,Balapavan Tirumani,Meals & Entertainment,13.32,53611600.73
02/14/2024,Expense,Grumpy's Pizza Pasta Bar,Balapavan Tirumani,Credit Card - Ramp,13.32,53611614.05
02/14/2024,Expense,Zambrero,Balapavan Tirumani,Credit Card - Ramp,9.36,53611623.41
02/14/2024,Expense,Bondi Mart Pty Ltd,Balapavan Tirumani,Credit Card - Ramp,8.54,53611631.95
02/14/2024,Expense,Qantas,Chris George,Travel:Airfare,356.29,53611988.24
02/14/2024,Expense,Mx2Games,Anik Das,Credit Card - Ramp,613.41,53612601.65
02/14/2024,Expense,Calendly,Harvey Spector,Tools & Subscription - G&A,11.68,53612613.33
02/14/2024,Expense,Careem,Harvey Spector,Travelling Expenses,11.44,53612624.77
02/14/2024,Expense,Calendly,Harvey Spector,Credit Card - Ramp,11.68,53612636.45
02/14/2024,Expense,Wake Up!,Balapavan Tirumani,Travel:Hotels,3.37,53612639.82
02/14/2024,Expense,Grumpy's Pizza Pasta Bar,Balapavan Tirumani,Credit Card - Ramp,13.32,53612653.14
02/14/2024,Expense,Rentalcars.Com,Chris George,Travelling Expenses,146.06,53612799.2
02/14/2024,Expense,Wake Up!,Balapavan Tirumani,Credit Card - Ramp,3.37,53612802.57
02/14/2024,Expense,Mx2Games,Anik Das,Tools & Subscription - G&A,613.41,53613415.98
02/14/2024,Expense,Zambrero,Balapavan Tirumani,Meals & Entertainment,9.36,53613425.34
02/14/2024,Expense,Wake Up!,Balapavan Tirumani,Travel:Hotels,3.37,53613428.71
02/14/2024,Expense,Careem,Harvey Spector,Travelling Expenses,11.44,53613440.15
02/14/2024,Expense,Calendly,Harvey Spector,Tools & Subscription - G&A,11.68,53613451.83
02/14/2024,Expense,Zambrero,Balapavan Tirumani,Meals & Entertainment,9.36,53613461.19
02/14/2024,Expense,Bondi Mart Pty Ltd,Balapavan Tirumani,Meals & Entertainment,8.54,53613469.73
02/14/2024,Expense,Rentalcars.Com,Chris George,Travelling Expenses,146.06,53613615.79
02/14/2024,Expense,Wake Up!,Balapavan Tirumani,Travel:Hotels,3.37,53613619.16
02/14/2024,Expense,Grumpy's Pizza Pasta Bar,Balapavan Tirumani,Meals & Entertainment,13.32,53613632.48
02/14/2024,Expense,Qantas,Chris George,Credit Card - Ramp,356.29,53613988.77
02/14/2024,Expense,Qantas,Chris George,Credit Card - Ramp,356.29,53614345.06
02/14/2024,Expense,Calendly,Harvey Spector,Credit Card - Ramp,11.68,53614356.74
02/14/2024,Expense,Mx2Games,Anik Das,Credit Card - Ramp,613.41,53614970.15
02/14/2024,Expense,Careem,Harvey Spector,Credit Card - Ramp,11.44,53614981.59
02/14/2024,Expense,Mx2Games,Anik Das,Credit Card - Ramp,613.41,53615595
02/14/2024,Expense,Grumpy's Pizza Pasta Bar,Balapavan Tirumani,Meals & Entertainment,13.32,53615608.32
02/14/2024,Expense,Calendly,Harvey Spector,Tools & Subscription - G&A,11.68,53615620
02/14/2024,Expense,Mx2Games,Anik Das,Tools & Subscription - G&A,613.41,53616233.41
02/14/2024,Expense,Qantas,Chris George,Travel:Airfare,356.29,53616589.7
02/14/2024,Expense,Mx2Games,Anik Das,Tools & Subscription - G&A,613.41,53617203.11
02/14/2024,Expense,Qantas,Chris George,Travel:Airfare,356.29,53617559.4
02/14/2024,Expense,Grumpy's Pizza Pasta Bar,Balapavan Tirumani,Meals & Entertainment,13.32,53617572.72
02/14/2024,Expense,Careem,Harvey Spector,Travelling Expenses,11.44,53617584.16
02/14/2024,Expense,Wake Up!,Balapavan Tirumani,Travel:Hotels,3.37,53617587.53
02/14/2024,Expense,Calendly,Harvey Spector,Tools & Subscription - G&A,11.68,53617599.21
02/14/2024,Expense,Rentalcars.Com,Chris George,Travelling Expenses,146.06,53617745.27
02/15/2024,Expense,Muji,Balapavan Tirumani,Credit Card - Ramp,105.05,53617850.32
02/15/2024,Expense,Grill'd,Balapavan Tirumani,Credit Card - Ramp,14.73,53617865.05
02/15/2024,Expense,Diamond Town Pty Ltd Restaurant,Balapavan Tirumani,Credit Card - Ramp,21.47,53617886.52
02/15/2024,Expense,Uber,Mike ross,Travelling Expenses,14.18,53617900.7
02/15/2024,Expense,Adobe,Harvey Spector,Credit Card - Ramp,33.06,53617933.76
02/15/2024,Expense,Diamond Town Pty Ltd Restaurant,Balapavan Tirumani,Credit Card - Ramp,21.47,53617955.23
02/15/2024,Expense,Muji,Balapavan Tirumani,Meals & Entertainment,105.05,53618060.28
02/15/2024,Expense,Transport for NSW,Balapavan Tirumani,Travelling Expenses,2.05,53618062.33
02/15/2024,Expense,Adobe,Harvey Spector,Tools & Subscription - S&M,33.06,53618095.39
02/15/2024,Expense,Grill'd,Balapavan Tirumani,Meals & Entertainment,14.73,53618110.12
02/15/2024,Expense,Uber,Mike ross,Travelling Expenses,16.59,53618126.71
02/15/2024,Expense,Australia,Mike ross - WFH expense,Credit Card - Ramp,111.78,53618238.49
02/15/2024,Expense,Diamond Town Pty Ltd Restaurant,Balapavan Tirumani,Meals & Entertainment,21.47,53618259.96
02/15/2024,Expense,Australia,Mike ross - WFH expense,Credit Card - Ramp,111.78,53618371.74
02/15/2024,Expense,Uber,Mike ross,Credit Card - Ramp,16.59,53618388.33
02/15/2024,Expense,Australia,Mike ross - WFH expense,Office expenses:Office supplies,111.78,53618500.11
02/15/2024,Expense,Grill'd,Balapavan Tirumani,Credit Card - Ramp,14.73,53618514.84
02/15/2024,Expense,Uber,Mike ross,Travelling Expenses,16.59,53618531.43
02/15/2024,Expense,Adobe,Harvey Spector,Tools & Subscription - S&M,33.06,53618564.49
02/15/2024,Expense,Muji,Balapavan Tirumani,Credit Card - Ramp,105.05,53618669.54
02/15/2024,Expense,Grill'd,Balapavan Tirumani,Meals & Entertainment,14.73,53618684.27
02/15/2024,Expense,Grill'd,Balapavan Tirumani,Credit Card - Ramp,14.73,53618699
02/15/2024,Expense,Transport for NSW,Balapavan Tirumani,Credit Card - Ramp,2.05,53618701.05
02/15/2024,Expense,Uber,Mike ross,Credit Card - Ramp,14.18,53618715.23
02/15/2024,Expense,Adobe,Harvey Spector,Credit Card - Ramp,33.06,53618748.29
02/15/2024,Expense,Adobe,Harvey Spector,Credit Card - Ramp,33.06,53618781.35
02/15/2024,Expense,Australia,Mike ross - WFH expense,Credit Card - Ramp,111.78,53618893.13
02/15/2024,Expense,Muji,Balapavan Tirumani,Credit Card - Ramp,105.05,53618998.18
02/15/2024,Expense,Diamond Town Pty Ltd Restaurant,Balapavan Tirumani,Credit Card - Ramp,21.47,53619019.65
02/15/2024,Expense,Muji,Balapavan Tirumani,Credit Card - Ramp,105.05,53619124.7
02/15/2024,Expense,Diamond Town Pty Ltd Restaurant,Balapavan Tirumani,Meals & Entertainment,21.47,53619146.17
02/15/2024,Expense,Adobe,Harvey Spector,Tools & Subscription - S&M,33.06,53619179.23
02/15/2024,Expense,Grill'd,Balapavan Tirumani,Meals & Entertainment,14.73,53619193.96
02/15/2024,Expense,Muji,Balapavan Tirumani,Meals & Entertainment,105.05,53619299.01
02/15/2024,Expense,Uber,Mike ross,Credit Card - Ramp,14.18,53619313.19
02/15/2024,Expense,Uber,Mike ross,Travelling Expenses,16.59,53619329.78
02/15/2024,Expense,Australia,Mike ross - WFH expense,Credit Card - Ramp,111.78,53619441.56
02/15/2024,Expense,Uber,Mike ross,Credit Card - Ramp,16.59,53619458.15
02/15/2024,Expense,Transport for NSW,Balapavan Tirumani,Travelling Expenses,2.05,53619460.2
02/15/2024,Expense,Uber,Mike ross,Travelling Expenses,14.18,53619474.38
02/15/2024,Expense,Transport for NSW,Balapavan Tirumani,Credit Card - Ramp,2.05,53619476.43
02/15/2024,Expense,Diamond Town Pty Ltd Restaurant,Balapavan Tirumani,Meals & Entertainment,21.47,53619497.9
02/15/2024,Expense,Uber,Mike ross,Credit Card - Ramp,16.59,53619514.49
02/15/2024,Expense,Transport for NSW,Balapavan Tirumani,Travelling Expenses,2.05,53619516.54
02/15/2024,Expense,Australia,Mike ross - WFH expense,Office expenses:Office supplies,111.78,53619628.32
02/15/2024,Expense,Australia,Mike ross - WFH expense,Office expenses:Office supplies,111.78,53619740.1
02/15/2024,Expense,Australia,Mike ross - WFH expense,Office expenses:Office supplies,111.78,53619851.88
02/15/2024,Expense,Grill'd,Balapavan Tirumani,Meals & Entertainment,14.73,53619866.61
02/15/2024,Expense,Uber,Mike ross,Travelling Expenses,16.59,53619883.2
02/15/2024,Expense,Uber,Mike ross,Credit Card - Ramp,14.18,53619897.38
02/15/2024,Expense,Transport for NSW,Balapavan Tirumani,Credit Card - Ramp,2.05,53619899.43
02/15/2024,Expense,Grill'd,Balapavan Tirumani,Credit Card - Ramp,14.73,53619914.16
02/15/2024,Expense,Diamond Town Pty Ltd Restaurant,Balapavan Tirumani,Credit Card - Ramp,21.47,53619935.63
02/15/2024,Expense,Muji,Balapavan Tirumani,Meals & Entertainment,105.05,53620040.68
02/15/2024,Expense,Transport for NSW,Balapavan Tirumani,Travelling Expenses,2.05,53620042.73
02/15/2024,Expense,Muji,Balapavan Tirumani,Meals & Entertainment,105.05,53620147.78
02/15/2024,Expense,Diamond Town Pty Ltd Restaurant,Balapavan Tirumani,Meals & Entertainment,21.47,53620169.25
02/15/2024,Expense,Uber,Mike ross,Travelling Expenses,14.18,53620183.43
02/15/2024,Expense,Adobe,Harvey Spector,Tools & Subscription - S&M,33.06,53620216.49
02/15/2024,Expense,Uber,Mike ross,Travelling Expenses,14.18,53620230.67
02/16/2024,Expense,Alma,Mike ross,Credit Card - Ramp,214.94,53620445.61
02/16/2024,Expense,LS Coast Palm Beach,Mike ross,Meals & Entertainment,79.59,53620525.2
02/16/2024,Expense,Classic Coffee,Mike ross,Credit Card - Ramp,11.8,53620537
02/16/2024,Expense,Randy's Wine,Mike ross,Credit Card - Ramp,30.95,53620567.95
02/16/2024,Expense,Classic Coffee,Mike ross,Credit Card - Ramp,11.8,53620579.75
02/16/2024,Expense,Classic Coffee,Mike ross,Credit Card - Ramp,5.28,53620585.03
02/16/2024,Expense,Classic Coffee,Mike ross,Credit Card - Ramp,5.28,53620590.31
02/16/2024,Expense,LS Coast Palm Beach,Mike ross,Credit Card - Ramp,79.59,53620669.9
02/16/2024,Expense,Alma,Mike ross,Credit Card - Ramp,214.94,53620884.84
02/16/2024,Expense,Randy's Wine,Mike ross,Meals & Entertainment,30.95,53620915.79
02/16/2024,Expense,LS Coast Palm Beach,Mike ross,Credit Card - Ramp,79.59,53620995.38
02/16/2024,Expense,Alma,Mike ross,Meals & Entertainment,214.94,53621210.32
02/16/2024,Expense,Randy's Wine,Mike ross,Meals & Entertainment,30.95,53621241.27
02/16/2024,Expense,Randy's Wine,Mike ross,Meals & Entertainment,30.95,53621272.22
02/16/2024,Expense,Classic Coffee,Mike ross,Meals & Entertainment,11.8,53621284.02
02/16/2024,Expense,Doppler,Balapavan Tirumani,Tools & Subscription - G&A,37.67,53621321.69
02/16/2024,Expense,Doppler,Balapavan Tirumani,Tools & Subscription - G&A,37.67,53621359.36
02/16/2024,Expense,Classic Coffee,Mike ross,Meals & Entertainment,11.8,53621371.16
02/16/2024,Expense,Doppler,Balapavan Tirumani,Credit Card - Ramp,37.67,53621408.83
02/16/2024,Expense,Alma,Mike ross,Meals & Entertainment,214.94,53621623.77
02/16/2024,Expense,Classic Coffee,Mike ross,Meals & Entertainment,5.28,53621629.05
02/16/2024,Expense,LS Coast Palm Beach,Mike ross,Meals & Entertainment,79.59,53621708.64
02/16/2024,Expense,LS Coast Palm Beach,Mike ross,Meals & Entertainment,79.59,53621788.23
02/16/2024,Expense,Randy's Wine,Mike ross,Credit Card - Ramp,30.95,53621819.18
02/16/2024,Expense,Classic Coffee,Mike ross,Meals & Entertainment,5.28,53621824.46
02/16/2024,Expense,Classic Coffee,Mike ross,Credit Card - Ramp,5.28,53621829.74
02/16/2024,Expense,Classic Coffee,Mike ross,Meals & Entertainment,5.28,53621835.02
02/16/2024,Expense,LS Coast Palm Beach,Mike ross,Credit Card - Ramp,79.59,53621914.61
02/16/2024,Expense,Classic Coffee,Mike ross,Meals & Entertainment,11.8,53621926.41
02/16/2024,Expense,Doppler,Balapavan Tirumani,Tools & Subscription - G&A,37.67,53621964.08
02/16/2024,Expense,Classic Coffee,Mike ross,Meals & Entertainment,11.8,53621975.88
02/16/2024,Expense,LS Coast Palm Beach,Mike ross,Meals & Entertainment,79.59,53622055.47
02/16/2024,Expense,Alma,Mike ross,Meals & Entertainment,214.94,53622270.41
02/16/2024,Expense,Randy's Wine,Mike ross,Meals & Entertainment,30.95,53622301.36
02/16/2024,Expense,Classic Coffee,Mike ross,Credit Card - Ramp,11.8,53622313.16
02/16/2024,Expense,Classic Coffee,Mike ross,Credit Card - Ramp,5.28,53622318.44
02/16/2024,Expense,Classic Coffee,Mike ross,Meals & Entertainment,5.28,53622323.72
02/16/2024,Bill,ANSR Dubai,,Professional Service Charges,10874,53633197.72
02/16/2024,Expense,LS Coast Palm Beach,Mike ross,Credit Card - Ramp,79.59,53633277.31
02/16/2024,Bill,ANSR Dubai,Service Fees for February 2024,Accounts Payable (A/P),10874,53644151.31
02/16/2024,Expense,Alma,Mike ross,Credit Card - Ramp,214.94,53644366.25
02/16/2024,Expense,Doppler,Balapavan Tirumani,Credit Card - Ramp,37.67,53644403.92
02/16/2024,Expense,Alma,Mike ross,Credit Card - Ramp,214.94,53644618.86
02/16/2024,Expense,Randy's Wine,Mike ross,Credit Card - Ramp,30.95,53644649.81
02/16/2024,Bill,ANSR Dubai,,Professional Service Charges,10874,53655523.81
02/16/2024,Bill,ANSR Dubai,Service Fees for February 2024,Accounts Payable (A/P),10874,53666397.81
02/16/2024,Expense,Randy's Wine,Mike ross,Credit Card - Ramp,30.95,53666428.76
02/16/2024,Expense,Classic Coffee,Mike ross,Credit Card - Ramp,11.8,53666440.56
02/16/2024,Bill,ANSR Dubai,,Professional Service Charges,10874,53677314.56
02/16/2024,Expense,Doppler,Balapavan Tirumani,Tools & Subscription - G&A,37.67,53677352.23
02/16/2024,Expense,Alma,Mike ross,Meals & Entertainment,214.94,53677567.17
02/16/2024,Bill,ANSR Dubai,,Professional Service Charges,10874,53688441.17
02/16/2024,Bill,ANSR Dubai,Service Fees for February 2024,Accounts Payable (A/P),10874,53699315.17
02/16/2024,Expense,Doppler,Balapavan Tirumani,Credit Card - Ramp,37.67,53699352.84
02/17/2024,Expense,Barrenjoey Boating Services,Mike ross,Meals & Entertainment,28.99,53699381.83
02/17/2024,Expense,Beach Without Sand Surf Shop,Balapavan Tirumani,Tools & Subscription - G&A,47.19,53699429.02
02/17/2024,Expense,Barrenjoey House,Mike ross,Meals & Entertainment,151.16,53699580.18
02/17/2024,Expense,Auth0,Praveen Kumar,Tools & Subscription - G&A,35,53699615.18
02/17/2024,Expense,Barrenjoey House,Mike ross,Credit Card - Ramp,151.16,53699766.34
02/17/2024,Expense,Barrenjoey Boating Services,Mike ross,Credit Card - Ramp,28.99,53699795.33
02/17/2024,Expense,Bookoccino,Mike ross,Credit Card - Ramp,7,53699802.33
02/17/2024,Expense,Barrenjoey House,Mike ross,Credit Card - Ramp,151.16,53699953.49
02/17/2024,Expense,SUNSET DINER,Mike ross,Meals & Entertainment,67.11,53700020.6
02/17/2024,Expense,Bookoccino,Mike ross,Meals & Entertainment,7,53700027.6
02/17/2024,Expense,SUNSET DINER,Mike ross,Credit Card - Ramp,67.11,53700094.71
02/17/2024,Expense,Barrenjoey House,Mike ross,Meals & Entertainment,151.16,53700245.87
02/17/2024,Expense,Ww Metro 74 Barrenjoey Ro,Balapavan Tirumani,Meals & Entertainment,5.87,53700251.74
02/17/2024,Expense,Barrenjoey Boating Services,Mike ross,Meals & Entertainment,28.99,53700280.73
02/17/2024,Expense,Beach Without Sand Surf Shop,Balapavan Tirumani,Credit Card - Ramp,47.19,53700327.92
02/17/2024,Expense,Ww Metro 74 Barrenjoey Ro,Balapavan Tirumani,Meals & Entertainment,5.87,53700333.79
02/17/2024,Expense,Beach Without Sand Surf Shop,Balapavan Tirumani,Credit Card - Ramp,47.19,53700380.98
02/17/2024,Expense,SUNSET DINER,Mike ross,Meals & Entertainment,67.11,53700448.09
02/17/2024,Expense,Barrenjoey House,Mike ross,Credit Card - Ramp,151.16,53700599.25
02/17/2024,Expense,Bookoccino,Mike ross,Credit Card - Ramp,7,53700606.25
02/17/2024,Expense,Barrenjoey Boating Services,Mike ross,Credit Card - Ramp,28.99,53700635.24
02/17/2024,Expense,Ww Metro 74 Barrenjoey Ro,Balapavan Tirumani,Credit Card - Ramp,5.87,53700641.11
02/17/2024,Expense,Auth0,Praveen Kumar,Credit Card - Ramp,35,53700676.11
02/17/2024,Expense,Auth0,Praveen Kumar,Tools & Subscription - G&A,35,53700711.11
02/17/2024,Expense,Ww Metro 74 Barrenjoey Ro,Balapavan Tirumani,Credit Card - Ramp,5.87,53700716.98
02/17/2024,Expense,Beach Without Sand Surf Shop,Balapavan Tirumani,Tools & Subscription - G&A,47.19,53700764.17
02/17/2024,Expense,SUNSET DINER,Mike ross,Meals & Entertainment,67.11,53700831.28
02/17/2024,Expense,Bookoccino,Mike ross,Credit Card - Ramp,7,53700838.28
02/17/2024,Expense,Beach Without Sand Surf Shop,Balapavan Tirumani,Tools & Subscription - G&A,47.19,53700885.47
02/17/2024,Expense,Bookoccino,Mike ross,Meals & Entertainment,7,53700892.47
02/17/2024,Expense,Auth0,Praveen Kumar,Tools & Subscription - G&A,35,53700927.47
02/17/2024,Expense,SUNSET DINER,Mike ross,Meals & Entertainment,67.11,53700994.58
02/17/2024,Expense,Barrenjoey House,Mike ross,Meals & Entertainment,151.16,53701145.74
02/17/2024,Expense,Ww Metro 74 Barrenjoey Ro,Balapavan Tirumani,Credit Card - Ramp,5.87,53701151.61
02/17/2024,Expense,Beach Without Sand Surf Shop,Balapavan Tirumani,Tools & Subscription - G&A,47.19,53701198.8
02/17/2024,Expense,Barrenjoey Boating Services,Mike ross,Meals & Entertainment,28.99,53701227.79
02/17/2024,Expense,Ww Metro 74 Barrenjoey Ro,Balapavan Tirumani,Meals & Entertainment,5.87,53701233.66
02/17/2024,Expense,SUNSET DINER,Mike ross,Credit Card - Ramp,67.11,53701300.77
02/17/2024,Expense,Barrenjoey Boating Services,Mike ross,Credit Card - Ramp,28.99,53701329.76
02/17/2024,Expense,Barrenjoey House,Mike ross,Credit Card - Ramp,151.16,53701480.92
02/17/2024,Expense,Bookoccino,Mike ross,Credit Card - Ramp,7,53701487.92
02/17/2024,Expense,Barrenjoey House,Mike ross,Meals & Entertainment,151.16,53701639.08
02/17/2024,Expense,SUNSET DINER,Mike ross,Credit Card - Ramp,67.11,53701706.19
02/17/2024,Expense,Auth0,Praveen Kumar,Credit Card - Ramp,35,53701741.19
02/17/2024,Expense,Barrenjoey Boating Services,Mike ross,Meals & Entertainment,28.99,53701770.18
02/17/2024,Expense,Barrenjoey Boating Services,Mike ross,Credit Card - Ramp,28.99,53701799.17
02/17/2024,Expense,SUNSET DINER,Mike ross,Credit Card - Ramp,67.11,53701866.28
02/17/2024,Expense,Beach Without Sand Surf Shop,Balapavan Tirumani,Credit Card - Ramp,47.19,53701913.47
02/17/2024,Expense,Ww Metro 74 Barrenjoey Ro,Balapavan Tirumani,Meals & Entertainment,5.87,53701919.34
02/17/2024,Expense,Ww Metro 74 Barrenjoey Ro,Balapavan Tirumani,Credit Card - Ramp,5.87,53701925.21
02/17/2024,Expense,Auth0,Praveen Kumar,Credit Card - Ramp,35,53701960.21
02/17/2024,Expense,Bookoccino,Mike ross,Meals & Entertainment,7,53701967.21
02/17/2024,Expense,Auth0,Praveen Kumar,Tools & Subscription - G&A,35,53702002.21
02/17/2024,Expense,Bookoccino,Mike ross,Meals & Entertainment,7,53702009.21
02/18/2024,Expense,Reclaim.ai,Max Kausman,Tools & Subscription - G&A,8,53702017.21
02/18/2024,Expense,Intuit,Harvey Spector,Tools & Subscription - G&A,60,53702077.21
02/18/2024,Expense,Romeo's IGA Foodhall,Balapavan Tirumani,Meals & Entertainment,2.63,53702079.84
02/18/2024,Expense,Grill'd,Balapavan Tirumani,Meals & Entertainment,14.83,53702094.67
02/18/2024,Expense,Romeo's IGA Foodhall,Balapavan Tirumani,Meals & Entertainment,2.63,53702097.3
02/18/2024,Expense,Intuit,Harvey Spector,Tools & Subscription - G&A,60,53702157.3
02/18/2024,Expense,Grill'd,Balapavan Tirumani,Meals & Entertainment,14.83,53702172.13
02/18/2024,Expense,Intuit,Harvey Spector,Credit Card - Ramp,60,53702232.13
02/18/2024,Expense,Reclaim.ai,Max Kausman,Tools & Subscription - G&A,8,53702240.13
02/18/2024,Expense,Reclaim.ai,Max Kausman,Credit Card - Ramp,8,53702248.13
02/18/2024,Expense,Romeo's IGA Foodhall,Balapavan Tirumani,Meals & Entertainment,2.63,53702250.76
02/18/2024,Expense,Intuit,Harvey Spector,Tools & Subscription - G&A,60,53702310.76
02/18/2024,Expense,Grill'd,Balapavan Tirumani,Meals & Entertainment,14.83,53702325.59
02/18/2024,Expense,Segment,Balapavan Tirumani,Credit Card - Ramp,120,53702445.59
02/18/2024,Expense,Segment,Balapavan Tirumani,Tools & Subscription - G&A,120,53702565.59
02/18/2024,Expense,Grill'd,Balapavan Tirumani,Meals & Entertainment,14.83,53702580.42
02/18/2024,Expense,Segment,Balapavan Tirumani,Tools & Subscription - G&A,120,53702700.42
02/18/2024,Expense,Reclaim.ai,Max Kausman,Tools & Subscription - G&A,8,53702708.42
02/18/2024,Expense,Segment,Balapavan Tirumani,Tools & Subscription - G&A,120,53702828.42
02/18/2024,Expense,Romeo's IGA Foodhall,Balapavan Tirumani,Credit Card - Ramp,2.63,53702831.05
02/18/2024,Expense,Romeo's IGA Foodhall,Balapavan Tirumani,Meals & Entertainment,2.63,53702833.68
02/18/2024,Expense,Segment,Balapavan Tirumani,Credit Card - Ramp,120,53702953.68
02/18/2024,Expense,Intuit,Harvey Spector,Credit Card - Ramp,60,53703013.68
02/18/2024,Expense,Grill'd,Balapavan Tirumani,Credit Card - Ramp,14.83,53703028.51
02/18/2024,Expense,Romeo's IGA Foodhall,Balapavan Tirumani,Credit Card - Ramp,2.63,53703031.14
02/18/2024,Expense,Romeo's IGA Foodhall,Balapavan Tirumani,Credit Card - Ramp,2.63,53703033.77
02/18/2024,Expense,Grill'd,Balapavan Tirumani,Credit Card - Ramp,14.83,53703048.6
02/18/2024,Expense,Reclaim.ai,Max Kausman,Credit Card - Ramp,8,53703056.6
02/18/2024,Expense,Romeo's IGA Foodhall,Balapavan Tirumani,Credit Card - Ramp,2.63,53703059.23
02/18/2024,Expense,Reclaim.ai,Max Kausman,Credit Card - Ramp,8,53703067.23
02/18/2024,Expense,Segment,Balapavan Tirumani,Credit Card - Ramp,120,53703187.23
02/18/2024,Expense,Intuit,Harvey Spector,Credit Card - Ramp,60,53703247.23
02/18/2024,Expense,Grill'd,Balapavan Tirumani,Credit Card - Ramp,14.83,53703262.06
02/18/2024,Expense,Intuit,Harvey Spector,Tools & Subscription - G&A,60,53703322.06
02/18/2024,Expense,Grill'd,Balapavan Tirumani,Credit Card - Ramp,14.83,53703336.89
02/18/2024,Expense,Reclaim.ai,Max Kausman,Tools & Subscription - G&A,8,53703344.89
02/18/2024,Expense,Segment,Balapavan Tirumani,Tools & Subscription - G&A,120,53703464.89
02/19/2024,Expense,Mcdonald's,Balapavan Tirumani,Meals & Entertainment,9.4,53703474.29
02/19/2024,Expense,Dulcet Cafe,Mike ross,Meals & Entertainment,17.08,53703491.37
02/19/2024,Expense,,MONTHLY CHARGE Bank Charges for the per 01JAN2024 TO 31JAN2024 Invoice No 1786715,General business expenses:Bank fees & service charges,-48.35,53703443.02
02/19/2024,Expense,The Nine,Balapavan Tirumani,Meals & Entertainment,32.03,53703475.05
02/19/2024,Expense,Mcdonald's,Balapavan Tirumani,Credit Card - Ramp,9.4,53703484.45
02/19/2024,Expense,The Nine,Balapavan Tirumani,Meals & Entertainment,32.03,53703516.48
02/19/2024,Expense,Chat Thai,Mike ross,Meals & Entertainment,60.57,53703577.05
02/19/2024,Expense,The Nine,Balapavan Tirumani,Meals & Entertainment,4.39,53703581.44
02/19/2024,Expense,Mcdonald's,Balapavan Tirumani,Meals & Entertainment,9.4,53703590.84
02/19/2024,Expense,Dulcet Cafe,Mike ross,Meals & Entertainment,17.08,53703607.92
02/19/2024,Expense,Kinokuniya Book Stores,Mike ross,General business expenses:Continuing education,35.03,53703642.95
02/19/2024,Expense,Kinokuniya Book Stores,Mike ross,Credit Card - Ramp,35.03,53703677.98
02/19/2024,Expense,The Nine,Balapavan Tirumani,Credit Card - Ramp,4.39,53703682.37
02/19/2024,Expense,Transport for NSW,Balapavan Tirumani,Travelling Expenses,4.12,53703686.49
02/19/2024,Expense,Transport for NSW,Balapavan Tirumani,Travelling Expenses,4.12,53703690.61
02/19/2024,Expense,The Nine,Balapavan Tirumani,Credit Card - Ramp,32.03,53703722.64
02/19/2024,Expense,The Nine,Balapavan Tirumani,Credit Card - Ramp,4.39,53703727.03
02/19/2024,Expense,The Nine,Balapavan Tirumani,Credit Card - Ramp,32.03,53703759.06
02/19/2024,Expense,Mcdonald's,Balapavan Tirumani,Meals & Entertainment,9.4,53703768.46
02/19/2024,Expense,Chat Thai,Mike ross,Credit Card - Ramp,60.57,53703829.03
02/19/2024,Expense,Kinokuniya Book Stores,Mike ross,General business expenses:Continuing education,35.03,53703864.06
02/19/2024,Expense,Dulcet Cafe,Mike ross,Meals & Entertainment,17.08,53703881.14
02/19/2024,Expense,Transport for NSW,Balapavan Tirumani,Travelling Expenses,4.12,53703885.26
02/19/2024,Expense,Dulcet Cafe,Mike ross,Credit Card - Ramp,17.08,53703902.34
02/19/2024,Expense,Mcdonald's,Balapavan Tirumani,Credit Card - Ramp,9.4,53703911.74
02/19/2024,Expense,Chat Thai,Mike ross,Credit Card - Ramp,60.57,53703972.31
02/19/2024,Expense,Dulcet Cafe,Mike ross,Credit Card - Ramp,17.08,53703989.39
02/19/2024,Expense,Kinokuniya Book Stores,Mike ross,General business expenses:Continuing education,35.03,53704024.42
02/19/2024,Expense,Chat Thai,Mike ross,Meals & Entertainment,60.57,53704084.99
02/19/2024,Expense,,Fees,HSBC A/c,48.35,53704133.34
02/19/2024,Expense,The Nine,Balapavan Tirumani,Meals & Entertainment,4.39,53704137.73
02/19/2024,Expense,The Nine,Balapavan Tirumani,Meals & Entertainment,32.03,53704169.76
02/19/2024,Expense,Chat Thai,Mike ross,Meals & Entertainment,60.57,53704230.33
02/19/2024,Expense,The Nine,Balapavan Tirumani,Meals & Entertainment,4.39,53704234.72
02/19/2024,Expense,Transport for NSW,Balapavan Tirumani,Credit Card - Ramp,4.12,53704238.84
02/19/2024,Expense,Kinokuniya Book Stores,Mike ross,Credit Card - Ramp,35.03,53704273.87
02/19/2024,Expense,Kinokuniya Book Stores,Mike ross,Credit Card - Ramp,35.03,53704308.9
02/19/2024,Expense,Chat Thai,Mike ross,Credit Card - Ramp,60.57,53704369.47
02/19/2024,Expense,Dulcet Cafe,Mike ross,Credit Card - Ramp,17.08,53704386.55
02/19/2024,Expense,Mcdonald's,Balapavan Tirumani,Credit Card - Ramp,9.4,53704395.95
02/19/2024,Expense,Transport for NSW,Balapavan Tirumani,Credit Card - Ramp,4.12,53704400.07
02/19/2024,Expense,The Nine,Balapavan Tirumani,Credit Card - Ramp,32.03,53704432.1
02/19/2024,Expense,,Fees,HSBC A/c,48.35,53704480.45
02/19/2024,Expense,,Fees,HSBC A/c,48.35,53704528.8
02/19/2024,Expense,The Nine,Balapavan Tirumani,Meals & Entertainment,32.03,53704560.83
02/19/2024,Expense,The Nine,Balapavan Tirumani,Meals & Entertainment,4.39,53704565.22
02/19/2024,Expense,,Fees,HSBC A/c,48.35,53704613.57
02/19/2024,Expense,Mcdonald's,Balapavan Tirumani,Credit Card - Ramp,9.4,53704622.97
02/19/2024,Expense,The Nine,Balapavan Tirumani,Credit Card - Ramp,4.39,53704627.36
02/19/2024,Expense,Dulcet Cafe,Mike ross,Credit Card - Ramp,17.08,53704644.44
02/19/2024,Expense,Kinokuniya Book Stores,Mike ross,Credit Card - Ramp,35.03,53704679.47
02/19/2024,Expense,,MONTHLY CHARGE Bank Charges for the per 01JAN2024 TO 31JAN2024 Invoice No 1786715,General business expenses:Bank fees & service charges,-48.35,53704631.12
02/19/2024,Expense,Mcdonald's,Balapavan Tirumani,Meals & Entertainment,9.4,53704640.52
02/19/2024,Expense,Chat Thai,Mike ross,Meals & Entertainment,60.57,53704701.09
02/19/2024,Expense,Dulcet Cafe,Mike ross,Meals & Entertainment,17.08,53704718.17
02/19/2024,Expense,Kinokuniya Book Stores,Mike ross,General business expenses:Continuing education,35.03,53704753.2
02/19/2024,Expense,Transport for NSW,Balapavan Tirumani,Credit Card - Ramp,4.12,53704757.32
02/19/2024,Expense,,MONTHLY CHARGE Bank Charges for the per 01JAN2024 TO 31JAN2024 Invoice No 1786715,General business expenses:Bank fees & service charges,-48.35,53704708.97
02/19/2024,Expense,Transport for NSW,Balapavan Tirumani,Travelling Expenses,4.12,53704713.09
02/19/2024,Expense,,MONTHLY CHARGE Bank Charges for the per 01JAN2024 TO 31JAN2024 Invoice No 1786715,General business expenses:Bank fees & service charges,-48.35,53704664.74
02/19/2024,Expense,The Nine,Balapavan Tirumani,Credit Card - Ramp,32.03,53704696.77
02/19/2024,Expense,Chat Thai,Mike ross,Credit Card - Ramp,60.57,53704757.34
02/19/2024,Expense,The Nine,Balapavan Tirumani,Credit Card - Ramp,4.39,53704761.73
02/20/2024,Expense,Zoom,Harvey Spector,Tools & Subscription - G&A,159.9,53704921.63
02/20/2024,Expense,BuildBetter,Max Kausman,Tools & Subscription - G&A,100,53705021.63
02/20/2024,Expense,Romeo's IGA Foodhall,Balapavan Tirumani,Meals & Entertainment,5.82,53705027.45
02/20/2024,Expense,Tsal,Harvey Spector,Travel:Airfare,33.66,53705061.11
02/20/2024,Expense,Romeo's IGA Foodhall,Balapavan Tirumani,Credit Card - Ramp,5.82,53705066.93
02/20/2024,Expense,Tickets Diamond Ba,Balapavan Tirumani,Contributions to charities,6.75,53705073.68
02/20/2024,Bill Payment (Check),ANSR Dubai,,HSBC A/c,-10874,53694199.68
02/20/2024,Expense,Zoom,Harvey Spector,Credit Card - Ramp,10.05,53694209.73
02/20/2024,Expense,Tickets Diamond Ba,Balapavan Tirumani,Credit Card - Ramp,6.75,53694216.48
02/20/2024,Expense,Grill'd,Balapavan Tirumani,Credit Card - Ramp,14.85,53694231.33
02/20/2024,Expense,BuildBetter,Max Kausman,Tools & Subscription - G&A,100,53694331.33
02/20/2024,Expense,Zoom,Harvey Spector,Tools & Subscription - G&A,10.05,53694341.38
02/20/2024,Expense,Romeo's IGA Foodhall,Balapavan Tirumani,Meals & Entertainment,5.82,53694347.2
02/20/2024,Expense,1Password,Mike ross,Tools & Subscription - G&A,59.85,53694407.05
02/20/2024,Expense,Zoom,Harvey Spector,Tools & Subscription - G&A,10.05,53694417.1
02/20/2024,Expense,Zoom,Harvey Spector,Credit Card - Ramp,10.05,53694427.15
02/20/2024,Expense,Grill'd,Balapavan Tirumani,Meals & Entertainment,14.85,53694442
02/20/2024,Expense,Grill'd,Balapavan Tirumani,Meals & Entertainment,14.85,53694456.85
02/20/2024,Expense,Zoom,Harvey Spector,Credit Card - Ramp,159.9,53694616.75
02/20/2024,Expense,BuildBetter,Max Kausman,Credit Card - Ramp,100,53694716.75
02/20/2024,Expense,BuildBetter,Max Kausman,Credit Card - Ramp,100,53694816.75
02/20/2024,Expense,Tickets Diamond Ba,Balapavan Tirumani,Credit Card - Ramp,6.75,53694823.5
02/20/2024,Bill Payment (Check),ANSR Dubai,"BOOK TRANSFER DEBIT 45BOOK DEBIT CHRONICLEHQ INC.*BNF:ANSR (EMEA) GLOBAL SERVICES LIM ITED*OBI:/INV/ANSREMEA/077*BBI:/DAS/REF:50456TB013EF*STBOOK*TIME: 0446*YOUR REF:ANSREMEA/077*OUR REF:051331206
ANSREMEA/077",Accounts Payable (A/P),-10874,53683949.5
02/20/2024,Expense,Zoom,Harvey Spector,Tools & Subscription - G&A,159.9,53684109.4
02/20/2024,Expense,Tsal,Harvey Spector,Credit Card - Ramp,33.66,53684143.06
02/20/2024,Expense,1Password,Mike ross,Credit Card - Ramp,59.85,53684202.91
02/20/2024,Expense,Tickets Diamond Ba,Balapavan Tirumani,Credit Card - Ramp,6.75,53684209.66
02/20/2024,Expense,1Password,Mike ross,Credit Card - Ramp,59.85,53684269.51
02/20/2024,Bill Payment (Check),ANSR Dubai,,HSBC A/c,-10874,53673395.51
02/20/2024,Expense,Zoom,Harvey Spector,Credit Card - Ramp,10.05,53673405.56
02/20/2024,Expense,1Password,Mike ross,Tools & Subscription - G&A,59.85,53673465.41
02/20/2024,Expense,Zoom,Harvey Spector,Credit Card - Ramp,159.9,53673625.31
02/20/2024,Expense,Tsal,Harvey Spector,Travel:Airfare,33.66,53673658.97
02/20/2024,Expense,BuildBetter,Max Kausman,Tools & Subscription - G&A,100,53673758.97
02/20/2024,Expense,1Password,Mike ross,Tools & Subscription - G&A,59.85,53673818.82
02/20/2024,Expense,Grill'd,Balapavan Tirumani,Credit Card - Ramp,14.85,53673833.67
02/20/2024,Bill Payment (Check),ANSR Dubai,"BOOK TRANSFER DEBIT 45BOOK DEBIT CHRONICLEHQ INC.*BNF:ANSR (EMEA) GLOBAL SERVICES LIM ITED*OBI:/INV/ANSREMEA/077*BBI:/DAS/REF:50456TB013EF*STBOOK*TIME: 0446*YOUR REF:ANSREMEA/077*OUR REF:051331206
ANSREMEA/077",Accounts Payable (A/P),-10874,53662959.67
02/20/2024,Expense,Tickets Diamond Ba,Balapavan Tirumani,Contributions to charities,6.75,53662966.42
02/20/2024,Expense,Zoom,Harvey Spector,Tools & Subscription - G&A,10.05,53662976.47
02/20/2024,Expense,Zoom,Harvey Spector,Tools & Subscription - G&A,159.9,53663136.37
02/20/2024,Expense,Romeo's IGA Foodhall,Balapavan Tirumani,Meals & Entertainment,5.82,53663142.19
02/20/2024,Expense,Grill'd,Balapavan Tirumani,Meals & Entertainment,14.85,53663157.04
02/20/2024,Expense,Tsal,Harvey Spector,Travel:Airfare,33.66,53663190.7
02/20/2024,Expense,Tickets Diamond Ba,Balapavan Tirumani,Contributions to charities,6.75,53663197.45
02/20/2024,Expense,Grill'd,Balapavan Tirumani,Credit Card - Ramp,14.85,53663212.3
02/20/2024,Expense,Romeo's IGA Foodhall,Balapavan Tirumani,Credit Card - Ramp,5.82,53663218.12
02/20/2024,Bill Payment (Check),ANSR Dubai,"BOOK TRANSFER DEBIT 45BOOK DEBIT CHRONICLEHQ INC.*BNF:ANSR (EMEA) GLOBAL SERVICES LIM ITED*OBI:/INV/ANSREMEA/077*BBI:/DAS/REF:50456TB013EF*STBOOK*TIME: 0446*YOUR REF:ANSREMEA/077*OUR REF:051331206
ANSREMEA/077",Accounts Payable (A/P),-10874,53652344.12
02/20/2024,Expense,Tickets Diamond Ba,Balapavan Tirumani,Credit Card - Ramp,6.75,53652350.87
02/20/2024,Expense,Tsal,Harvey Spector,Credit Card - Ramp,33.66,53652384.53
02/20/2024,Expense,Romeo's IGA Foodhall,Balapavan Tirumani,Credit Card - Ramp,5.82,53652390.35
02/20/2024,Bill Payment (Check),ANSR Dubai,"BOOK TRANSFER DEBIT 45BOOK DEBIT CHRONICLEHQ INC.*BNF:ANSR (EMEA) GLOBAL SERVICES LIM ITED*OBI:/INV/ANSREMEA/077*BBI:/DAS/REF:50456TB013EF*STBOOK*TIME: 0446*YOUR REF:ANSREMEA/077*OUR REF:051331206
ANSREMEA/077",Accounts Payable (A/P),-10874,53641516.35
02/20/2024,Expense,Tsal,Harvey Spector,Credit Card - Ramp,33.66,53641550.01
02/20/2024,Expense,Grill'd,Balapavan Tirumani,Credit Card - Ramp,14.85,53641564.86
02/20/2024,Expense,1Password,Mike ross,Credit Card - Ramp,59.85,53641624.71
02/20/2024,Expense,Zoom,Harvey Spector,Credit Card - Ramp,159.9,53641784.61
02/20/2024,Expense,1Password,Mike ross,Tools & Subscription - G&A,59.85,53641844.46
02/20/2024,Expense,Tickets Diamond Ba,Balapavan Tirumani,Contributions to charities,6.75,53641851.21
02/20/2024,Expense,Tsal,Harvey Spector,Travel:Airfare,33.66,53641884.87
02/20/2024,Expense,Grill'd,Balapavan Tirumani,Meals & Entertainment,14.85,53641899.72
02/20/2024,Expense,BuildBetter,Max Kausman,Credit Card - Ramp,100,53641999.72
02/20/2024,Expense,BuildBetter,Max Kausman,Tools & Subscription - G&A,100,53642099.72
02/20/2024,Expense,Zoom,Harvey Spector,Tools & Subscription - G&A,159.9,53642259.62
02/20/2024,Expense,Zoom,Harvey Spector,Tools & Subscription - G&A,10.05,53642269.67
02/20/2024,Bill Payment (Check),ANSR Dubai,,HSBC A/c,-10874,53631395.67
02/20/2024,Expense,Romeo's IGA Foodhall,Balapavan Tirumani,Credit Card - Ramp,5.82,53631401.49
02/20/2024,Expense,Romeo's IGA Foodhall,Balapavan Tirumani,Meals & Entertainment,5.82,53631407.31
02/20/2024,Bill Payment (Check),ANSR Dubai,,HSBC A/c,-10874,53620533.31
02/21/2024,Expense,Careem,Harvey Spector,Travelling Expenses,17.05,53620550.36
02/21/2024,Expense,Rice Pot Thai Cuisine,Balapavan Tirumani,Credit Card - Ramp,17.13,53620567.49
02/21/2024,Expense,Bondi Mart Pty Ltd,Balapavan Tirumani,Meals & Entertainment,1.72,53620569.21
02/21/2024,Expense,Dubai Taxi,Harvey Spector,Travelling Expenses,13.04,53620582.25
02/21/2024,Expense,Zambrero,Balapavan Tirumani,Credit Card - Ramp,9.42,53620591.67
02/21/2024,Expense,Rice Pot Thai Cuisine,Balapavan Tirumani,Meals & Entertainment,17.13,53620608.8
02/21/2024,Expense,Dubai Taxi,Harvey Spector,Credit Card - Ramp,13.04,53620621.84
02/21/2024,Expense,Supercell,Anik Das,Tools & Subscription - G&A,7.45,53620629.29
02/21/2024,Expense,Careem,Harvey Spector,Travelling Expenses,17.05,53620646.34
02/21/2024,Expense,Bondi Mart Pty Ltd,Balapavan Tirumani,Meals & Entertainment,1.72,53620648.06
02/21/2024,Expense,Zambrero,Balapavan Tirumani,Meals & Entertainment,9.42,53620657.48
02/21/2024,Expense,Bondi Mart Pty Ltd,Balapavan Tirumani,Credit Card - Ramp,1.72,53620659.2
02/21/2024,Expense,Bondi Mart Pty Ltd,Balapavan Tirumani,Credit Card - Ramp,1.72,53620660.92
02/21/2024,Transfer,,RAMP STATEMENT,Credit Card - Ramp,-12541.43,53608119.49
02/21/2024,Transfer,,RAMP STATEMENT,Account1,-12541.43,53595578.06
02/21/2024,Expense,Zambrero,Balapavan Tirumani,Meals & Entertainment,9.42,53595587.48
02/21/2024,Expense,Zambrero,Balapavan Tirumani,Credit Card - Ramp,9.42,53595596.9
02/21/2024,Expense,Rice Pot Thai Cuisine,Balapavan Tirumani,Credit Card - Ramp,17.13,53595614.03
02/21/2024,Expense,Bondi Mart Pty Ltd,Balapavan Tirumani,Credit Card - Ramp,1.72,53595615.75
02/21/2024,Transfer,,RAMP STATEMENT,Account1,-12541.43,53583074.32
02/21/2024,Expense,Careem,Harvey Spector,Travelling Expenses,17.05,53583091.37
02/21/2024,Expense,Dubai Taxi,Harvey Spector,Travelling Expenses,13.04,53583104.41
02/21/2024,Expense,Rice Pot Thai Cuisine,Balapavan Tirumani,Meals & Entertainment,17.13,53583121.54
02/21/2024,Transfer,,RAMP STATEMENT,Credit Card - Ramp,-12541.43,53570580.11
02/21/2024,Expense,Supercell,Anik Das,Credit Card - Ramp,7.45,53570587.56
02/21/2024,Transfer,,RAMP STATEMENT,Account1,-12541.43,53558046.13
02/21/2024,Expense,Careem,Harvey Spector,Credit Card - Ramp,17.05,53558063.18
02/21/2024,Expense,Rice Pot Thai Cuisine,Balapavan Tirumani,Meals & Entertainment,17.13,53558080.31
02/21/2024,Expense,Supercell,Anik Das,Tools & Subscription - G&A,7.45,53558087.76
02/21/2024,Expense,Zambrero,Balapavan Tirumani,Meals & Entertainment,9.42,53558097.18
02/21/2024,Expense,Dubai Taxi,Harvey Spector,Travelling Expenses,13.04,53558110.22
02/21/2024,Expense,Bondi Mart Pty Ltd,Balapavan Tirumani,Meals & Entertainment,1.72,53558111.94
02/21/2024,Expense,Dubai Taxi,Harvey Spector,Credit Card - Ramp,13.04,53558124.98
02/21/2024,Expense,Bondi Mart Pty Ltd,Balapavan Tirumani,Meals & Entertainment,1.72,53558126.7
02/21/2024,Expense,Dubai Taxi,Harvey Spector,Travelling Expenses,13.04,53558139.74
02/21/2024,Transfer,,RAMP STATEMENT,Account1,-12541.43,53545598.31
02/21/2024,Transfer,,RAMP STATEMENT,Credit Card - Ramp,-12541.43,53533056.88
02/21/2024,Expense,Careem,Harvey Spector,Travelling Expenses,17.05,53533073.93
02/21/2024,Expense,Rice Pot Thai Cuisine,Balapavan Tirumani,Meals & Entertainment,17.13,53533091.06
02/21/2024,Expense,Supercell,Anik Das,Tools & Subscription - G&A,7.45,53533098.51
02/21/2024,Expense,Careem,Harvey Spector,Credit Card - Ramp,17.05,53533115.56
02/21/2024,Expense,Bondi Mart Pty Ltd,Balapavan Tirumani,Credit Card - Ramp,1.72,53533117.28
02/21/2024,Expense,Supercell,Anik Das,Credit Card - Ramp,7.45,53533124.73
02/21/2024,Expense,Supercell,Anik Das,Tools & Subscription - G&A,7.45,53533132.18
02/21/2024,Expense,Zambrero,Balapavan Tirumani,Meals & Entertainment,9.42,53533141.6
02/21/2024,Expense,Zambrero,Balapavan Tirumani,Credit Card - Ramp,9.42,53533151.02
02/21/2024,Expense,Rice Pot Thai Cuisine,Balapavan Tirumani,Credit Card - Ramp,17.13,53533168.15
02/21/2024,Expense,Supercell,Anik Das,Credit Card - Ramp,7.45,53533175.6
02/21/2024,Expense,Zambrero,Balapavan Tirumani,Credit Card - Ramp,9.42,53533185.02
02/21/2024,Expense,Dubai Taxi,Harvey Spector,Credit Card - Ramp,13.04,53533198.06
02/21/2024,Expense,Careem,Harvey Spector,Credit Card - Ramp,17.05,53533215.11
02/21/2024,Transfer,,RAMP STATEMENT,Credit Card - Ramp,-12541.43,53520673.68
02/21/2024,Expense,Rice Pot Thai Cuisine,Balapavan Tirumani,Credit Card - Ramp,17.13,53520690.81
02/22/2024,Expense,Cafe Gusto,Balapavan Tirumani,Credit Card - Ramp,15.06,53520705.87
02/22/2024,Expense,Harris Farm Markets,Balapavan Tirumani,Credit Card - Ramp,6.42,53520712.29
02/22/2024,Expense,Cloudflare,Anik Das,Credit Card - Ramp,5,53520717.29
02/22/2024,Expense,The Grumpy Baker,Balapavan Tirumani,Credit Card - Ramp,3.09,53520720.38
02/22/2024,Expense,Stately.ai,Chris Jerochim,Tools & Subscription - G&A,39,53520759.38
02/22/2024,Expense,The Grumpy Baker,Balapavan Tirumani,Credit Card - Ramp,3.09,53520762.47
02/22/2024,Expense,Cafe Gusto,Balapavan Tirumani,Credit Card - Ramp,9.28,53520771.75
02/22/2024,Expense,The Grumpy Baker,Balapavan Tirumani,Meals & Entertainment,3.09,53520774.84
02/22/2024,Expense,The Grumpy Baker,Balapavan Tirumani,Credit Card - Ramp,3.09,53520777.93
02/22/2024,Expense,Harris Farm Markets,Balapavan Tirumani,Credit Card - Ramp,6.09,53520784.02
02/22/2024,Expense,Harris Farm Markets,Balapavan Tirumani,Credit Card - Ramp,6.42,53520790.44
02/22/2024,Expense,Durga Australia Pty Restaurant,Balapavan Tirumani,Credit Card - Ramp,12.86,53520803.3
02/22/2024,Expense,Durga Australia Pty Restaurant,Balapavan Tirumani,Credit Card - Ramp,12.86,53520816.16
02/22/2024,Expense,Durga Australia Pty Restaurant,Balapavan Tirumani,Credit Card - Ramp,12.86,53520829.02
02/22/2024,Credit Card Credit,Zoom,Max Kausman,Credit Card - Ramp,-10.48,53520818.54
02/22/2024,Expense,Cloudflare,Anik Das,Tools & Subscription - G&A,5,53520823.54
02/22/2024,Expense,Cafe Gusto,Balapavan Tirumani,Meals & Entertainment,9.28,53520832.82
02/22/2024,Expense,Cafe Gusto,Balapavan Tirumani,Meals & Entertainment,9.28,53520842.1
02/22/2024,Expense,Cafe Gusto,Balapavan Tirumani,Credit Card - Ramp,15.06,53520857.16
02/22/2024,Expense,Cafe Gusto,Balapavan Tirumani,Credit Card - Ramp,9.28,53520866.44
02/22/2024,Expense,Durga Australia Pty Restaurant,Balapavan Tirumani,Meals & Entertainment,12.86,53520879.3
02/22/2024,Expense,Durga Australia Pty Restaurant,Balapavan Tirumani,Meals & Entertainment,12.86,53520892.16
02/22/2024,Expense,Harris Farm Markets,Balapavan Tirumani,Credit Card - Ramp,6.09,53520898.25
02/22/2024,Expense,The Grumpy Baker,Balapavan Tirumani,Meals & Entertainment,3.09,53520901.34
02/22/2024,Credit Card Credit,Zoom,Max Kausman,Tools & Subscription - G&A,-10.48,53520890.86
02/22/2024,Expense,Stately.ai,Chris Jerochim,Credit Card - Ramp,39,53520929.86
02/22/2024,Expense,Stately.ai,Chris Jerochim,Credit Card - Ramp,39,53520968.86
02/22/2024,Expense,Cloudflare,Anik Das,Credit Card - Ramp,5,53520973.86
02/22/2024,Credit Card Credit,Zoom,Max Kausman,Credit Card - Ramp,-10.48,53520963.38
02/22/2024,Expense,Stately.ai,Chris Jerochim,Credit Card - Ramp,39,53521002.38
02/22/2024,Expense,Harris Farm Markets,Balapavan Tirumani,Meals & Entertainment,6.09,53521008.47
02/22/2024,Expense,Cafe Gusto,Balapavan Tirumani,Meals & Entertainment,15.06,53521023.53
02/22/2024,Expense,Harris Farm Markets,Balapavan Tirumani,Credit Card - Ramp,6.09,53521029.62
02/22/2024,Expense,Durga Australia Pty Restaurant,Balapavan Tirumani,Credit Card - Ramp,12.86,53521042.48
02/22/2024,Expense,Harris Farm Markets,Balapavan Tirumani,Meals & Entertainment,6.42,53521048.9
02/22/2024,Expense,Harris Farm Markets,Balapavan Tirumani,Meals & Entertainment,6.42,53521055.32
02/22/2024,Expense,Stately.ai,Chris Jerochim,Tools & Subscription - G&A,39,53521094.32
02/22/2024,Expense,Cafe Gusto,Balapavan Tirumani,Credit Card - Ramp,15.06,53521109.38
02/22/2024,Expense,Durga Australia Pty Restaurant,Balapavan Tirumani,Meals & Entertainment,12.86,53521122.24
02/22/2024,Expense,The Grumpy Baker,Balapavan Tirumani,Credit Card - Ramp,3.09,53521125.33
02/22/2024,Expense,Harris Farm Markets,Balapavan Tirumani,Credit Card - Ramp,6.42,53521131.75
02/22/2024,Expense,Cloudflare,Anik Das,Credit Card - Ramp,5,53521136.75
02/22/2024,Expense,Harris Farm Markets,Balapavan Tirumani,Meals & Entertainment,6.09,53521142.84
02/22/2024,Credit Card Credit,Zoom,Max Kausman,Credit Card - Ramp,-10.48,53521132.36
02/22/2024,Expense,Harris Farm Markets,Balapavan Tirumani,Meals & Entertainment,6.42,53521138.78
02/22/2024,Expense,Cloudflare,Anik Das,Tools & Subscription - G&A,5,53521143.78
02/22/2024,Expense,Cafe Gusto,Balapavan Tirumani,Credit Card - Ramp,15.06,53521158.84
02/22/2024,Expense,Cafe Gusto,Balapavan Tirumani,Credit Card - Ramp,9.28,53521168.12
02/22/2024,Expense,Harris Farm Markets,Balapavan Tirumani,Credit Card - Ramp,6.09,53521174.21
02/22/2024,Expense,Cloudflare,Anik Das,Tools & Subscription - G&A,5,53521179.21
02/22/2024,Credit Card Credit,Zoom,Max Kausman,Tools & Subscription - G&A,-10.48,53521168.73
02/22/2024,Expense,Cafe Gusto,Balapavan Tirumani,Meals & Entertainment,15.06,53521183.79
02/22/2024,Expense,Cafe Gusto,Balapavan Tirumani,Meals & Entertainment,15.06,53521198.85
02/22/2024,Expense,Cafe Gusto,Balapavan Tirumani,Meals & Entertainment,9.28,53521208.13
02/22/2024,Credit Card Credit,Zoom,Max Kausman,Tools & Subscription - G&A,-10.48,53521197.65
02/22/2024,Expense,Cafe Gusto,Balapavan Tirumani,Meals & Entertainment,9.28,53521206.93
02/22/2024,Expense,Cafe Gusto,Balapavan Tirumani,Meals & Entertainment,15.06,53521221.99
02/22/2024,Expense,Harris Farm Markets,Balapavan Tirumani,Meals & Entertainment,6.09,53521228.08
02/22/2024,Expense,Stately.ai,Chris Jerochim,Tools & Subscription - G&A,39,53521267.08
02/22/2024,Expense,Harris Farm Markets,Balapavan Tirumani,Credit Card - Ramp,6.42,53521273.5
02/22/2024,Expense,Harris Farm Markets,Balapavan Tirumani,Meals & Entertainment,6.09,53521279.59
02/22/2024,Expense,Cafe Gusto,Balapavan Tirumani,Credit Card - Ramp,9.28,53521288.87
02/22/2024,Expense,Durga Australia Pty Restaurant,Balapavan Tirumani,Meals & Entertainment,12.86,53521301.73
02/22/2024,Expense,The Grumpy Baker,Balapavan Tirumani,Meals & Entertainment,3.09,53521304.82
02/22/2024,Expense,Stately.ai,Chris Jerochim,Tools & Subscription - G&A,39,53521343.82
02/22/2024,Expense,Cloudflare,Anik Das,Tools & Subscription - G&A,5,53521348.82
02/22/2024,Expense,Harris Farm Markets,Balapavan Tirumani,Meals & Entertainment,6.42,53521355.24
02/22/2024,Credit Card Credit,Zoom,Max Kausman,Tools & Subscription - G&A,-10.48,53521344.76
02/22/2024,Expense,The Grumpy Baker,Balapavan Tirumani,Meals & Entertainment,3.09,53521347.85
02/23/2024,Expense,Makaveli,Mike ross,Credit Card - Ramp,15.51,53521363.36
02/23/2024,Expense,Big Beat Australia,Balapavan Tirumani,Meals & Entertainment,3.42,53521366.78
02/23/2024,Expense,Careem,Harvey Spector,Credit Card - Ramp,6.59,53521373.37
02/23/2024,Expense,Makaveli,Mike ross,Credit Card - Ramp,15.51,53521388.88
02/23/2024,Expense,Eventbrite,Balapavan Tirumani,Tools & Subscription - G&A,22.6,53521411.48
02/23/2024,Expense,Fusion India Restaurant,Balapavan Tirumani,Meals & Entertainment,14.5,53521425.98
02/23/2024,Expense,Careem,Harvey Spector,Travelling Expenses,6.59,53521432.57
02/23/2024,Expense,Big Beat Australia,Balapavan Tirumani,Credit Card - Ramp,3.42,53521435.99
02/23/2024,Expense,Careem,Harvey Spector,Travelling Expenses,6.59,53521442.58
02/23/2024,Expense,Big Beat Australia,Balapavan Tirumani,Meals & Entertainment,3.42,53521446
02/23/2024,Expense,Eventbrite,Balapavan Tirumani,Tools & Subscription - G&A,22.6,53521468.6
02/23/2024,Expense,Big Beat Australia,Balapavan Tirumani,Credit Card - Ramp,3.42,53521472.02
02/23/2024,Expense,Transport for NSW,Balapavan Tirumani,Travelling Expenses,3.79,53521475.81
02/23/2024,Expense,Makaveli,Mike ross,Meals & Entertainment,15.51,53521491.32
02/23/2024,Expense,Makaveli,Mike ross,Meals & Entertainment,15.51,53521506.83
02/23/2024,Expense,Transport for NSW,Balapavan Tirumani,Credit Card - Ramp,3.79,53521510.62
02/23/2024,Expense,Fusion India Restaurant,Balapavan Tirumani,Credit Card - Ramp,14.5,53521525.12
02/23/2024,Expense,Careem,Harvey Spector,Travelling Expenses,6.59,53521531.71
02/23/2024,Expense,Careem,Harvey Spector,Credit Card - Ramp,6.59,53521538.3
02/23/2024,Expense,Careem,Harvey Spector,Travelling Expenses,6.59,53521544.89
02/23/2024,Expense,Fusion India Restaurant,Balapavan Tirumani,Meals & Entertainment,14.5,53521559.39
02/23/2024,Expense,Eventbrite,Balapavan Tirumani,Credit Card - Ramp,22.6,53521581.99
02/23/2024,Expense,Makaveli,Mike ross,Meals & Entertainment,15.51,53521597.5
02/23/2024,Expense,Makaveli,Mike ross,Meals & Entertainment,15.51,53521613.01
02/23/2024,Expense,Fusion India Restaurant,Balapavan Tirumani,Meals & Entertainment,14.5,53521627.51
02/23/2024,Expense,Transport for NSW,Balapavan Tirumani,Travelling Expenses,3.79,53521631.3
02/23/2024,Expense,Fusion India Restaurant,Balapavan Tirumani,Credit Card - Ramp,14.5,53521645.8
02/23/2024,Expense,Fusion India Restaurant,Balapavan Tirumani,Credit Card - Ramp,14.5,53521660.3
02/23/2024,Expense,Big Beat Australia,Balapavan Tirumani,Credit Card - Ramp,3.42,53521663.72
02/23/2024,Expense,Makaveli,Mike ross,Credit Card - Ramp,15.51,53521679.23
02/23/2024,Expense,Makaveli,Mike ross,Credit Card - Ramp,15.51,53521694.74
02/23/2024,Expense,Eventbrite,Balapavan Tirumani,Credit Card - Ramp,22.6,53521717.34
02/23/2024,Expense,Big Beat Australia,Balapavan Tirumani,Credit Card - Ramp,3.42,53521720.76
02/23/2024,Expense,Fusion India Restaurant,Balapavan Tirumani,Credit Card - Ramp,14.5,53521735.26
02/23/2024,Expense,Transport for NSW,Balapavan Tirumani,Credit Card - Ramp,3.79,53521739.05
02/23/2024,Expense,Fusion India Restaurant,Balapavan Tirumani,Meals & Entertainment,14.5,53521753.55
02/23/2024,Expense,Big Beat Australia,Balapavan Tirumani,Meals & Entertainment,3.42,53521756.97
02/23/2024,Expense,Transport for NSW,Balapavan Tirumani,Credit Card - Ramp,3.79,53521760.76
02/23/2024,Expense,Eventbrite,Balapavan Tirumani,Credit Card - Ramp,22.6,53521783.36
02/23/2024,Expense,Eventbrite,Balapavan Tirumani,Tools & Subscription - G&A,22.6,53521805.96
02/23/2024,Expense,Careem,Harvey Spector,Credit Card - Ramp,6.59,53521812.55
02/23/2024,Expense,Transport for NSW,Balapavan Tirumani,Travelling Expenses,3.79,53521816.34
02/23/2024,Expense,Eventbrite,Balapavan Tirumani,Tools & Subscription - G&A,22.6,53521838.94
02/23/2024,Expense,Big Beat Australia,Balapavan Tirumani,Meals & Entertainment,3.42,53521842.36
02/23/2024,Expense,Transport for NSW,Balapavan Tirumani,Travelling Expenses,3.79,53521846.15
02/24/2024,Expense,Best Kebab Restaurant,Balapavan Tirumani,Credit Card - Ramp,12.55,53521858.7
02/24/2024,Expense,Star Corner,Balapavan Tirumani,Meals & Entertainment,6.58,53521865.28
02/24/2024,Expense,Uber,Mike ross,Credit Card - Ramp,13.7,53521878.98
02/24/2024,Expense,Star Corner,Balapavan Tirumani,Credit Card - Ramp,6.58,53521885.56
02/24/2024,Expense,Careem,Harvey Spector,Credit Card - Ramp,10.28,53521895.84
02/24/2024,Expense,Best Kebab Restaurant,Balapavan Tirumani,Meals & Entertainment,12.55,53521908.39
02/24/2024,Expense,Star Corner,Balapavan Tirumani,Credit Card - Ramp,6.58,53521914.97
02/24/2024,Expense,Best Kebab Restaurant,Balapavan Tirumani,Credit Card - Ramp,12.55,53521927.52
02/24/2024,Expense,Careem,Harvey Spector,Travelling Expenses,10.28,53521937.8
02/24/2024,Expense,Star Corner,Balapavan Tirumani,Meals & Entertainment,6.58,53521944.38
02/24/2024,Expense,Star Corner,Balapavan Tirumani,Meals & Entertainment,6.58,53521950.96
02/24/2024,Expense,Felt,Harvey Spector,Tools & Subscription - G&A,36,53521986.96
02/24/2024,Expense,Best Kebab Restaurant,Balapavan Tirumani,Meals & Entertainment,12.55,53521999.51
02/24/2024,Expense,Careem,Harvey Spector,Travelling Expenses,10.28,53522009.79
02/24/2024,Expense,Best Kebab Restaurant,Balapavan Tirumani,Credit Card - Ramp,12.55,53522022.34
02/24/2024,Expense,Felt,Harvey Spector,Tools & Subscription - G&A,36,53522058.34
02/24/2024,Expense,Star Corner,Balapavan Tirumani,Credit Card - Ramp,6.58,53522064.92
02/24/2024,Expense,Best Kebab Restaurant,Balapavan Tirumani,Meals & Entertainment,12.55,53522077.47
02/24/2024,Expense,Uber,Mike ross,Travelling Expenses,13.7,53522091.17
02/24/2024,Expense,Careem,Harvey Spector,Travelling Expenses,10.28,53522101.45
02/24/2024,Expense,Uber,Mike ross,Travelling Expenses,13.7,53522115.15
02/24/2024,Expense,Felt,Harvey Spector,Tools & Subscription - G&A,36,53522151.15
02/24/2024,Expense,Felt,Harvey Spector,Credit Card - Ramp,36,53522187.15
02/24/2024,Expense,Felt,Harvey Spector,Credit Card - Ramp,36,53522223.15
02/24/2024,Expense,Careem,Harvey Spector,Travelling Expenses,10.28,53522233.43
02/24/2024,Expense,Star Corner,Balapavan Tirumani,Meals & Entertainment,6.58,53522240.01
02/24/2024,Expense,Careem,Harvey Spector,Credit Card - Ramp,10.28,53522250.29
02/24/2024,Expense,Felt,Harvey Spector,Credit Card - Ramp,36,53522286.29
02/24/2024,Expense,Uber,Mike ross,Travelling Expenses,13.7,53522299.99
02/24/2024,Expense,Careem,Harvey Spector,Credit Card - Ramp,10.28,53522310.27
02/24/2024,Expense,Best Kebab Restaurant,Balapavan Tirumani,Credit Card - Ramp,12.55,53522322.82
02/24/2024,Expense,Best Kebab Restaurant,Balapavan Tirumani,Meals & Entertainment,12.55,53522335.37
02/24/2024,Expense,Uber,Mike ross,Credit Card - Ramp,13.7,53522349.07
02/24/2024,Expense,Uber,Mike ross,Credit Card - Ramp,13.7,53522362.77
02/24/2024,Expense,Uber,Mike ross,Travelling Expenses,13.7,53522376.47
02/24/2024,Expense,Felt,Harvey Spector,Tools & Subscription - G&A,36,53522412.47
02/24/2024,Expense,Star Corner,Balapavan Tirumani,Credit Card - Ramp,6.58,53522419.05
02/25/2024,Expense,Fusion India Restaurant,Balapavan Tirumani,Meals & Entertainment,17.21,53522436.26
02/25/2024,Expense,Visabot,Harvey Spector,Credit Card - Ramp,56.09,53522492.35
02/25/2024,Expense,Visabot,Harvey Spector,Credit Card - Ramp,56.09,53522548.44
02/25/2024,Expense,Detour Espresso,Balapavan Tirumani,Meals & Entertainment,9.94,53522558.38
02/25/2024,Expense,Visabot,Harvey Spector,General business expenses,56.09,53522614.47
02/25/2024,Expense,Careem Plus,Harvey Spector,Travelling Expenses,5.33,53522619.8
02/25/2024,Expense,Detour Espresso,Balapavan Tirumani,Credit Card - Ramp,9.94,53522629.74
02/25/2024,Expense,Fusion India Restaurant,Balapavan Tirumani,Credit Card - Ramp,2.75,53522632.49
02/25/2024,Expense,Careem Plus,Harvey Spector,Travelling Expenses,5.33,53522637.82
02/25/2024,Expense,Fusion India Restaurant,Balapavan Tirumani,Meals & Entertainment,17.21,53522655.03
02/25/2024,Expense,Detour Espresso,Balapavan Tirumani,Meals & Entertainment,9.94,53522664.97
02/25/2024,Expense,Careem Plus,Harvey Spector,Credit Card - Ramp,5.33,53522670.3
02/25/2024,Expense,Visabot,Harvey Spector,General business expenses,56.09,53522726.39
02/25/2024,Expense,Careem Plus,Harvey Spector,Travelling Expenses,5.33,53522731.72
02/25/2024,Expense,Fusion India Restaurant,Balapavan Tirumani,Meals & Entertainment,2.75,53522734.47
02/25/2024,Expense,Fusion India Restaurant,Balapavan Tirumani,Meals & Entertainment,17.21,53522751.68
02/25/2024,Expense,Fusion India Restaurant,Balapavan Tirumani,Credit Card - Ramp,17.21,53522768.89
02/25/2024,Expense,Fusion India Restaurant,Balapavan Tirumani,Meals & Entertainment,2.75,53522771.64
02/25/2024,Expense,Fusion India Restaurant,Balapavan Tirumani,Meals & Entertainment,2.75,53522774.39
02/25/2024,Expense,Detour Espresso,Balapavan Tirumani,Meals & Entertainment,9.94,53522784.33
02/25/2024,Expense,Careem Plus,Harvey Spector,Travelling Expenses,5.33,53522789.66
02/25/2024,Expense,Visabot,Harvey Spector,General business expenses,56.09,53522845.75
02/25/2024,Expense,Detour Espresso,Balapavan Tirumani,Credit Card - Ramp,9.94,53522855.69
02/25/2024,Expense,Detour Espresso,Balapavan Tirumani,Credit Card - Ramp,9.94,53522865.63
02/25/2024,Expense,Visabot,Harvey Spector,Credit Card - Ramp,56.09,53522921.72
02/25/2024,Expense,Careem Plus,Harvey Spector,Credit Card - Ramp,5.33,53522927.05
02/25/2024,Expense,Visabot,Harvey Spector,Credit Card - Ramp,56.09,53522983.14
02/25/2024,Expense,Visabot,Harvey Spector,General business expenses,56.09,53523039.23
02/25/2024,Expense,Careem Plus,Harvey Spector,Credit Card - Ramp,5.33,53523044.56
02/25/2024,Expense,Fusion India Restaurant,Balapavan Tirumani,Credit Card - Ramp,2.75,53523047.31
02/25/2024,Expense,Detour Espresso,Balapavan Tirumani,Meals & Entertainment,9.94,53523057.25
02/25/2024,Expense,Fusion India Restaurant,Balapavan Tirumani,Credit Card - Ramp,2.75,53523060
02/25/2024,Expense,Detour Espresso,Balapavan Tirumani,Credit Card - Ramp,9.94,53523069.94
02/25/2024,Expense,Fusion India Restaurant,Balapavan Tirumani,Credit Card - Ramp,17.21,53523087.15
02/25/2024,Expense,Fusion India Restaurant,Balapavan Tirumani,Credit Card - Ramp,2.75,53523089.9
02/25/2024,Expense,Fusion India Restaurant,Balapavan Tirumani,Credit Card - Ramp,17.21,53523107.11
02/25/2024,Expense,Fusion India Restaurant,Balapavan Tirumani,Credit Card - Ramp,17.21,53523124.32
02/25/2024,Expense,Fusion India Restaurant,Balapavan Tirumani,Meals & Entertainment,17.21,53523141.53
02/25/2024,Expense,Fusion India Restaurant,Balapavan Tirumani,Meals & Entertainment,2.75,53523144.28
02/26/2024,Expense,FedEx,Harvey Spector,General business expenses,73.39,53523217.67
02/26/2024,Expense,Uber,Mike ross,Credit Card - Ramp,51.58,53523269.25
02/26/2024,Expense,Detour Espresso,Balapavan Tirumani,Meals & Entertainment,8.57,53523277.82
02/26/2024,Expense,Stately.ai,Mike ross,Tools & Subscription - G&A,141.61,53523419.43
02/26/2024,Expense,Stately.ai,Mike ross,Tools & Subscription - G&A,141.61,53523561.04
02/26/2024,Expense,Coles 0583,Balapavan Tirumani,Meals & Entertainment,43.4,53523604.44
02/26/2024,Expense,FedEx,Harvey Spector,Credit Card - Ramp,73.39,53523677.83
02/26/2024,Expense,Detour Espresso,Balapavan Tirumani,Credit Card - Ramp,8.57,53523686.4
02/26/2024,Expense,Uber,Mike ross,Travelling Expenses,51.58,53523737.98
02/26/2024,Expense,Coles 0583,Balapavan Tirumani,Credit Card - Ramp,43.4,53523781.38
02/26/2024,Expense,Stately.ai,Mike ross,Tools & Subscription - G&A,141.61,53523922.99
02/26/2024,Expense,Uber,Mike ross,Travelling Expenses,51.58,53523974.57
02/26/2024,Expense,FedEx,Harvey Spector,General business expenses,73.39,53524047.96
02/26/2024,Expense,Detour Espresso,Balapavan Tirumani,Credit Card - Ramp,8.57,53524056.53
02/26/2024,Expense,Coles 0583,Balapavan Tirumani,Credit Card - Ramp,43.4,53524099.93
02/26/2024,Expense,Paperlike,Mike ross,General business expenses,23.05,53524122.98
02/26/2024,Expense,Paperlike,Mike ross,General business expenses,23.05,53524146.03
02/26/2024,Expense,Coles 0583,Balapavan Tirumani,Credit Card - Ramp,43.4,53524189.43
02/26/2024,Expense,Detour Espresso,Balapavan Tirumani,Credit Card - Ramp,8.57,53524198
02/26/2024,Expense,Stately.ai,Mike ross,Credit Card - Ramp,141.61,53524339.61
02/26/2024,Expense,Paperlike,Mike ross,General business expenses,23.05,53524362.66
02/26/2024,Expense,Detour Espresso,Balapavan Tirumani,Meals & Entertainment,8.57,53524371.23
02/26/2024,Expense,Stately.ai,Mike ross,Credit Card - Ramp,141.61,53524512.84
02/26/2024,Expense,FedEx,Harvey Spector,Credit Card - Ramp,73.39,53524586.23
02/26/2024,Expense,Paperlike,Mike ross,Credit Card - Ramp,23.05,53524609.28
02/26/2024,Expense,Stately.ai,Mike ross,Tools & Subscription - G&A,141.61,53524750.89
02/26/2024,Expense,Stately.ai,Mike ross,Credit Card - Ramp,141.61,53524892.5
02/26/2024,Expense,Uber,Mike ross,Credit Card - Ramp,51.58,53524944.08
02/26/2024,Expense,Paperlike,Mike ross,Credit Card - Ramp,23.05,53524967.13
02/26/2024,Expense,FedEx,Harvey Spector,Credit Card - Ramp,73.39,53525040.52
02/26/2024,Expense,Paperlike,Mike ross,Credit Card - Ramp,23.05,53525063.57
02/26/2024,Expense,Coles 0583,Balapavan Tirumani,Meals & Entertainment,43.4,53525106.97
02/26/2024,Expense,Coles 0583,Balapavan Tirumani,Credit Card - Ramp,43.4,53525150.37
02/26/2024,Expense,FedEx,Harvey Spector,General business expenses,73.39,53525223.76
02/26/2024,Expense,Coles 0583,Balapavan Tirumani,Meals & Entertainment,43.4,53525267.16
02/26/2024,Expense,FedEx,Harvey Spector,Credit Card - Ramp,73.39,53525340.55
02/26/2024,Expense,Detour Espresso,Balapavan Tirumani,Meals & Entertainment,8.57,53525349.12
02/26/2024,Expense,Uber,Mike ross,Credit Card - Ramp,51.58,53525400.7
02/26/2024,Expense,Detour Espresso,Balapavan Tirumani,Meals & Entertainment,8.57,53525409.27
02/26/2024,Expense,Detour Espresso,Balapavan Tirumani,Credit Card - Ramp,8.57,53525417.84
02/26/2024,Expense,Uber,Mike ross,Travelling Expenses,51.58,53525469.42
02/26/2024,Expense,Coles 0583,Balapavan Tirumani,Meals & Entertainment,43.4,53525512.82
02/26/2024,Expense,FedEx,Harvey Spector,General business expenses,73.39,53525586.21
02/26/2024,Expense,Paperlike,Mike ross,General business expenses,23.05,53525609.26
02/26/2024,Expense,Uber,Mike ross,Travelling Expenses,51.58,53525660.84
02/26/2024,Expense,Paperlike,Mike ross,Credit Card - Ramp,23.05,53525683.89
02/27/2024,Expense,Sentry,Balapavan Tirumani,Tools & Subscription - G&A,29,53525712.89
02/27/2024,Expense,Detour Espresso,Balapavan Tirumani,Credit Card - Ramp,8.74,53525721.63
02/27/2024,Expense,Detour Espresso,Balapavan Tirumani,Credit Card - Ramp,8.74,53525730.37
02/27/2024,Expense,Detour Espresso,Balapavan Tirumani,Credit Card - Ramp,5.47,53525735.84
02/27/2024,Expense,Sendinblue,Balapavan Tirumani,Tools & Subscription - G&A,78.65,53525814.49
02/27/2024,Expense,Sendinblue,Balapavan Tirumani,Credit Card - Ramp,78.65,53525893.14
02/27/2024,Expense,Splitbee,Harris Jose,Credit Card - Ramp,16.52,53525909.66
02/27/2024,Expense,,Corp E Corp,Account1,-2850,53523059.66
02/27/2024,Expense,Sentry,Balapavan Tirumani,Tools & Subscription - G&A,29,53523088.66
02/27/2024,Expense,Detour Espresso,Balapavan Tirumani,Meals & Entertainment,5.47,53523094.13
02/27/2024,Expense,Detour Espresso,Balapavan Tirumani,Meals & Entertainment,8.74,53523102.87
02/27/2024,Expense,Detour Espresso,Balapavan Tirumani,Meals & Entertainment,8.74,53523111.61
02/27/2024,Expense,Careem,Harvey Spector,Travelling Expenses,15.79,53523127.4
02/27/2024,Expense,Careem,Harvey Spector,Travelling Expenses,15.79,53523143.19
02/27/2024,Expense,Sendinblue,Balapavan Tirumani,Tools & Subscription - G&A,78.65,53523221.84
02/27/2024,Expense,Detour Espresso,Balapavan Tirumani,Credit Card - Ramp,5.47,53523227.31
02/27/2024,Expense,Detour Espresso,Balapavan Tirumani,Meals & Entertainment,8.74,53523236.05
02/27/2024,Expense,Detour Espresso,Balapavan Tirumani,Credit Card - Ramp,5.47,53523241.52
02/27/2024,Expense,,Corp E Corp,Delaware Corporation Tax Payable,-2850,53520391.52
02/27/2024,Expense,Detour Espresso,Balapavan Tirumani,Meals & Entertainment,5.47,53520396.99
02/27/2024,Expense,Splitbee,Harris Jose,Tools & Subscription - G&A,16.52,53520413.51
02/27/2024,Expense,Splitbee,Harris Jose,Tools & Subscription - G&A,16.52,53520430.03
02/27/2024,Expense,Detour Espresso,Balapavan Tirumani,Credit Card - Ramp,8.74,53520438.77
02/27/2024,Expense,Sendinblue,Balapavan Tirumani,Tools & Subscription - G&A,78.65,53520517.42
02/27/2024,Expense,Sentry,Balapavan Tirumani,Tools & Subscription - G&A,29,53520546.42
02/27/2024,Expense,Detour Espresso,Balapavan Tirumani,Meals & Entertainment,8.74,53520555.16
02/27/2024,Expense,,Corp E Corp,Account1,-2850,53517705.16
02/27/2024,Expense,Detour Espresso,Balapavan Tirumani,Credit Card - Ramp,5.47,53517710.63
02/27/2024,Expense,Careem,Harvey Spector,Travelling Expenses,15.79,53517726.42
02/27/2024,Expense,Sendinblue,Balapavan Tirumani,Credit Card - Ramp,78.65,53517805.07
02/27/2024,Expense,Splitbee,Harris Jose,Credit Card - Ramp,16.52,53517821.59
02/27/2024,Expense,Sendinblue,Balapavan Tirumani,Tools & Subscription - G&A,78.65,53517900.24
02/27/2024,Expense,Detour Espresso,Balapavan Tirumani,Meals & Entertainment,5.47,53517905.71
02/27/2024,Expense,Sentry,Balapavan Tirumani,Tools & Subscription - G&A,29,53517934.71
02/27/2024,Expense,Careem,Harvey Spector,Credit Card - Ramp,15.79,53517950.5
02/27/2024,Expense,,Corp E Corp,Account1,-2850,53515100.5
02/27/2024,Expense,,Corp E Corp,Delaware Corporation Tax Payable,-2850,53512250.5
02/27/2024,Expense,Careem,Harvey Spector,Travelling Expenses,15.79,53512266.29
02/27/2024,Expense,Splitbee,Harris Jose,Tools & Subscription - G&A,16.52,53512282.81
02/27/2024,Expense,Sentry,Balapavan Tirumani,Credit Card - Ramp,29,53512311.81
02/27/2024,Expense,Careem,Harvey Spector,Credit Card - Ramp,15.79,53512327.6
02/27/2024,Expense,Splitbee,Harris Jose,Tools & Subscription - G&A,16.52,53512344.12
02/27/2024,Expense,Detour Espresso,Balapavan Tirumani,Credit Card - Ramp,8.74,53512352.86
02/27/2024,Expense,Sendinblue,Balapavan Tirumani,Credit Card - Ramp,78.65,53512431.51
02/27/2024,Expense,,Corp E Corp,Delaware Corporation Tax Payable,-2850,53509581.51
02/27/2024,Expense,,Corp E Corp,Account1,-2850,53506731.51
02/27/2024,Expense,Detour Espresso,Balapavan Tirumani,Meals & Entertainment,5.47,53506736.98
02/27/2024,Expense,Sentry,Balapavan Tirumani,Credit Card - Ramp,29,53506765.98
02/27/2024,Expense,,Corp E Corp,Delaware Corporation Tax Payable,-2850,53503915.98
02/27/2024,Expense,Careem,Harvey Spector,Credit Card - Ramp,15.79,53503931.77
02/27/2024,Expense,Sentry,Balapavan Tirumani,Credit Card - Ramp,29,53503960.77
02/27/2024,Expense,Splitbee,Harris Jose,Credit Card - Ramp,16.52,53503977.29
02/28/2024,Expense,Gumrd,Harvey Spector,General business expenses:Memberships & subscriptions,10,53503987.29
02/28/2024,Expense,Github,Balapavan Tirumani,Tools & Subscription - G&A,10,53503997.29
02/28/2024,Expense,Github,Balapavan Tirumani,Credit Card - Ramp,10,53504007.29
02/28/2024,Expense,MenubarX,Harvey Spector,Tools & Subscription - G&A,4.99,53504012.28
02/28/2024,Expense,Gumrd,Harvey Spector,Credit Card - Ramp,10,53504022.28
02/28/2024,Expense,Gumrd,Harvey Spector,General business expenses:Memberships & subscriptions,10,53504032.28
02/28/2024,Expense,Swish,Harvey Spector,Tools & Subscription - G&A,16,53504048.28
02/28/2024,Expense,Ninjadog,Anik Das,Credit Card - Ramp,39.16,53504087.44
02/28/2024,Expense,Gumrd,Harvey Spector,Credit Card - Ramp,10,53504097.44
02/28/2024,Expense,Ninjadog,Anik Das,Tools & Subscription - G&A,39.16,53504136.6
02/28/2024,Expense,Github,Balapavan Tirumani,Tools & Subscription - G&A,44,53504180.6
02/28/2024,Expense,The Bogey Hole Cafe,Mike ross,Meals & Entertainment,26.28,53504206.88
02/28/2024,Expense,Gumrd,Harvey Spector,Credit Card - Ramp,10,53504216.88
02/28/2024,Expense,Swish,Harvey Spector,Credit Card - Ramp,16,53504232.88
02/28/2024,Expense,Smp On The Run Mart,Balapavan Tirumani,Meals & Entertainment,4.12,53504237
02/28/2024,Expense,Mtw,Harvey Spector,Tools & Subscription - G&A,21,53504258
02/28/2024,Expense,MenubarX,Harvey Spector,Tools & Subscription - G&A,4.99,53504262.99
02/28/2024,Expense,Fusion India Restaurant,Balapavan Tirumani,Meals & Entertainment,14.42,53504277.41
02/28/2024,Expense,The Bogey Hole Cafe,Mike ross,Meals & Entertainment,26.28,53504303.69
02/28/2024,Expense,Fusion India Restaurant,Balapavan Tirumani,Credit Card - Ramp,14.42,53504318.11
02/28/2024,Expense,Mtw,Harvey Spector,Tools & Subscription - G&A,21,53504339.11
02/28/2024,Expense,Mtw,Harvey Spector,Credit Card - Ramp,21,53504360.11
02/28/2024,Expense,Detour Espresso,Balapavan Tirumani,Meals & Entertainment,6.27,53504366.38
02/28/2024,Expense,Ninjadog,Anik Das,Credit Card - Ramp,39.16,53504405.54
02/28/2024,Expense,Swish,Harvey Spector,Credit Card - Ramp,16,53504421.54
02/28/2024,Expense,MenubarX,Harvey Spector,Tools & Subscription - G&A,4.99,53504426.53
02/28/2024,Expense,MenubarX,Harvey Spector,Credit Card - Ramp,4.99,53504431.52
02/28/2024,Expense,Github,Balapavan Tirumani,Credit Card - Ramp,44,53504475.52
02/28/2024,Expense,Detour Espresso,Balapavan Tirumani,Meals & Entertainment,6.27,53504481.79
02/28/2024,Expense,The Bogey Hole Cafe,Mike ross,Credit Card - Ramp,26.28,53504508.07
02/28/2024,Expense,Github,Balapavan Tirumani,Credit Card - Ramp,10,53504518.07
02/28/2024,Expense,Gumrd,Harvey Spector,General business expenses:Memberships & subscriptions,10,53504528.07
02/28/2024,Expense,Detour Espresso,Balapavan Tirumani,Credit Card - Ramp,6.27,53504534.34
02/28/2024,Expense,MenubarX,Harvey Spector,Credit Card - Ramp,4.99,53504539.33
02/28/2024,Expense,Github,Balapavan Tirumani,Tools & Subscription - G&A,10,53504549.33
02/28/2024,Expense,Fusion India Restaurant,Balapavan Tirumani,Meals & Entertainment,14.42,53504563.75
02/28/2024,Expense,Github,Balapavan Tirumani,Tools & Subscription - G&A,44,53504607.75
02/28/2024,Expense,The Bogey Hole Cafe,Mike ross,Meals & Entertainment,26.28,53504634.03
02/28/2024,Expense,Smp On The Run Mart,Balapavan Tirumani,Credit Card - Ramp,4.12,53504638.15
02/28/2024,Expense,Github,Balapavan Tirumani,Tools & Subscription - G&A,44,53504682.15
02/28/2024,Expense,Detour Espresso,Balapavan Tirumani,Meals & Entertainment,6.27,53504688.42
02/28/2024,Expense,Github,Balapavan Tirumani,Tools & Subscription - G&A,10,53504698.42
02/28/2024,Expense,Github,Balapavan Tirumani,Credit Card - Ramp,44,53504742.42
02/28/2024,Expense,Github,Balapavan Tirumani,Credit Card - Ramp,10,53504752.42
02/28/2024,Expense,Detour Espresso,Balapavan Tirumani,Credit Card - Ramp,6.27,53504758.69
02/28/2024,Expense,The Bogey Hole Cafe,Mike ross,Credit Card - Ramp,26.28,53504784.97
02/28/2024,Expense,Gumrd,Harvey Spector,Credit Card - Ramp,10,53504794.97
02/28/2024,Expense,Github,Balapavan Tirumani,Tools & Subscription - G&A,10,53504804.97
02/28/2024,Expense,Detour Espresso,Balapavan Tirumani,Credit Card - Ramp,6.27,53504811.24
02/28/2024,Expense,Smp On The Run Mart,Balapavan Tirumani,Credit Card - Ramp,4.12,53504815.36
02/28/2024,Expense,Mtw,Harvey Spector,Credit Card - Ramp,21,53504836.36
02/28/2024,Expense,Fusion India Restaurant,Balapavan Tirumani,Credit Card - Ramp,14.42,53504850.78
02/28/2024,Expense,MenubarX,Harvey Spector,Tools & Subscription - G&A,4.99,53504855.77
02/28/2024,Expense,Gumrd,Harvey Spector,General business expenses:Memberships & subscriptions,10,53504865.77
02/28/2024,Expense,Github,Balapavan Tirumani,Credit Card - Ramp,44,53504909.77
02/28/2024,Expense,Fusion India Restaurant,Balapavan Tirumani,Meals & Entertainment,14.42,53504924.19
02/28/2024,Expense,Fusion India Restaurant,Balapavan Tirumani,Meals & Entertainment,14.42,53504938.61
02/28/2024,Expense,Smp On The Run Mart,Balapavan Tirumani,Meals & Entertainment,4.12,53504942.73
02/28/2024,Expense,Mtw,Harvey Spector,Tools & Subscription - G&A,21,53504963.73
02/28/2024,Expense,The Bogey Hole Cafe,Mike ross,Meals & Entertainment,26.28,53504990.01
02/28/2024,Expense,The Bogey Hole Cafe,Mike ross,Credit Card - Ramp,26.28,53505016.29
02/28/2024,Expense,Ninjadog,Anik Das,Credit Card - Ramp,39.16,53505055.45
02/28/2024,Expense,Github,Balapavan Tirumani,Tools & Subscription - G&A,44,53505099.45
02/28/2024,Expense,MenubarX,Harvey Spector,Credit Card - Ramp,4.99,53505104.44
02/28/2024,Expense,Swish,Harvey Spector,Credit Card - Ramp,16,53505120.44
02/28/2024,Expense,Smp On The Run Mart,Balapavan Tirumani,Meals & Entertainment,4.12,53505124.56
02/28/2024,Expense,Ninjadog,Anik Das,Tools & Subscription - G&A,39.16,53505163.72
02/28/2024,Expense,Detour Espresso,Balapavan Tirumani,Meals & Entertainment,6.27,53505169.99
02/28/2024,Expense,Smp On The Run Mart,Balapavan Tirumani,Credit Card - Ramp,4.12,53505174.11
02/28/2024,Expense,Mtw,Harvey Spector,Credit Card - Ramp,21,53505195.11
02/28/2024,Expense,Fusion India Restaurant,Balapavan Tirumani,Credit Card - Ramp,14.42,53505209.53
02/28/2024,Expense,Smp On The Run Mart,Balapavan Tirumani,Credit Card - Ramp,4.12,53505213.65
02/28/2024,Expense,Swish,Harvey Spector,Tools & Subscription - G&A,16,53505229.65
02/28/2024,Expense,Ninjadog,Anik Das,Tools & Subscription - G&A,39.16,53505268.81
02/28/2024,Expense,Swish,Harvey Spector,Tools & Subscription - G&A,16,53505284.81
02/28/2024,Expense,Fusion India Restaurant,Balapavan Tirumani,Credit Card - Ramp,14.42,53505299.23
02/28/2024,Expense,The Bogey Hole Cafe,Mike ross,Credit Card - Ramp,26.28,53505325.51
02/28/2024,Expense,Mtw,Harvey Spector,Tools & Subscription - G&A,21,53505346.51
02/28/2024,Expense,Swish,Harvey Spector,Tools & Subscription - G&A,16,53505362.51
02/28/2024,Expense,Ninjadog,Anik Das,Tools & Subscription - G&A,39.16,53505401.67
02/28/2024,Expense,Detour Espresso,Balapavan Tirumani,Credit Card - Ramp,6.27,53505407.94
02/28/2024,Expense,Smp On The Run Mart,Balapavan Tirumani,Meals & Entertainment,4.12,53505412.06
02/29/2024,Bill,Big Company ,"Service Expenses for the month of February 2024 
INR   28,61,090   @ 82.0967",Accounts Payable (A/P),34510,53539922.06
02/29/2024,Bill,Big Company ,"Service Expenses for the month of February 2024 
INR   28,61,090   @ 82.0967",Accounts Payable (A/P),34510,53574432.06
02/29/2024,Expense,Fusion India Restaurant,Balapavan Tirumani,Meals & Entertainment,18.52,53574450.58
02/29/2024,Expense,Uber,Mike ross,Travelling Expenses,16.57,53574467.15
02/29/2024,Expense,Mx2Games,Anik Das,Tools & Subscription - G&A,96.47,53574563.62
02/29/2024,Expense,Uber,Mike ross,Travelling Expenses,16.57,53574580.19
02/29/2024,Expense,Mx2Games,Anik Das,Tools & Subscription - G&A,96.47,53574676.66
02/29/2024,Expense,Detour Espresso,Balapavan Tirumani,Meals & Entertainment,2.26,53574678.92
02/29/2024,Expense,Uber,Mike ross,Travelling Expenses,16.57,53574695.49
02/29/2024,Expense,Detour Espresso,Balapavan Tirumani,Meals & Entertainment,2.26,53574697.75
02/29/2024,Expense,Fusion India Restaurant,Balapavan Tirumani,Meals & Entertainment,18.52,53574716.27
02/29/2024,Expense,inkle,Harvey Spector,Tools & Subscription - G&A,30,53574746.27
02/29/2024,Expense,inkle,Harvey Spector,Credit Card - Ramp,30,53574776.27
02/29/2024,Expense,Fusion India Restaurant,Balapavan Tirumani,Meals & Entertainment,2.4,53574778.67
02/29/2024,Expense,Mx2Games,Anik Das,Tools & Subscription - G&A,96.47,53574875.14
02/29/2024,Expense,Apify,Harvey Spector,Credit Card - Ramp,34.3,53574909.44
02/29/2024,Expense,inkle,Harvey Spector,Tools & Subscription - G&A,30,53574939.44
02/29/2024,Expense,Uber,Mike ross,Credit Card - Ramp,16.57,53574956.01
02/29/2024,Expense,Apify,Harvey Spector,Tools & Subscription - G&A,34.3,53574990.31
02/29/2024,Expense,Detour Espresso,Balapavan Tirumani,Credit Card - Ramp,6.27,53574996.58
02/29/2024,Expense,Uber,Mike ross,Credit Card - Ramp,16.57,53575013.15
02/29/2024,Expense,Detour Espresso,Balapavan Tirumani,Meals & Entertainment,6.27,53575019.42
02/29/2024,Bill,Big Company ,,Outsources Services - India,34510,53609529.42
02/29/2024,Expense,Fusion India Restaurant,Balapavan Tirumani,Credit Card - Ramp,18.52,53609547.94
02/29/2024,Expense,Mx2Games,Anik Das,Credit Card - Ramp,96.47,53609644.41
02/29/2024,Expense,Apify,Harvey Spector,Tools & Subscription - G&A,34.3,53609678.71
02/29/2024,Expense,Fusion India Restaurant,Balapavan Tirumani,Credit Card - Ramp,2.4,53609681.11
02/29/2024,Bill,Big Company ,"Service Expenses for the month of February 2024 
INR   28,61,090   @ 82.0967",Accounts Payable (A/P),34510,53644191.11
02/29/2024,Expense,Detour Espresso,Balapavan Tirumani,Credit Card - Ramp,2.26,53644193.37
02/29/2024,Expense,Mx2Games,Anik Das,Credit Card - Ramp,96.47,53644289.84
02/29/2024,Expense,Detour Espresso,Balapavan Tirumani,Meals & Entertainment,2.26,53644292.1
02/29/2024,Bill,Big Company ,,Outsources Services - India,34510,53678802.1
02/29/2024,Expense,Fusion India Restaurant,Balapavan Tirumani,Meals & Entertainment,2.4,53678804.5
02/29/2024,Expense,Apify,Harvey Spector,Credit Card - Ramp,34.3,53678838.8
02/29/2024,Expense,Fusion India Restaurant,Balapavan Tirumani,Meals & Entertainment,2.4,53678841.2
02/29/2024,Expense,Fusion India Restaurant,Balapavan Tirumani,Meals & Entertainment,18.52,53678859.72
02/29/2024,Bill,Big Company ,,Outsources Services - India,34510,53713369.72
02/29/2024,Expense,Detour Espresso,Balapavan Tirumani,Credit Card - Ramp,2.26,53713371.98
02/29/2024,Expense,Mx2Games,Anik Das,Credit Card - Ramp,96.47,53713468.45
02/29/2024,Expense,Apify,Harvey Spector,Credit Card - Ramp,34.3,53713502.75
02/29/2024,Expense,inkle,Harvey Spector,Credit Card - Ramp,30,53713532.75
02/29/2024,Bill,Big Company ,,Outsources Services - India,34510,53748042.75
02/29/2024,Expense,Fusion India Restaurant,Balapavan Tirumani,Credit Card - Ramp,2.4,53748045.15
02/29/2024,Expense,Detour Espresso,Balapavan Tirumani,Credit Card - Ramp,2.26,53748047.41
02/29/2024,Expense,Fusion India Restaurant,Balapavan Tirumani,Credit Card - Ramp,2.4,53748049.81
02/29/2024,Expense,Detour Espresso,Balapavan Tirumani,Credit Card - Ramp,6.27,53748056.08
02/29/2024,Expense,Fusion India Restaurant,Balapavan Tirumani,Credit Card - Ramp,18.52,53748074.6
02/29/2024,Expense,Fusion India Restaurant,Balapavan Tirumani,Credit Card - Ramp,2.4,53748077
02/29/2024,Expense,Fusion India Restaurant,Balapavan Tirumani,Credit Card - Ramp,18.52,53748095.52
02/29/2024,Expense,Detour Espresso,Balapavan Tirumani,Credit Card - Ramp,2.26,53748097.78
02/29/2024,Expense,Fusion India Restaurant,Balapavan Tirumani,Credit Card - Ramp,18.52,53748116.3
02/29/2024,Expense,Detour Espresso,Balapavan Tirumani,Credit Card - Ramp,6.27,53748122.57
02/29/2024,Expense,Detour Espresso,Balapavan Tirumani,Meals & Entertainment,6.27,53748128.84
02/29/2024,Expense,Detour Espresso,Balapavan Tirumani,Credit Card - Ramp,6.27,53748135.11
02/29/2024,Expense,inkle,Harvey Spector,Tools & Subscription - G&A,30,53748165.11
02/29/2024,Expense,Fusion India Restaurant,Balapavan Tirumani,Meals & Entertainment,2.4,53748167.51
02/29/2024,Expense,Apify,Harvey Spector,Tools & Subscription - G&A,34.3,53748201.81
02/29/2024,Bill,Big Company ,"Service Expenses for the month of February 2024 
INR   28,61,090   @ 82.0967",Accounts Payable (A/P),34510,53782711.81
02/29/2024,Expense,Apify,Harvey Spector,Tools & Subscription - G&A,34.3,53782746.11
02/29/2024,Expense,inkle,Harvey Spector,Tools & Subscription - G&A,30,53782776.11
02/29/2024,Expense,inkle,Harvey Spector,Credit Card - Ramp,30,53782806.11
02/29/2024,Expense,Detour Espresso,Balapavan Tirumani,Meals & Entertainment,2.26,53782808.37
02/29/2024,Expense,Mx2Games,Anik Das,Tools & Subscription - G&A,96.47,53782904.84
02/29/2024,Expense,Uber,Mike ross,Travelling Expenses,16.57,53782921.41
02/29/2024,Expense,Detour Espresso,Balapavan Tirumani,Meals & Entertainment,6.27,53782927.68
02/29/2024,Expense,Detour Espresso,Balapavan Tirumani,Meals & Entertainment,6.27,53782933.95
02/29/2024,Expense,Fusion India Restaurant,Balapavan Tirumani,Meals & Entertainment,18.52,53782952.47
02/29/2024,Expense,Uber,Mike ross,Credit Card - Ramp,16.57,53782969.04
03/01/2024,Expense,Sellbrite Digital Llp,Anik Das,Office expenses:Office supplies,21.13,53782990.17
03/01/2024,Expense,Harris Farm Markets,Balapavan Tirumani,Meals & Entertainment,2.69,53782992.86
03/01/2024,Expense,Makuto,Mike ross,Credit Card - Ramp,11.91,53783004.77
03/01/2024,Expense,Supercell,Anik Das,Tools & Subscription - G&A,7.45,53783012.22
03/01/2024,Expense,Netlify,Balapavan Tirumani,Tools & Subscription - G&A,19,53783031.22
03/01/2024,Expense,Harris Farm Markets,Balapavan Tirumani,Credit Card - Ramp,2.69,53783033.91
03/01/2024,Expense,Netlify,Balapavan Tirumani,Credit Card - Ramp,19,53783052.91
03/01/2024,Expense,Cleeng,Harvey Spector,Credit Card - Ramp,18.9,53783071.81
03/01/2024,Expense,Cleeng,Harvey Spector,Credit Card - Ramp,18.9,53783090.71
03/01/2024,Expense,Supercell,Anik Das,Credit Card - Ramp,7.45,53783098.16
03/01/2024,Expense,Liveblocks,Balapavan Tirumani,Credit Card - Ramp,99,53783197.16
03/01/2024,Expense,Makuto,Mike ross,Credit Card - Ramp,11.91,53783209.07
03/01/2024,Expense,Supercell,Anik Das,Credit Card - Ramp,7.45,53783216.52
03/01/2024,Expense,Liveblocks,Balapavan Tirumani,Tools & Subscription - G&A,99,53783315.52
03/01/2024,Expense,Supercell,Anik Das,Tools & Subscription - G&A,7.45,53783322.97
03/01/2024,Expense,Makuto,Mike ross,Meals & Entertainment,11.91,53783334.88
03/01/2024,Expense,Cleeng,Harvey Spector,Tools & Subscription - G&A,18.9,53783353.78
03/01/2024,Expense,Render,Balapavan Tirumani,Tools & Subscription - G&A,289.01,53783642.79
03/01/2024,Expense,Harris Farm Markets,Balapavan Tirumani,Meals & Entertainment,2.69,53783645.48
03/01/2024,Expense,Netlify,Balapavan Tirumani,Tools & Subscription - G&A,19,53783664.48
03/01/2024,Expense,Render,Balapavan Tirumani,Tools & Subscription - G&A,289.01,53783953.49
03/01/2024,Expense,Netlify,Balapavan Tirumani,Tools & Subscription - G&A,19,53783972.49
03/01/2024,Expense,Makuto,Mike ross,Meals & Entertainment,11.91,53783984.4
03/01/2024,Expense,Liveblocks,Balapavan Tirumani,Tools & Subscription - G&A,99,53784083.4
03/01/2024,Expense,Supercell,Anik Das,Tools & Subscription - G&A,7.45,53784090.85
03/01/2024,Expense,Cleeng,Harvey Spector,Tools & Subscription - G&A,18.9,53784109.75
03/01/2024,Expense,Harris Farm Markets,Balapavan Tirumani,Credit Card - Ramp,2.69,53784112.44
03/01/2024,Expense,Sellbrite Digital Llp,Anik Das,Office expenses:Office supplies,21.13,53784133.57
03/01/2024,Expense,Harris Farm Markets,Balapavan Tirumani,Meals & Entertainment,2.69,53784136.26
03/01/2024,Expense,Liveblocks,Balapavan Tirumani,Tools & Subscription - G&A,99,53784235.26
03/01/2024,Expense,Makuto,Mike ross,Meals & Entertainment,11.91,53784247.17
03/01/2024,Expense,Sellbrite Digital Llp,Anik Das,Office expenses:Office supplies,21.13,53784268.3
03/01/2024,Expense,Render,Balapavan Tirumani,Credit Card - Ramp,289.01,53784557.31
03/01/2024,Expense,Liveblocks,Balapavan Tirumani,Tools & Subscription - G&A,99,53784656.31
03/01/2024,Expense,Netlify,Balapavan Tirumani,Credit Card - Ramp,19,53784675.31
03/01/2024,Expense,Liveblocks,Balapavan Tirumani,Credit Card - Ramp,99,53784774.31
03/01/2024,Expense,Makuto,Mike ross,Meals & Entertainment,11.91,53784786.22
03/01/2024,Expense,Sellbrite Digital Llp,Anik Das,Office expenses:Office supplies,21.13,53784807.35
03/01/2024,Expense,Cleeng,Harvey Spector,Tools & Subscription - G&A,18.9,53784826.25
03/01/2024,Expense,Cleeng,Harvey Spector,Credit Card - Ramp,18.9,53784845.15
03/01/2024,Expense,Supercell,Anik Das,Credit Card - Ramp,7.45,53784852.6
03/01/2024,Expense,Render,Balapavan Tirumani,Credit Card - Ramp,289.01,53785141.61
03/01/2024,Expense,Render,Balapavan Tirumani,Tools & Subscription - G&A,289.01,53785430.62
03/01/2024,Expense,Render,Balapavan Tirumani,Credit Card - Ramp,289.01,53785719.63
03/01/2024,Expense,Sellbrite Digital Llp,Anik Das,Credit Card - Ramp,21.13,53785740.76
03/01/2024,Expense,Liveblocks,Balapavan Tirumani,Credit Card - Ramp,99,53785839.76
03/01/2024,Expense,Cleeng,Harvey Spector,Tools & Subscription - G&A,18.9,53785858.66
03/01/2024,Expense,Netlify,Balapavan Tirumani,Credit Card - Ramp,19,53785877.66
03/01/2024,Expense,Supercell,Anik Das,Tools & Subscription - G&A,7.45,53785885.11
03/01/2024,Expense,Render,Balapavan Tirumani,Tools & Subscription - G&A,289.01,53786174.12
03/01/2024,Expense,Harris Farm Markets,Balapavan Tirumani,Meals & Entertainment,2.69,53786176.81
03/01/2024,Expense,Sellbrite Digital Llp,Anik Das,Credit Card - Ramp,21.13,53786197.94
03/01/2024,Expense,Netlify,Balapavan Tirumani,Tools & Subscription - G&A,19,53786216.94
03/01/2024,Expense,Harris Farm Markets,Balapavan Tirumani,Credit Card - Ramp,2.69,53786219.63
03/01/2024,Expense,Makuto,Mike ross,Credit Card - Ramp,11.91,53786231.54
03/01/2024,Expense,Harris Farm Markets,Balapavan Tirumani,Credit Card - Ramp,2.69,53786234.23
03/01/2024,Expense,Sellbrite Digital Llp,Anik Das,Credit Card - Ramp,21.13,53786255.36
03/01/2024,Expense,Sellbrite Digital Llp,Anik Das,Credit Card - Ramp,21.13,53786276.49
03/01/2024,Expense,Makuto,Mike ross,Credit Card - Ramp,11.91,53786288.4
03/02/2024,Expense,Amazon Web Services,Balapavan Tirumani,Office expenses:Office supplies,45.98,53786334.38
03/02/2024,Expense,Fexmon Pty Ltd,Balapavan Tirumani,Meals & Entertainment,2.69,53786337.07
03/02/2024,Expense,June,Balapavan Tirumani,Tools & Subscription - G&A,149,53786486.07
03/02/2024,Expense,Harris Farm Markets,Balapavan Tirumani,Meals & Entertainment,6.59,53786492.66
03/02/2024,Expense,Google G Suite,Mike ross,Tools & Subscription - G&A,104.51,53786597.17
03/02/2024,Expense,Yango,Harvey Spector,Credit Card - Ramp,1.68,53786598.85
03/02/2024,Expense,Careem,Harvey Spector,Credit Card - Ramp,10.09,53786608.94
03/02/2024,Expense,Star Corner,Balapavan Tirumani,Credit Card - Ramp,6.6,53786615.54
03/02/2024,Expense,Harris Farm Markets,Balapavan Tirumani,Credit Card - Ramp,6.59,53786622.13
03/02/2024,Expense,June,Balapavan Tirumani,Tools & Subscription - G&A,149,53786771.13
03/02/2024,Expense,Yango,Harvey Spector,Credit Card - Ramp,1.68,53786772.81
03/02/2024,Expense,Yango,Harvey Spector,Credit Card - Ramp,13.18,53786785.99
03/02/2024,Expense,Star Corner,Balapavan Tirumani,Meals & Entertainment,6.6,53786792.59
03/02/2024,Expense,Fexmon Pty Ltd,Balapavan Tirumani,Credit Card - Ramp,2.69,53786795.28
03/02/2024,Expense,Yango,Harvey Spector,Travelling Expenses,1.68,53786796.96
03/02/2024,Expense,Star Corner,Balapavan Tirumani,Meals & Entertainment,6.6,53786803.56
03/02/2024,Expense,Careem,Harvey Spector,Travelling Expenses,10.09,53786813.65
03/02/2024,Expense,Careem,Harvey Spector,Credit Card - Ramp,10.09,53786823.74
03/02/2024,Expense,Harris Farm Markets,Balapavan Tirumani,Credit Card - Ramp,6.59,53786830.33
03/02/2024,Expense,Fexmon Pty Ltd,Balapavan Tirumani,Credit Card - Ramp,2.69,53786833.02
03/02/2024,Expense,Harris Farm Markets,Balapavan Tirumani,Meals & Entertainment,6.59,53786839.61
03/02/2024,Expense,Amazon Web Services,Balapavan Tirumani,Credit Card - Ramp,45.98,53786885.59
03/02/2024,Expense,Google G Suite,Mike ross,Tools & Subscription - G&A,104.51,53786990.1
03/02/2024,Expense,Yango,Harvey Spector,Travelling Expenses,13.18,53787003.28
03/02/2024,Expense,Google G Suite,Mike ross,Credit Card - Ramp,104.51,53787107.79
03/02/2024,Expense,June,Balapavan Tirumani,Credit Card - Ramp,149,53787256.79
03/02/2024,Expense,Fexmon Pty Ltd,Balapavan Tirumani,Meals & Entertainment,2.69,53787259.48
03/02/2024,Expense,Amazon Web Services,Balapavan Tirumani,Office expenses:Office supplies,45.98,53787305.46
03/02/2024,Expense,Yango,Harvey Spector,Travelling Expenses,13.18,53787318.64
03/02/2024,Expense,Careem,Harvey Spector,Travelling Expenses,10.09,53787328.73
03/02/2024,Expense,Amazon Web Services,Balapavan Tirumani,Credit Card - Ramp,45.98,53787374.71
03/02/2024,Expense,Yango,Harvey Spector,Travelling Expenses,1.68,53787376.39
03/02/2024,Expense,Yango,Harvey Spector,Credit Card - Ramp,13.18,53787389.57
03/02/2024,Expense,Star Corner,Balapavan Tirumani,Credit Card - Ramp,6.6,53787396.17
03/02/2024,Expense,Google G Suite,Mike ross,Credit Card - Ramp,104.51,53787500.68
03/02/2024,Expense,Careem,Harvey Spector,Credit Card - Ramp,10.09,53787510.77
03/02/2024,Expense,Harris Farm Markets,Balapavan Tirumani,Meals & Entertainment,6.59,53787517.36
03/02/2024,Expense,June,Balapavan Tirumani,Tools & Subscription - G&A,149,53787666.36
03/02/2024,Expense,Amazon Web Services,Balapavan Tirumani,Office expenses:Office supplies,45.98,53787712.34
03/02/2024,Expense,Star Corner,Balapavan Tirumani,Meals & Entertainment,6.6,53787718.94
03/02/2024,Expense,Yango,Harvey Spector,Travelling Expenses,1.68,53787720.62
03/02/2024,Expense,Yango,Harvey Spector,Travelling Expenses,13.18,53787733.8
03/02/2024,Expense,Yango,Harvey Spector,Travelling Expenses,1.68,53787735.48
03/02/2024,Expense,Fexmon Pty Ltd,Balapavan Tirumani,Meals & Entertainment,2.69,53787738.17
03/02/2024,Expense,Google G Suite,Mike ross,Tools & Subscription - G&A,104.51,53787842.68
03/02/2024,Expense,Harris Farm Markets,Balapavan Tirumani,Meals & Entertainment,6.59,53787849.27
03/02/2024,Expense,Google G Suite,Mike ross,Tools & Subscription - G&A,104.51,53787953.78
03/02/2024,Expense,June,Balapavan Tirumani,Tools & Subscription - G&A,149,53788102.78
03/02/2024,Expense,Amazon Web Services,Balapavan Tirumani,Office expenses:Office supplies,45.98,53788148.76
03/02/2024,Expense,Careem,Harvey Spector,Travelling Expenses,10.09,53788158.85
03/02/2024,Expense,Careem,Harvey Spector,Travelling Expenses,10.09,53788168.94
03/02/2024,Expense,Star Corner,Balapavan Tirumani,Meals & Entertainment,6.6,53788175.54
03/02/2024,Expense,Yango,Harvey Spector,Travelling Expenses,13.18,53788188.72
03/02/2024,Expense,June,Balapavan Tirumani,Credit Card - Ramp,149,53788337.72
03/02/2024,Expense,Amazon Web Services,Balapavan Tirumani,Credit Card - Ramp,45.98,53788383.7
03/02/2024,Expense,Yango,Harvey Spector,Credit Card - Ramp,13.18,53788396.88
03/02/2024,Expense,Yango,Harvey Spector,Credit Card - Ramp,1.68,53788398.56
03/02/2024,Expense,Amazon Web Services,Balapavan Tirumani,Credit Card - Ramp,45.98,53788444.54
03/02/2024,Expense,Fexmon Pty Ltd,Balapavan Tirumani,Credit Card - Ramp,2.69,53788447.23
03/02/2024,Expense,Harris Farm Markets,Balapavan Tirumani,Credit Card - Ramp,6.59,53788453.82
03/02/2024,Expense,Star Corner,Balapavan Tirumani,Credit Card - Ramp,6.6,53788460.42
03/02/2024,Expense,Harris Farm Markets,Balapavan Tirumani,Credit Card - Ramp,6.59,53788467.01
03/02/2024,Expense,Fexmon Pty Ltd,Balapavan Tirumani,Credit Card - Ramp,2.69,53788469.7
03/02/2024,Expense,Star Corner,Balapavan Tirumani,Credit Card - Ramp,6.6,53788476.3
03/02/2024,Expense,June,Balapavan Tirumani,Credit Card - Ramp,149,53788625.3
03/02/2024,Expense,Google G Suite,Mike ross,Credit Card - Ramp,104.51,53788729.81
03/02/2024,Expense,Fexmon Pty Ltd,Balapavan Tirumani,Meals & Entertainment,2.69,53788732.5
03/03/2024,Expense,Star Corner,Balapavan Tirumani,Meals & Entertainment,12.85,53788745.35
03/03/2024,Expense,Tequila Sunrise Cocktail,Balapavan Tirumani,Meals & Entertainment,4.24,53788749.59
03/03/2024,Expense,Harris Farm Markets,Balapavan Tirumani,Credit Card - Ramp,6.93,53788756.52
03/03/2024,Expense,Tequila Sunrise Cocktail,Balapavan Tirumani,Credit Card - Ramp,4.24,53788760.76
03/03/2024,Expense,VirtualPostMail,Harvey Spector,General business expenses:Memberships & subscriptions,35,53788795.76
03/03/2024,Expense,Star Corner,Balapavan Tirumani,Credit Card - Ramp,12.85,53788808.61
03/03/2024,Expense,Tequila Sunrise Cocktail,Balapavan Tirumani,Credit Card - Ramp,4.24,53788812.85
03/03/2024,Expense,VirtualPostMail,Harvey Spector,General business expenses:Memberships & subscriptions,35,53788847.85
03/03/2024,Expense,Tequila Sunrise Cocktail,Balapavan Tirumani,Meals & Entertainment,4.24,53788852.09
03/03/2024,Expense,Tequila Sunrise Cocktail,Balapavan Tirumani,Credit Card - Ramp,4.24,53788856.33
03/03/2024,Expense,Tequila Sunrise Cocktail,Balapavan Tirumani,Credit Card - Ramp,4.24,53788860.57
03/03/2024,Expense,Harris Farm Markets,Balapavan Tirumani,Meals & Entertainment,6.93,53788867.5
03/03/2024,Expense,Tequila Sunrise Cocktail,Balapavan Tirumani,Meals & Entertainment,4.24,53788871.74
03/03/2024,Expense,Star Corner,Balapavan Tirumani,Meals & Entertainment,12.85,53788884.59
03/03/2024,Expense,Harris Farm Markets,Balapavan Tirumani,Meals & Entertainment,6.93,53788891.52
03/03/2024,Expense,VirtualPostMail,Harvey Spector,Credit Card - Ramp,35,53788926.52
03/03/2024,Expense,VirtualPostMail,Harvey Spector,Credit Card - Ramp,35,53788961.52
03/03/2024,Expense,Harris Farm Markets,Balapavan Tirumani,Credit Card - Ramp,6.93,53788968.45
03/03/2024,Expense,Tequila Sunrise Cocktail,Balapavan Tirumani,Credit Card - Ramp,4.24,53788972.69
03/03/2024,Expense,Tequila Sunrise Cocktail,Balapavan Tirumani,Credit Card - Ramp,4.24,53788976.93
03/03/2024,Expense,Harris Farm Markets,Balapavan Tirumani,Credit Card - Ramp,6.93,53788983.86
03/03/2024,Expense,Star Corner,Balapavan Tirumani,Credit Card - Ramp,12.85,53788996.71
03/03/2024,Expense,VirtualPostMail,Harvey Spector,General business expenses:Memberships & subscriptions,35,53789031.71
03/03/2024,Expense,Tequila Sunrise Cocktail,Balapavan Tirumani,Meals & Entertainment,4.24,53789035.95
03/03/2024,Expense,Tequila Sunrise Cocktail,Balapavan Tirumani,Meals & Entertainment,4.24,53789040.19
03/03/2024,Expense,Harris Farm Markets,Balapavan Tirumani,Meals & Entertainment,6.93,53789047.12
03/03/2024,Expense,VirtualPostMail,Harvey Spector,Credit Card - Ramp,35,53789082.12
03/03/2024,Expense,Star Corner,Balapavan Tirumani,Credit Card - Ramp,12.85,53789094.97
03/03/2024,Expense,Harris Farm Markets,Balapavan Tirumani,Credit Card - Ramp,6.93,53789101.9
03/03/2024,Expense,VirtualPostMail,Harvey Spector,Credit Card - Ramp,35,53789136.9
03/03/2024,Expense,Star Corner,Balapavan Tirumani,Meals & Entertainment,12.85,53789149.75
03/03/2024,Expense,VirtualPostMail,Harvey Spector,General business expenses:Memberships & subscriptions,35,53789184.75
03/03/2024,Expense,Tequila Sunrise Cocktail,Balapavan Tirumani,Credit Card - Ramp,4.24,53789188.99
03/03/2024,Expense,Harris Farm Markets,Balapavan Tirumani,Meals & Entertainment,6.93,53789195.92
03/03/2024,Expense,Star Corner,Balapavan Tirumani,Meals & Entertainment,12.85,53789208.77
03/03/2024,Expense,Tequila Sunrise Cocktail,Balapavan Tirumani,Meals & Entertainment,4.24,53789213.01
03/03/2024,Expense,Tequila Sunrise Cocktail,Balapavan Tirumani,Meals & Entertainment,4.24,53789217.25
03/03/2024,Expense,Star Corner,Balapavan Tirumani,Credit Card - Ramp,12.85,53789230.1
03/03/2024,Expense,Tequila Sunrise Cocktail,Balapavan Tirumani,Credit Card - Ramp,4.24,53789234.34
03/03/2024,Expense,Tequila Sunrise Cocktail,Balapavan Tirumani,Meals & Entertainment,4.24,53789238.58
03/04/2024,Expense,Superhuman,Mike ross,Credit Card - Ramp,90,53789328.58
03/04/2024,Expense,McDonald's (Ramp Vendor),Balapavan Tirumani,Credit Card - Ramp,7.85,53789336.43
03/04/2024,Expense,Superhuman,Mike ross,Credit Card - Ramp,90,53789426.43
03/04/2024,Expense,1Password,Harvey Spector,Credit Card - Ramp,35.88,53789462.31
03/04/2024,Expense,Noahpinion,Max Kausman,Credit Card - Ramp,5.39,53789467.7
03/04/2024,Expense,Harris Farm Markets,Balapavan Tirumani,Credit Card - Ramp,6.43,53789474.13
03/04/2024,Expense,McDonald's (Ramp Vendor),Balapavan Tirumani,Credit Card - Ramp,7.85,53789481.98
03/04/2024,Expense,Superhuman,Mike ross,Professional Service Charges,90,53789571.98
03/04/2024,Expense,Harris Farm Markets,Balapavan Tirumani,Credit Card - Ramp,6.43,53789578.41
03/04/2024,Expense,Harris Farm Markets,Balapavan Tirumani,Credit Card - Ramp,6.43,53789584.84
03/04/2024,Expense,Harris Farm Markets,Balapavan Tirumani,Meals & Entertainment,6.43,53789591.27
03/04/2024,Expense,Superhuman,Mike ross,Professional Service Charges,90,53789681.27
03/04/2024,Expense,1Password,Harvey Spector,Tools & Subscription - G&A,35.88,53789717.15
03/04/2024,Expense,McDonald's (Ramp Vendor),Balapavan Tirumani,Meals & Entertainment,7.85,53789725
03/04/2024,Expense,Noahpinion,Max Kausman,Tools & Subscription - S&M,5.39,53789730.39
03/04/2024,Expense,1Password,Harvey Spector,Tools & Subscription - G&A,35.88,53789766.27
03/04/2024,Expense,McDonald's (Ramp Vendor),Balapavan Tirumani,Credit Card - Ramp,7.85,53789774.12
03/04/2024,Expense,Noahpinion,Max Kausman,Credit Card - Ramp,5.39,53789779.51
03/04/2024,Expense,1Password,Harvey Spector,Credit Card - Ramp,35.88,53789815.39
03/04/2024,Expense,Noahpinion,Max Kausman,Tools & Subscription - S&M,5.39,53789820.78
03/04/2024,Expense,McDonald's (Ramp Vendor),Balapavan Tirumani,Meals & Entertainment,7.85,53789828.63
03/04/2024,Expense,Harris Farm Markets,Balapavan Tirumani,Credit Card - Ramp,6.43,53789835.06
03/04/2024,Expense,McDonald's (Ramp Vendor),Balapavan Tirumani,Credit Card - Ramp,7.85,53789842.91
03/04/2024,Expense,Noahpinion,Max Kausman,Tools & Subscription - S&M,5.39,53789848.3
03/04/2024,Expense,Harris Farm Markets,Balapavan Tirumani,Meals & Entertainment,6.43,53789854.73
03/04/2024,Expense,Harris Farm Markets,Balapavan Tirumani,Meals & Entertainment,6.43,53789861.16
03/04/2024,Expense,Superhuman,Mike ross,Credit Card - Ramp,90,53789951.16
03/04/2024,Expense,Noahpinion,Max Kausman,Credit Card - Ramp,5.39,53789956.55
03/04/2024,Expense,McDonald's (Ramp Vendor),Balapavan Tirumani,Meals & Entertainment,7.85,53789964.4
03/04/2024,Expense,Superhuman,Mike ross,Professional Service Charges,90,53790054.4
03/04/2024,Expense,1Password,Harvey Spector,Tools & Subscription - G&A,35.88,53790090.28
03/04/2024,Expense,McDonald's (Ramp Vendor),Balapavan Tirumani,Meals & Entertainment,7.85,53790098.13
03/04/2024,Expense,Harris Farm Markets,Balapavan Tirumani,Meals & Entertainment,6.43,53790104.56
03/04/2024,Expense,Superhuman,Mike ross,Professional Service Charges,90,53790194.56
03/04/2024,Expense,1Password,Harvey Spector,Credit Card - Ramp,35.88,53790230.44
03/04/2024,Expense,1Password,Harvey Spector,Tools & Subscription - G&A,35.88,53790266.32
03/04/2024,Expense,Noahpinion,Max Kausman,Tools & Subscription - S&M,5.39,53790271.71
03/05/2024,Expense,Harris Farm Markets,Balapavan Tirumani,Credit Card - Ramp,2.69,53790274.4
03/05/2024,Expense,Babiole Dubai,Harvey Spector,Travel:Hotels,16.26,53790290.66
03/05/2024,Expense,Star Corner,Balapavan Tirumani,Meals & Entertainment,6.47,53790297.13
03/05/2024,Expense,Linear,Chris Jerochim,Credit Card - Ramp,110,53790407.13
03/05/2024,Expense,Uber,Mike ross,Travelling Expenses,7.6,53790414.73
03/05/2024,Expense,Babiole Dubai,Harvey Spector,Travel:Hotels,16.26,53790430.99
03/05/2024,Expense,Noon Al Quoz,Harvey Spector,Credit Card - Ramp,4.2,53790435.19
03/05/2024,Expense,Harris Farm Markets,Balapavan Tirumani,Meals & Entertainment,2.69,53790437.88
03/05/2024,Expense,Linear,Chris Jerochim,Tools & Subscription - G&A,110,53790547.88
03/05/2024,Expense,Linear,Chris Jerochim,Tools & Subscription - G&A,110,53790657.88
03/05/2024,Expense,Babiole Dubai,Harvey Spector,Travel:Hotels,16.26,53790674.14
03/05/2024,Expense,Harris Farm Markets,Balapavan Tirumani,Credit Card - Ramp,2.69,53790676.83
03/05/2024,Expense,Uber,Mike ross,Travelling Expenses,7.6,53790684.43
03/05/2024,Expense,Noon Al Quoz,Harvey Spector,Credit Card - Ramp,4.2,53790688.63
03/05/2024,Expense,Uber,Mike ross,Credit Card - Ramp,18.4,53790707.03
03/05/2024,Expense,Star Corner,Balapavan Tirumani,Meals & Entertainment,6.45,53790713.48
03/05/2024,Expense,Uber,Mike ross,Travelling Expenses,12.66,53790726.14
03/05/2024,Expense,Harris Farm Markets,Balapavan Tirumani,Meals & Entertainment,2.69,53790728.83
03/05/2024,Expense,Linear,Chris Jerochim,Tools & Subscription - G&A,110,53790838.83
03/05/2024,Expense,Noon Al Quoz,Harvey Spector,Meals & Entertainment,4.2,53790843.03
03/05/2024,Expense,Star Corner,Balapavan Tirumani,Meals & Entertainment,6.45,53790849.48
03/05/2024,Expense,Babiole Dubai,Harvey Spector,Credit Card - Ramp,16.26,53790865.74
03/05/2024,Expense,Linear,Chris Jerochim,Tools & Subscription - G&A,110,53790975.74
03/05/2024,Expense,Uber,Mike ross,Credit Card - Ramp,7.6,53790983.34
03/05/2024,Expense,Uber,Mike ross,Travelling Expenses,18.4,53791001.74
03/05/2024,Expense,Uber,Mike ross,Travelling Expenses,18.4,53791020.14
03/05/2024,Expense,Harris Farm Markets,Balapavan Tirumani,Meals & Entertainment,2.69,53791022.83
03/05/2024,Expense,Noon Al Quoz,Harvey Spector,Meals & Entertainment,4.2,53791027.03
03/05/2024,Expense,Uber,Mike ross,Credit Card - Ramp,12.66,53791039.69
03/05/2024,Expense,Babiole Dubai,Harvey Spector,Credit Card - Ramp,16.26,53791055.95
03/05/2024,Expense,Star Corner,Balapavan Tirumani,Meals & Entertainment,6.47,53791062.42
03/05/2024,Expense,Uber,Mike ross,Travelling Expenses,12.66,53791075.08
03/05/2024,Expense,Uber,Mike ross,Credit Card - Ramp,12.66,53791087.74
03/05/2024,Expense,Uber,Mike ross,Travelling Expenses,12.66,53791100.4
03/05/2024,Expense,Uber,Mike ross,Credit Card - Ramp,18.4,53791118.8
03/05/2024,Expense,Uber,Mike ross,Credit Card - Ramp,7.6,53791126.4
03/05/2024,Expense,Star Corner,Balapavan Tirumani,Credit Card - Ramp,6.47,53791132.87
03/05/2024,Expense,Noon Al Quoz,Harvey Spector,Meals & Entertainment,4.2,53791137.07
03/05/2024,Expense,Harris Farm Markets,Balapavan Tirumani,Meals & Entertainment,2.69,53791139.76
03/05/2024,Expense,Noon Al Quoz,Harvey Spector,Meals & Entertainment,4.2,53791143.96
03/05/2024,Expense,Babiole Dubai,Harvey Spector,Travel:Hotels,16.26,53791160.22
03/05/2024,Expense,Uber,Mike ross,Travelling Expenses,7.6,53791167.82
03/05/2024,Expense,Star Corner,Balapavan Tirumani,Meals & Entertainment,6.47,53791174.29
03/05/2024,Expense,Star Corner,Balapavan Tirumani,Meals & Entertainment,6.45,53791180.74
03/05/2024,Expense,Harris Farm Markets,Balapavan Tirumani,Credit Card - Ramp,2.69,53791183.43
03/05/2024,Expense,Noon Al Quoz,Harvey Spector,Credit Card - Ramp,4.2,53791187.63
03/05/2024,Expense,Star Corner,Balapavan Tirumani,Credit Card - Ramp,6.47,53791194.1
03/05/2024,Expense,Star Corner,Balapavan Tirumani,Credit Card - Ramp,6.45,53791200.55
03/05/2024,Expense,Star Corner,Balapavan Tirumani,Credit Card - Ramp,6.45,53791207
03/05/2024,Expense,Linear,Chris Jerochim,Credit Card - Ramp,110,53791317
03/05/2024,Expense,Harris Farm Markets,Balapavan Tirumani,Credit Card - Ramp,2.69,53791319.69
03/05/2024,Expense,Star Corner,Balapavan Tirumani,Meals & Entertainment,6.45,53791326.14
03/05/2024,Expense,Star Corner,Balapavan Tirumani,Credit Card - Ramp,6.47,53791332.61
03/05/2024,Expense,Uber,Mike ross,Travelling Expenses,12.66,53791345.27
03/05/2024,Expense,Uber,Mike ross,Credit Card - Ramp,18.4,53791363.67
03/05/2024,Expense,Star Corner,Balapavan Tirumani,Meals & Entertainment,6.47,53791370.14
03/05/2024,Expense,Uber,Mike ross,Credit Card - Ramp,12.66,53791382.8
03/05/2024,Expense,Babiole Dubai,Harvey Spector,Credit Card - Ramp,16.26,53791399.06
03/05/2024,Expense,Star Corner,Balapavan Tirumani,Credit Card - Ramp,6.45,53791405.51
03/05/2024,Expense,Uber,Mike ross,Credit Card - Ramp,7.6,53791413.11
03/05/2024,Expense,Noon Al Quoz,Harvey Spector,Credit Card - Ramp,4.2,53791417.31
03/05/2024,Expense,Star Corner,Balapavan Tirumani,Credit Card - Ramp,6.47,53791423.78
03/05/2024,Expense,Uber,Mike ross,Travelling Expenses,7.6,53791431.38
03/05/2024,Expense,Uber,Mike ross,Travelling Expenses,18.4,53791449.78
03/05/2024,Expense,Uber,Mike ross,Travelling Expenses,18.4,53791468.18
03/05/2024,Expense,Linear,Chris Jerochim,Credit Card - Ramp,110,53791578.18
03/05/2024,Expense,Star Corner,Balapavan Tirumani,Credit Card - Ramp,6.45,53791584.63
03/06/2024,Expense,Careem,Harvey Spector,Travelling Expenses,5.75,53791590.38
03/06/2024,Expense,Oporto,Balapavan Tirumani,Meals & Entertainment,5.08,53791595.46
03/06/2024,Expense,Oporto,Balapavan Tirumani,Meals & Entertainment,5.08,53791600.54
03/06/2024,Expense,Careem,Harvey Spector,Travelling Expenses,4.62,53791605.16
03/06/2024,Expense,OpenAI,Harvey Spector,Credit Card - Ramp,20,53791625.16
03/06/2024,Expense,OpenAI,Harvey Spector,Tools & Subscription - G&A,20,53791645.16
03/06/2024,Expense,Made Dubai,Harvey Spector,Meals & Entertainment,21.6,53791666.76
03/06/2024,Expense,Careem,Harvey Spector,Travelling Expenses,5.75,53791672.51
03/06/2024,Expense,Made Dubai,Harvey Spector,Meals & Entertainment,21.6,53791694.11
03/06/2024,Expense,Made Dubai,Harvey Spector,Credit Card - Ramp,21.6,53791715.71
03/06/2024,Expense,OpenAI,Harvey Spector,Credit Card - Ramp,20,53791735.71
03/06/2024,Expense,OpenAI,Mike ross,Tools & Subscription - G&A,20,53791755.71
03/06/2024,Expense,Careem,Harvey Spector,Travelling Expenses,5.75,53791761.46
03/06/2024,Expense,OpenAI,Harvey Spector,Tools & Subscription - G&A,20,53791781.46
03/06/2024,Expense,Oporto,Balapavan Tirumani,Meals & Entertainment,5.08,53791786.54
03/06/2024,Expense,Careem,Harvey Spector,Travelling Expenses,4.62,53791791.16
03/06/2024,Expense,OpenAI,Mike ross,Credit Card - Ramp,20,53791811.16
03/06/2024,Expense,OpenAI,Harvey Spector,Tools & Subscription - G&A,20,53791831.16
03/06/2024,Expense,Careem,Harvey Spector,Travelling Expenses,4.62,53791835.78
03/06/2024,Expense,OpenAI,Mike ross,Tools & Subscription - G&A,20,53791855.78
03/06/2024,Expense,Oporto,Balapavan Tirumani,Credit Card - Ramp,5.08,53791860.86
03/06/2024,Expense,Made Dubai,Harvey Spector,Meals & Entertainment,21.6,53791882.46
03/06/2024,Expense,OpenAI,Harvey Spector,Tools & Subscription - G&A,20,53791902.46
03/06/2024,Expense,OpenAI,Mike ross,Tools & Subscription - G&A,20,53791922.46
03/06/2024,Expense,OpenAI,Harvey Spector,Credit Card - Ramp,20,53791942.46
03/06/2024,Expense,OpenAI,Mike ross,Credit Card - Ramp,20,53791962.46
03/06/2024,Expense,OpenAI,Mike ross,Credit Card - Ramp,20,53791982.46
03/06/2024,Expense,Made Dubai,Harvey Spector,Credit Card - Ramp,21.6,53792004.06
03/06/2024,Expense,Oporto,Balapavan Tirumani,Credit Card - Ramp,5.08,53792009.14
03/06/2024,Expense,Oporto,Balapavan Tirumani,Credit Card - Ramp,5.08,53792014.22
03/06/2024,Expense,Made Dubai,Harvey Spector,Credit Card - Ramp,21.6,53792035.82
03/06/2024,Expense,Careem,Harvey Spector,Credit Card - Ramp,4.62,53792040.44
03/06/2024,Expense,Careem,Harvey Spector,Credit Card - Ramp,5.75,53792046.19
03/06/2024,Expense,Oporto,Balapavan Tirumani,Credit Card - Ramp,5.08,53792051.27
03/06/2024,Expense,Careem,Harvey Spector,Travelling Expenses,4.62,53792055.89
03/06/2024,Expense,Careem,Harvey Spector,Credit Card - Ramp,4.62,53792060.51
03/06/2024,Expense,Made Dubai,Harvey Spector,Credit Card - Ramp,21.6,53792082.11
03/06/2024,Expense,Oporto,Balapavan Tirumani,Meals & Entertainment,5.08,53792087.19
03/06/2024,Expense,Careem,Harvey Spector,Travelling Expenses,5.75,53792092.94
03/06/2024,Expense,Careem,Harvey Spector,Credit Card - Ramp,4.62,53792097.56
03/06/2024,Expense,Made Dubai,Harvey Spector,Meals & Entertainment,21.6,53792119.16
03/06/2024,Expense,OpenAI,Mike ross,Tools & Subscription - G&A,20,53792139.16
03/06/2024,Expense,Careem,Harvey Spector,Credit Card - Ramp,5.75,53792144.91
03/06/2024,Expense,Careem,Harvey Spector,Credit Card - Ramp,5.75,53792150.66
03/07/2024,Expense,Harris Farm Markets,Balapavan Tirumani,Credit Card - Ramp,4.75,53792155.41
03/07/2024,Expense,Heroku,Harvey Spector,Tools & Subscription - S&M,5,53792160.41
03/07/2024,Expense,Heroku,Harvey Spector,Tools & Subscription - S&M,5,53792165.41
03/07/2024,Expense,Heroku,Harvey Spector,Tools & Subscription - S&M,5,53792170.41
03/07/2024,Expense,Supabase,Harris Jose,Tools & Subscription - G&A,33.71,53792204.12
03/07/2024,Expense,Durga Australia Pty Restaurant,Balapavan Tirumani,Meals & Entertainment,11.87,53792215.99
03/07/2024,Expense,teenage engineering,Mike ross,Credit Card - Ramp,1499,53793714.99
03/07/2024,Expense,Harris Farm Markets,Balapavan Tirumani,Meals & Entertainment,4.75,53793719.74
03/07/2024,Expense,Harris Farm Markets,Balapavan Tirumani,Credit Card - Ramp,4.75,53793724.49
03/07/2024,Expense,teenage engineering,Mike ross,Office expenses:Office supplies,1499,53795223.49
03/07/2024,Expense,Durga Australia Pty Restaurant,Balapavan Tirumani,Credit Card - Ramp,11.87,53795235.36
03/07/2024,Expense,Harris Farm Markets,Balapavan Tirumani,Meals & Entertainment,4.75,53795240.11
03/07/2024,Expense,Durga Australia Pty Restaurant,Balapavan Tirumani,Credit Card - Ramp,11.87,53795251.98
03/07/2024,Expense,Harris Farm Markets,Balapavan Tirumani,Meals & Entertainment,4.75,53795256.73
03/07/2024,Expense,Heroku,Harvey Spector,Credit Card - Ramp,5,53795261.73
03/07/2024,Expense,teenage engineering,Mike ross,Office expenses:Office supplies,1499,53796760.73
03/07/2024,Expense,Harris Farm Markets,Balapavan Tirumani,Credit Card - Ramp,4.75,53796765.48
03/07/2024,Expense,Supabase,Harris Jose,Tools & Subscription - G&A,33.71,53796799.19
03/07/2024,Expense,Harris Farm Markets,Balapavan Tirumani,Meals & Entertainment,4.75,53796803.94
03/07/2024,Expense,Heroku,Harvey Spector,Tools & Subscription - S&M,5,53796808.94
03/07/2024,Expense,Durga Australia Pty Restaurant,Balapavan Tirumani,Credit Card - Ramp,11.87,53796820.81
03/07/2024,Expense,Supabase,Harris Jose,Credit Card - Ramp,33.71,53796854.52
03/07/2024,Expense,Durga Australia Pty Restaurant,Balapavan Tirumani,Meals & Entertainment,11.87,53796866.39
03/07/2024,Expense,Supabase,Harris Jose,Credit Card - Ramp,33.71,53796900.1
03/07/2024,Expense,teenage engineering,Mike ross,Credit Card - Ramp,1499,53798399.1
03/07/2024,Expense,Heroku,Harvey Spector,Credit Card - Ramp,5,53798404.1
03/07/2024,Expense,Harris Farm Markets,Balapavan Tirumani,Credit Card - Ramp,4.75,53798408.85
03/07/2024,Expense,Durga Australia Pty Restaurant,Balapavan Tirumani,Meals & Entertainment,11.87,53798420.72
03/07/2024,Expense,Supabase,Harris Jose,Tools & Subscription - G&A,33.71,53798454.43
03/07/2024,Expense,Supabase,Harris Jose,Tools & Subscription - G&A,33.71,53798488.14
03/07/2024,Expense,Supabase,Harris Jose,Credit Card - Ramp,33.71,53798521.85
03/07/2024,Expense,teenage engineering,Mike ross,Credit Card - Ramp,1499,53800020.85
03/07/2024,Expense,Heroku,Harvey Spector,Credit Card - Ramp,5,53800025.85
03/07/2024,Expense,teenage engineering,Mike ross,Office expenses:Office supplies,1499,53801524.85
03/07/2024,Expense,Durga Australia Pty Restaurant,Balapavan Tirumani,Credit Card - Ramp,11.87,53801536.72
03/07/2024,Expense,Durga Australia Pty Restaurant,Balapavan Tirumani,Meals & Entertainment,11.87,53801548.59
03/07/2024,Expense,teenage engineering,Mike ross,Credit Card - Ramp,1499,53803047.59
03/07/2024,Expense,teenage engineering,Mike ross,Office expenses:Office supplies,1499,53804546.59
03/08/2024,Expense,Careem,Harvey Spector,Travelling Expenses,7.12,53804553.71
03/08/2024,Expense,Heroku,Balapavan Tirumani,Credit Card - Ramp,85,53804638.71
03/08/2024,Expense,Heroku,Balapavan Tirumani,Tools & Subscription - S&M,85,53804723.71
03/08/2024,Expense,Careem,Harvey Spector,Credit Card - Ramp,7.12,53804730.83
03/08/2024,Expense,Heroku,Balapavan Tirumani,Credit Card - Ramp,85,53804815.83
03/08/2024,Expense,Heroku,Balapavan Tirumani,Tools & Subscription - S&M,85,53804900.83
03/08/2024,Expense,Heroku,Balapavan Tirumani,Tools & Subscription - S&M,85,53804985.83
03/08/2024,Expense,Careem,Harvey Spector,Travelling Expenses,7.12,53804992.95
03/08/2024,Expense,Careem,Harvey Spector,Travelling Expenses,7.12,53805000.07
03/08/2024,Expense,Heroku,Balapavan Tirumani,Tools & Subscription - S&M,85,53805085.07
03/08/2024,Expense,Careem,Harvey Spector,Travelling Expenses,7.12,53805092.19
03/08/2024,Expense,Careem,Harvey Spector,Credit Card - Ramp,7.12,53805099.31
03/08/2024,Expense,Careem,Harvey Spector,Credit Card - Ramp,7.12,53805106.43
03/08/2024,Expense,Heroku,Balapavan Tirumani,Credit Card - Ramp,85,53805191.43
03/09/2024,Expense,OpenAI,Balapavan Tirumani,Credit Card - Ramp,20,53805211.43
03/09/2024,Expense,Star Corner,Balapavan Tirumani,Credit Card - Ramp,2.78,53805214.21
03/09/2024,Expense,Lemon Squeezy,Chris George,Credit Card - Ramp,99,53805313.21
03/09/2024,Expense,Star Corner,Balapavan Tirumani,Credit Card - Ramp,2.78,53805315.99
03/09/2024,Expense,Star Corner,Balapavan Tirumani,Meals & Entertainment,2.78,53805318.77
03/09/2024,Expense,Star Corner,Balapavan Tirumani,Credit Card - Ramp,6.74,53805325.51
03/09/2024,Expense,Lemon Squeezy,Chris George,Tools & Subscription - G&A,99,53805424.51
03/09/2024,Expense,Usersnap,Harris Jose,Credit Card - Ramp,99,53805523.51
03/09/2024,Expense,OpenAI,Balapavan Tirumani,Tools & Subscription - G&A,20,53805543.51
03/09/2024,Expense,OpenAI,Balapavan Tirumani,Tools & Subscription - G&A,20,53805563.51
03/09/2024,Expense,Star Corner,Balapavan Tirumani,Credit Card - Ramp,2.78,53805566.29
03/09/2024,Expense,Usersnap,Harris Jose,Tools & Subscription - G&A,99,53805665.29
03/09/2024,Deposit,,Savings Interest,Interest Received,0.82,53805666.11
03/09/2024,Expense,Usersnap,Harris Jose,Tools & Subscription - G&A,99,53805765.11
03/09/2024,Expense,Usersnap,Harris Jose,Tools & Subscription - G&A,99,53805864.11
03/09/2024,Deposit,,Savings Interest,Interest Received,0.82,53805864.93
03/09/2024,Deposit,,Savings Interest,Interest Received,0.82,53805865.75
03/09/2024,Deposit,,Savings Interest,Savings (6977),0.82,53805866.57
03/09/2024,Deposit,,Savings Interest,Savings (6977),0.82,53805867.39
03/09/2024,Expense,Star Corner,Balapavan Tirumani,Credit Card - Ramp,6.74,53805874.13
03/09/2024,Expense,Star Corner,Balapavan Tirumani,Meals & Entertainment,6.74,53805880.87
03/09/2024,Expense,Lemon Squeezy,Chris George,Tools & Subscription - G&A,99,53805979.87
03/09/2024,Expense,OpenAI,Balapavan Tirumani,Tools & Subscription - G&A,20,53805999.87
03/09/2024,Expense,Lemon Squeezy,Chris George,Credit Card - Ramp,99,53806098.87
03/09/2024,Deposit,,Savings Interest,Savings (6977),0.82,53806099.69
03/09/2024,Expense,Star Corner,Balapavan Tirumani,Meals & Entertainment,6.74,53806106.43
03/09/2024,Expense,Lemon Squeezy,Chris George,Credit Card - Ramp,99,53806205.43
03/09/2024,Expense,OpenAI,Balapavan Tirumani,Tools & Subscription - G&A,20,53806225.43
03/09/2024,Expense,Star Corner,Balapavan Tirumani,Meals & Entertainment,6.74,53806232.17
03/09/2024,Expense,Star Corner,Balapavan Tirumani,Credit Card - Ramp,6.74,53806238.91
03/09/2024,Expense,Lemon Squeezy,Chris George,Tools & Subscription - G&A,99,53806337.91
03/09/2024,Expense,Star Corner,Balapavan Tirumani,Meals & Entertainment,2.78,53806340.69
03/09/2024,Expense,Lemon Squeezy,Chris George,Tools & Subscription - G&A,99,53806439.69
03/09/2024,Deposit,,Savings Interest,Interest Received,0.82,53806440.51
03/09/2024,Expense,Usersnap,Harris Jose,Credit Card - Ramp,99,53806539.51
03/09/2024,Expense,Star Corner,Balapavan Tirumani,Meals & Entertainment,2.78,53806542.29
03/09/2024,Expense,Star Corner,Balapavan Tirumani,Credit Card - Ramp,6.74,53806549.03
03/09/2024,Expense,Usersnap,Harris Jose,Tools & Subscription - G&A,99,53806648.03
03/09/2024,Expense,Star Corner,Balapavan Tirumani,Credit Card - Ramp,2.78,53806650.81
03/09/2024,Expense,OpenAI,Balapavan Tirumani,Credit Card - Ramp,20,53806670.81
03/09/2024,Expense,Star Corner,Balapavan Tirumani,Meals & Entertainment,2.78,53806673.59
03/09/2024,Expense,Star Corner,Balapavan Tirumani,Meals & Entertainment,6.74,53806680.33
03/09/2024,Expense,Usersnap,Harris Jose,Credit Card - Ramp,99,53806779.33
03/09/2024,Expense,OpenAI,Balapavan Tirumani,Credit Card - Ramp,20,53806799.33
03/10/2024,Expense,Pause Cafe,Harvey Spector,Meals & Entertainment,12,53806811.33
03/10/2024,Expense,Pause Cafe,Harvey Spector,Credit Card - Ramp,12,53806823.33
03/10/2024,Expense,Pause Cafe,Harvey Spector,Credit Card - Ramp,12,53806835.33
03/10/2024,Expense,Pause Cafe,Harvey Spector,Meals & Entertainment,12,53806847.33
03/10/2024,Expense,Pause Cafe,Harvey Spector,Credit Card - Ramp,12,53806859.33
03/10/2024,Expense,Pause Cafe,Harvey Spector,Meals & Entertainment,12,53806871.33
03/10/2024,Expense,Pause Cafe,Harvey Spector,Credit Card - Ramp,12,53806883.33
03/10/2024,Expense,Pause Cafe,Harvey Spector,Meals & Entertainment,12,53806895.33
03/12/2024,Expense,OpenAI,Max Kausman,Tools & Subscription - G&A,20,53806915.33
03/12/2024,Expense,OpenAI,Max Kausman,Credit Card - Ramp,20,53806935.33
03/12/2024,Expense,OpenAI,Max Kausman,Credit Card - Ramp,20,53806955.33
03/12/2024,Expense,OpenAI,Max Kausman,Credit Card - Ramp,20,53806975.33
03/12/2024,Expense,OpenAI,Max Kausman,Tools & Subscription - G&A,20,53806995.33
03/12/2024,Expense,OpenAI,Max Kausman,Tools & Subscription - G&A,20,53807015.33
03/12/2024,Expense,OpenAI,Max Kausman,Tools & Subscription - G&A,20,53807035.33